winner_id,Rating,ratings.Games,ratings.Win,ratings.Draw,ratings.Loss,ratings.Lag,season,Name
200652,2676.430412,80,74,0,6,1,1991,Monica Seles
200033,2671.352819,84,79,0,5,1,2013,Serena Williams
200003,2664.961095,67,63,0,4,0,2007,Justine Henin
200414,2662.748072,83,77,0,6,0,1993,Steffi Graf
200652,2654.580515,75,70,0,5,0,1992,Monica Seles
200414,2644.264189,77,72,0,5,1,1990,Steffi Graf
200414,2636.359718,78,71,0,7,0,1992,Steffi Graf
200079,2627.553853,102,90,0,12,2,2003,Kim Clijsters
200033,2620.72072,64,58,0,6,3,2012,Serena Williams
200001,2610.911763,88,78,0,10,3,2000,Martina Hingis
200017,2610.205032,83,74,0,9,0,1994,Arantxa Sanchez Vicario
200033,2601.849411,62,57,0,5,0,2002,Serena Williams
200128,2595.900955,71,60,0,11,0,1999,Lindsay Davenport
200414,2594.549678,74,66,0,8,1,1991,Steffi Graf
200128,2594.512196,74,64,0,10,6,2001,Lindsay Davenport
200001,2592.098627,81,76,0,5,0,1997,Martina Hingis
200003,2588.239625,87,76,0,11,2,2003,Justine Henin
200414,2587.806045,59,54,0,5,0,1996,Steffi Graf
200128,2582.556936,84,70,0,14,0,1998,Lindsay Davenport
200003,2581.696106,69,61,0,8,0,2006,Justine Henin
200414,2577.978659,50,48,0,2,1,1995,Steffi Graf
200079,2576.527072,77,68,0,9,0,2005,Kim Clijsters
201345,2575.428684,69,59,0,10,0,2006,Maria Sharapova
200001,2574.499856,82,70,0,12,0,1999,Martina Hingis
200065,2573.623395,77,65,0,12,2,2004,Amelie Mauresmo
200748,2571.076597,52,46,0,6,14,2001,Venus Williams
200293,2569.402855,62,53,0,9,1,1991,Martina Navratilova
200128,2568.253853,74,64,0,10,2,2004,Lindsay Davenport
200652,2565.979036,56,50,0,6,1,1990,Monica Seles
200748,2564.260838,45,41,0,4,10,2000,Venus Williams
200001,2563.819782,78,66,0,12,0,1998,Martina Hingis
201345,2554.701202,72,61,0,11,3,2012,Maria Sharapova
200017,2554.161987,84,67,0,17,0,1992,Arantxa Sanchez Vicario
200128,2552.531306,71,60,0,11,0,2005,Lindsay Davenport
200748,2549.272366,72,63,0,9,0,2002,Venus Williams
201458,2543.553023,80,68,0,12,3,2012,Victoria Azarenka
200096,2543.179686,56,43,0,13,0,2005,Mary Pierce
200414,2542.888843,64,58,0,6,0,1994,Steffi Graf
200748,2541.615978,72,60,0,12,0,1999,Venus Williams
201520,2538.893273,67,56,0,11,0,2011,Petra Kvitova
200017,2538.756866,87,74,0,13,0,1993,Arantxa Sanchez Vicario
200539,2537.566793,67,54,0,13,0,1996,Jana Novotna
201496,2536.211866,82,65,0,17,2,2010,Caroline Wozniacki
200033,2534.69203,47,40,0,7,6,2001,Serena Williams
200748,2533.236532,51,40,0,11,0,2008,Venus Williams
200128,2532.231473,74,60,0,14,0,2000,Lindsay Davenport
201347,2530.368333,89,69,0,20,0,2008,Jelena Jankovic
200001,2530.237776,69,52,0,17,0,1996,Martina Hingis
200079,2529.10366,68,51,0,17,0,2002,Kim Clijsters
200572,2527.300312,73,62,0,11,1,1991,Gabriela Sabatini
200293,2527.225631,46,38,0,8,0,1992,Martina Navratilova
200128,2526.19644,75,59,0,16,0,1997,Lindsay Davenport
200572,2525.456395,77,65,0,12,0,1992,Gabriela Sabatini
200572,2525.374829,59,46,0,13,1,1990,Gabriela Sabatini
200077,2525.203351,55,43,0,12,1,1991,Jennifer Capriati
200049,2524.903837,73,63,0,10,0,1995,Conchita Martinez
200033,2523.233842,59,53,0,6,9,2015,Serena Williams
200033,2522.508168,62,52,0,10,2,2014,Serena Williams
200049,2519.626418,79,66,0,13,0,1993,Conchita Martinez
200065,2515.536964,73,56,0,17,0,2005,Amelie Mauresmo
201345,2513.902001,71,55,0,16,2,2004,Maria Sharapova
200079,2513.733774,47,40,0,7,2,2010,Kim Clijsters
200017,2511.059402,76,61,0,15,1,1991,Arantxa Sanchez Vicario
200414,2511.053335,42,33,0,9,0,1998,Steffi Graf
200033,2510.782963,41,38,0,3,20,2003,Serena Williams
200539,2510.107269,68,53,0,15,0,1997,Jana Novotna
200652,2508.632087,59,50,0,9,0,1996,Monica Seles
200539,2501.030228,54,43,0,11,0,1994,Jana Novotna
200652,2500.875912,59,46,0,13,0,1998,Monica Seles
200033,2499.26159,63,50,0,13,2,2009,Serena Williams
200065,2498.900549,70,53,0,17,0,2003,Amelie Mauresmo
200652,2497.668865,70,57,0,13,0,2000,Monica Seles
200079,2495.869489,77,58,0,19,0,2001,Kim Clijsters
200108,2494.72453,73,56,0,17,0,2008,Elena Dementieva
200293,2492.033663,51,44,0,7,0,1993,Martina Navratilova
201594,2491.096069,67,50,0,17,0,2013,Simona Halep
200033,2491.037945,45,38,0,7,6,1999,Serena Williams
200748,2490.48062,60,50,0,10,4,2007,Venus Williams
200293,2488.845339,54,48,0,6,3,1990,Martina Navratilova
201419,2487.637201,60,46,0,14,1,2013,Na Li
200079,2486.14395,57,44,0,13,0,2006,Kim Clijsters
200597,2485.230555,50,40,0,10,1,1990,Mary Joe Fernandez
201345,2484.134172,63,50,0,13,2,2014,Maria Sharapova
201329,2483.861891,67,49,0,18,2,2010,Vera Zvonareva
201329,2482.471503,87,64,0,23,0,2008,Vera Zvonareva
200008,2482.20718,29,27,0,2,9,1998,Alicia Molik
200033,2481.292199,53,44,0,9,0,2008,Serena Williams
200772,2479.077511,74,56,0,18,0,2004,Anastasia Myskina
200652,2477.68411,50,40,0,10,9,2001,Monica Seles
200033,2476.253252,45,37,0,8,13,2000,Serena Williams
201400,2475.828984,63,48,0,15,1,2005,Nicole Vaidisova
200077,2475.353527,70,56,0,14,6,2001,Jennifer Capriati
201336,2472.896988,76,56,0,20,0,2008,Dinara Safina
200065,2471.398604,66,51,0,15,0,2006,Amelie Mauresmo
200077,2468.982655,46,35,0,11,0,1992,Jennifer Capriati
200033,2465.08557,50,39,0,11,2,2004,Serena Williams
200003,2463.777195,39,34,0,5,5,2005,Justine Henin
201496,2462.988142,68,49,0,19,2,2014,Caroline Wozniacki
200748,2462.546463,63,50,0,13,4,1998,Venus Williams
201320,2461.798468,81,61,0,20,0,2006,Svetlana Kuznetsova
201492,2461.395051,71,54,0,17,5,2011,Andrea Petkovic
201345,2459.468846,66,53,0,13,0,2005,Maria Sharapova
201345,2458.993824,52,40,0,12,0,2007,Maria Sharapova
200120,2458.793745,76,53,0,23,6,2001,Jelena Dokic
200539,2458.675317,66,51,0,15,0,1998,Jana Novotna
201520,2457.411935,62,45,0,17,0,2014,Petra Kvitova
200003,2456.995124,40,36,0,4,11,2004,Justine Henin
200597,2455.891736,68,51,0,17,0,1992,Mary Joe Fernandez
201421,2455.51838,79,60,0,19,2,2014,Ana Ivanovic
201421,2454.182724,66,49,0,17,0,2007,Ana Ivanovic
200049,2453.35431,45,36,0,9,1,1990,Conchita Martinez
200003,2451.975903,78,60,0,18,0,2001,Justine Henin
200096,2451.057907,47,35,0,12,0,1998,Mary Pierce
201496,2450.56853,71,50,0,21,2,2012,Caroline Wozniacki
200539,2450.304406,63,47,0,16,0,1993,Jana Novotna
200128,2449.479539,63,48,0,15,7,2003,Lindsay Davenport
201458,2449.113351,79,60,0,19,2,2011,Victoria Azarenka
200008,2449.004749,62,42,0,20,3,2004,Alicia Molik
201419,2448.572108,63,46,0,17,3,2012,Na Li
200748,2448.24889,45,38,0,7,9,2010,Venus Williams
200652,2447.608403,59,45,0,14,0,1997,Monica Seles
200065,2445.768003,64,48,0,16,6,2002,Amelie Mauresmo
201364,2445.757283,64,46,0,18,2,2007,Tatiana Golovin
200096,2445.143559,63,45,0,18,0,1994,Mary Pierce
201474,2445.125161,68,49,0,19,2,2011,Agnieszka Radwanska
200128,2443.019492,66,51,0,15,0,1996,Lindsay Davenport
200455,2442.08503,63,47,0,16,1,1990,Katerina Maleeva
201345,2440.402063,49,39,0,10,0,2015,Maria Sharapova
200652,2439.942842,63,49,0,14,0,2002,Monica Seles
200081,2439.621898,67,50,0,17,0,1996,Anke Huber
200539,2439.166495,64,48,0,16,1,1991,Jana Novotna
201493,2438.792174,84,62,0,22,3,2012,Angelique Kerber
200001,2437.030005,75,60,0,15,9,2001,Martina Hingis
201345,2437.025613,45,37,0,8,10,2013,Maria Sharapova
200081,2436.105134,60,43,0,17,1,1995,Anke Huber
201320,2435.280766,75,55,0,20,0,2007,Svetlana Kuznetsova
201474,2434.378263,83,63,0,20,3,2012,Agnieszka Radwanska
200108,2434.364851,74,49,0,25,2,2003,Elena Dementieva
200414,2433.85322,43,34,0,9,14,1999,Steffi Graf
201496,2433.565116,75,54,0,21,2,2008,Caroline Wozniacki
201212,2433.390308,64,41,0,23,2,2005,Francesca Schiavone
201474,2432.850192,76,51,0,25,2,2015,Agnieszka Radwanska
201345,2432.806112,40,31,0,9,5,2009,Maria Sharapova
200401,2432.280811,55,40,0,15,1,1990,Manuela Maleeva Fragniere
200748,2431.795611,48,37,0,11,7,2005,Venus Williams
200128,2431.681929,64,48,0,16,0,1994,Lindsay Davenport
200539,2431.323391,57,38,0,19,0,1992,Jana Novotna
200069,2431.018911,71,47,0,24,0,2008,Nadia Petrova
200081,2430.983358,54,40,0,14,0,1993,Anke Huber
200081,2430.49389,58,41,0,17,0,1994,Anke Huber
201320,2430.302151,83,60,0,23,0,2004,Svetlana Kuznetsova
201403,2430.081894,58,38,0,20,2,2006,Anna Chakvetadze
201496,2430.006174,83,66,0,17,2,2011,Caroline Wozniacki
200003,2429.359645,40,32,0,8,18,2010,Justine Henin
201458,2428.132259,55,43,0,12,1,2013,Victoria Azarenka
201520,2427.796158,75,52,0,23,1,2013,Petra Kvitova
201403,2427.431695,79,59,0,20,0,2007,Anna Chakvetadze
200077,2427.250238,44,34,0,10,1,1990,Jennifer Capriati
200597,2426.959317,69,50,0,19,1,1991,Mary Joe Fernandez
200033,2426.804853,26,22,0,4,9,2011,Serena Williams
200069,2426.339535,81,56,0,25,0,2005,Nadia Petrova
200049,2425.830227,53,40,0,13,1,1991,Conchita Martinez
200401,2425.682709,52,36,0,16,0,1993,Manuela Maleeva Fragniere
202469,2425.063435,60,41,0,19,2,2015,Garbine Muguruza
200017,2425.019871,50,37,0,13,1,1990,Arantxa Sanchez Vicario
200001,2424.933628,72,53,0,19,0,2006,Martina Hingis
200077,2424.91744,60,42,0,18,2,2003,Jennifer Capriati
200049,2424.756133,70,55,0,15,0,1994,Conchita Martinez
200064,2424.739301,89,63,0,26,0,1997,Amanda Coetzer
200572,2423.818413,61,44,0,17,1,1995,Gabriela Sabatini
200572,2423.340287,59,42,0,17,0,1994,Gabriela Sabatini
200652,2422.353459,51,38,0,13,7,1999,Monica Seles
200096,2422.27526,64,45,0,19,0,1999,Mary Pierce
200003,2422.044745,73,52,0,21,0,2002,Justine Henin
200748,2421.986098,55,41,0,14,1,2015,Venus Williams
200033,2421.960909,29,25,0,4,18,2010,Serena Williams
200748,2421.705052,31,26,0,5,20,2003,Venus Williams
200108,2421.575999,74,56,0,18,2,2009,Elena Dementieva
200401,2421.269388,60,45,0,15,1,1991,Manuela Maleeva Fragniere
200096,2420.685725,64,47,0,17,0,1997,Mary Pierce
200017,2419.43865,66,50,0,16,0,1995,Arantxa Sanchez Vicario
200033,2418.951682,45,35,0,10,0,2007,Serena Williams
201474,2418.780536,82,62,0,20,1,2013,Agnieszka Radwanska
201325,2418.007691,69,46,0,23,2,2011,Samantha Stosur
200108,2417.329263,59,41,0,18,3,2007,Elena Dementieva
200069,2417.278561,68,48,0,20,0,2006,Nadia Petrova
200069,2416.639709,59,39,0,20,2,2012,Nadia Petrova
201355,2416.186301,81,57,0,24,0,2009,Flavia Pennetta
200748,2416.180607,58,44,0,14,3,2004,Venus Williams
201320,2416.136611,60,43,0,17,2,2009,Svetlana Kuznetsova
200404,2416.045936,66,48,0,18,1,1990,Zina Garrison
200081,2415.743528,47,33,0,14,7,1991,Anke Huber
201493,2415.43639,69,46,0,23,1,2013,Angelique Kerber
200723,2415.304541,44,31,0,13,1,1995,Iva Majoli
200772,2414.832603,68,46,0,22,1,2003,Anastasia Myskina
201345,2414.108975,57,43,0,14,2,2011,Maria Sharapova
200065,2413.654572,60,47,0,13,1,2001,Amelie Mauresmo
200049,2413.593356,69,51,0,18,0,1996,Conchita Martinez
200097,2413.542141,64,41,0,23,0,1998,Nathalie Tauziat
200539,2413.430362,56,40,0,16,1,1990,Jana Novotna
201594,2413.373389,69,49,0,20,2,2014,Simona Halep
200017,2413.250012,70,46,0,24,0,1997,Arantxa Sanchez Vicario
200017,2412.599024,80,58,0,22,0,1996,Arantxa Sanchez Vicario
200096,2412.337645,50,36,0,14,0,1993,Mary Pierce
200764,2411.829111,55,37,0,18,4,2004,Elena Bovina
201497,2411.440961,41,31,0,10,6,2007,Agnes Szavay
200617,2410.453376,53,41,0,12,1,1995,Kimiko Date Krumm
200404,2409.988305,61,43,0,18,0,1993,Zina Garrison
200086,2407.988553,46,33,0,13,6,1994,Magdalena Maleeva
200064,2407.786749,59,41,0,18,0,1993,Amanda Coetzer
200128,2407.66374,35,26,0,9,0,2002,Lindsay Davenport
200067,2407.384044,83,58,0,25,0,2005,Patty Schnyder
200017,2407.174807,68,49,0,19,0,1998,Arantxa Sanchez Vicario
201347,2406.893353,73,45,0,28,1,2006,Jelena Jankovic
200097,2406.450798,62,44,0,18,0,1993,Nathalie Tauziat
200086,2406.197263,51,38,0,13,1,1995,Magdalena Maleeva
200051,2405.250658,70,47,0,23,0,1997,Irina Spirlea
201294,2405.100637,86,60,0,26,1,2011,Marion Bartoli
200077,2404.972433,65,48,0,17,0,2002,Jennifer Capriati
201474,2403.968983,75,53,0,22,0,2008,Agnieszka Radwanska
201290,2403.7826,80,54,0,26,0,2002,Daniela Hantuchova
200049,2402.901641,69,50,0,19,0,1992,Conchita Martinez
201347,2402.881688,104,78,0,26,0,2007,Jelena Jankovic
203094,2402.5,17,16,0,1,52,2001,Petra Russegger
200029,2402.5,19,17,0,2,56,2002,Lisa Mcshea
201349,2402.5,17,16,0,1,63,2002,Melinda Czink
200554,2402.4429,52,37,0,15,1,1995,Brenda Schultz Mccarthy
200377,2402.374046,58,41,0,17,1,1990,Helena Sukova
201329,2402.10728,78,56,0,22,2,2011,Vera Zvonareva
200108,2402.042206,63,40,0,23,2,2004,Elena Dementieva
200097,2401.88683,63,42,0,21,0,1997,Nathalie Tauziat
202302,2401.455833,21,19,0,2,34,2003,Maria Fernanda Alves
200482,2401.261549,45,31,0,14,7,1991,Judith Wiesner
200016,2401.179916,85,56,0,29,1,2001,Sandrine Testud
201347,2400.565627,67,46,0,21,1,2013,Jelena Jankovic
200617,2400.49223,52,36,0,16,0,1996,Kimiko Date Krumm
201290,2400.244794,82,54,0,28,0,2007,Daniela Hantuchova
201355,2399.943366,75,50,0,25,2,2008,Flavia Pennetta
201400,2399.838569,51,37,0,14,1,2007,Nicole Vaidisova
200069,2399.665398,56,36,0,20,4,2003,Nadia Petrova
201347,2399.589296,65,46,0,19,2,2009,Jelena Jankovic
200601,2398.982198,50,37,0,13,2,1990,Leila Meskhi
200572,2398.746645,64,47,0,17,0,1993,Gabriela Sabatini
201325,2398.417765,66,42,0,24,0,2013,Samantha Stosur
201493,2398.353849,76,53,0,23,2,2015,Angelique Kerber
200748,2398.194178,33,24,0,9,4,2012,Venus Williams
201336,2397.166883,71,55,0,16,2,2009,Dinara Safina
200377,2397.00686,57,41,0,16,0,1992,Helena Sukova
200741,2396.681709,39,29,0,10,33,1997,Renee Reid
200401,2396.578134,50,37,0,13,0,1992,Manuela Maleeva Fragniere
201421,2396.094403,53,33,0,20,1,2010,Ana Ivanovic
201421,2395.422841,58,42,0,16,0,2008,Ana Ivanovic
200097,2394.904891,62,37,0,25,0,1999,Nathalie Tauziat
200097,2394.393154,65,46,0,19,1,1990,Nathalie Tauziat
200085,2393.613177,74,48,0,26,2,2003,Ai Sugiyama
201345,2393.570354,39,33,0,6,13,2008,Maria Sharapova
201496,2393.095531,63,41,0,22,2,2013,Caroline Wozniacki
200108,2393.01172,69,46,0,23,0,2005,Elena Dementieva
201495,2392.69699,65,43,0,22,3,2011,Dominika Cibulkova
200772,2392.58178,57,37,0,20,3,2005,Anastasia Myskina
201506,2391.88869,77,55,0,22,3,2012,Sara Errani
201520,2391.834618,63,46,0,17,1,2012,Petra Kvitova
201474,2391.659781,73,49,0,24,2,2009,Agnieszka Radwanska
200733,2391.344655,18,16,0,2,52,1999,Trudi Musgrave
200723,2390.117754,64,46,0,18,0,1996,Iva Majoli
201325,2389.963561,64,44,0,20,1,2009,Samantha Stosur
200077,2389.069296,38,28,0,10,13,1993,Jennifer Capriati
201329,2388.923245,83,56,0,27,2,2004,Vera Zvonareva
200037,2388.444222,51,36,0,15,2,1991,Sabine Appelmans
200039,2387.252542,40,29,0,11,0,2002,Chanda Rubin
200428,2386.864237,61,39,0,22,0,1992,Lori Mcneil
200065,2386.32511,48,34,0,14,0,1999,Amelie Mauresmo
200096,2386.081539,40,29,0,11,16,2000,Mary Pierce
200039,2385.470652,59,39,0,20,0,1995,Chanda Rubin
200009,2385.416351,33,26,0,7,0,1996,Tamarine Tanasugarn
201320,2385.117,65,44,0,21,0,2008,Svetlana Kuznetsova
203901,2384.926538,20,16,0,4,45,1998,Mira Radu
200086,2384.641477,47,32,0,15,4,1992,Magdalena Maleeva
201458,2383.952344,63,42,0,21,2,2010,Victoria Azarenka
200116,2383.902271,54,34,0,20,1,1992,Natalia Zvereva
202505,2383.471374,62,41,0,21,5,2015,Belinda Bencic
201518,2383.33601,52,34,0,18,1,2009,Yanina Wickmayer
201458,2383.041795,48,34,0,14,6,2015,Victoria Azarenka
200077,2382.598222,41,29,0,12,3,2004,Jennifer Capriati
201345,2382.543056,44,33,0,11,5,2010,Maria Sharapova
200116,2382.016497,46,34,0,12,0,1994,Natalia Zvereva
200016,2381.91316,67,44,0,23,0,1997,Sandrine Testud
200455,2381.522718,53,36,0,17,1,1991,Katerina Maleeva
200080,2381.142337,58,41,0,17,0,1997,Dominique Monami
200116,2381.129297,53,35,0,18,0,1993,Natalia Zvereva
200096,2380.125495,45,34,0,11,1,1992,Mary Pierce
201496,2380.036954,93,68,0,25,2,2009,Caroline Wozniacki
200081,2379.366756,52,36,0,16,1,1992,Anke Huber
200059,2379.006835,51,34,0,17,0,1996,Ruxandra Dragomir Ilie
201325,2378.857657,66,47,0,19,2,2010,Samantha Stosur
200723,2378.612062,58,39,0,19,0,1994,Iva Majoli
200086,2378.13889,54,38,0,16,0,1993,Magdalena Maleeva
201400,2378.049914,56,39,0,17,2,2006,Nicole Vaidisova
201421,2377.592373,58,39,0,19,1,2006,Ana Ivanovic
200039,2377.52819,65,45,0,20,2,2003,Chanda Rubin
201294,2375.884614,68,46,0,22,1,2009,Marion Bartoli
201458,2375.882087,63,46,0,17,2,2009,Victoria Azarenka
200128,2375.046913,29,21,0,8,7,2006,Lindsay Davenport
201458,2375.021617,60,40,0,20,3,2008,Victoria Azarenka
202219,2374.820538,17,15,0,2,8,1996,Keiko Nagatomi
200293,2374.454541,47,33,0,14,0,1994,Martina Navratilova
201513,2374.398254,49,36,0,13,1,2011,Sabine Lisicki
200016,2374.294812,79,52,0,27,0,1998,Sandrine Testud
201594,2373.684188,67,50,0,17,2,2015,Simona Halep
201294,2373.409533,78,47,0,31,0,2007,Marion Bartoli
200103,2373.393823,31,24,0,7,52,1997,Evie Dominikovic
200043,2372.485831,55,35,0,20,4,2007,Virginie Razzano
201212,2372.303537,64,39,0,25,0,2009,Francesca Schiavone
201419,2371.874675,52,35,0,17,5,2009,Na Li
201424,2371.035628,71,49,0,22,4,2010,Shahar Peer
200597,2370.850886,46,31,0,15,0,1995,Mary Joe Fernandez
200096,2370.451143,53,37,0,16,1,1995,Mary Pierce
201347,2370.414132,60,39,0,21,1,2015,Jelena Jankovic
200108,2370.29746,70,48,0,22,0,2006,Elena Dementieva
201290,2370.195547,63,38,0,25,2,2005,Daniela Hantuchova
200617,2369.624729,36,25,0,11,11,1993,Kimiko Date Krumm
200108,2368.872227,58,38,0,20,3,2000,Elena Dementieva
201294,2368.604532,73,45,0,28,1,2006,Marion Bartoli
200097,2368.549094,60,39,0,21,1,1991,Nathalie Tauziat
200079,2368.512946,47,30,0,17,1,2000,Kim Clijsters
200064,2368.119318,70,47,0,23,3,2000,Amanda Coetzer
200108,2367.736162,60,41,0,19,2,2010,Elena Dementieva
200079,2367.598946,16,13,0,3,3,2009,Kim Clijsters
200404,2367.593348,56,38,0,18,1,1991,Zina Garrison
200652,2367.436026,12,11,0,1,12,1995,Monica Seles
201421,2366.79505,46,32,0,14,2,2005,Ana Ivanovic
200067,2366.334223,75,48,0,27,2,2007,Patty Schnyder
200033,2366.201786,37,26,0,11,6,1998,Serena Williams
200077,2366.13514,55,36,0,19,0,2000,Jennifer Capriati
201329,2366.06558,59,37,0,22,1,2006,Vera Zvonareva
200049,2365.6876,56,37,0,19,0,1997,Conchita Martinez
201466,2365.620992,50,32,0,18,5,2010,Kaia Kanepi
200001,2365.500103,44,34,0,10,6,2002,Martina Hingis
200612,2365.42422,37,24,0,13,3,1993,Natalia Medvedeva
201345,2365.085006,36,24,0,12,4,2003,Maria Sharapova
201355,2365.012348,74,51,0,23,0,2010,Flavia Pennetta
200107,2364.964209,59,37,0,22,5,2003,Paola Suarez
200597,2364.688347,58,40,0,18,0,1997,Mary Joe Fernandez
201325,2364.582333,58,34,0,24,4,2014,Samantha Stosur
200617,2364.506378,47,33,0,14,0,1994,Kimiko Date Krumm
201311,2363.938677,73,49,0,24,2,2013,Roberta Vinci
200004,2363.718767,26,21,0,5,9,1999,Kerry Anne Guse
200032,2363.392701,71,47,0,24,0,1999,Barbara Schett
201419,2363.004367,36,29,0,7,17,2014,Na Li
200113,2362.966235,76,47,0,29,3,2000,Anna Kournikova
200116,2362.729241,53,38,0,15,1,1990,Natalia Zvereva
200748,2362.693328,54,38,0,16,2,2009,Venus Williams
200081,2362.137201,48,32,0,16,16,2000,Anke Huber
200128,2362.127677,14,13,0,1,1,2007,Lindsay Davenport
200029,2362,16,14,0,2,45,2003,Lisa Mcshea
200079,2361.820999,24,20,0,4,8,2004,Kim Clijsters
200116,2361.631207,53,35,0,18,1,1995,Natalia Zvereva
200069,2361.507071,58,39,0,19,5,2007,Nadia Petrova
202981,2361.230975,22,17,0,5,45,1998,Melissa Beadman
201424,2361.211785,63,43,0,20,2,2006,Shahar Peer
200097,2361.207101,62,41,0,21,0,1992,Nathalie Tauziat
200377,2359.803633,52,34,0,18,1,1991,Helena Sukova
200652,2359.76732,19,17,0,2,44,1993,Monica Seles
201329,2359.626408,44,30,0,14,1,2007,Vera Zvonareva
200040,2359.568326,64,40,0,24,5,2003,Anna Smashnova
200604,2359.316661,46,32,0,14,1,1990,Barbara Paulus
201329,2359.138109,48,34,0,14,2,2009,Vera Zvonareva
201336,2358.867868,57,37,0,20,2,2005,Dinara Safina
201520,2358.547144,55,38,0,17,0,2015,Petra Kvitova
200077,2358.287421,39,26,0,13,1,1999,Jennifer Capriati
201458,2358.275705,48,31,0,17,4,2007,Victoria Azarenka
200064,2358.217232,62,44,0,18,1,1992,Amanda Coetzer
200482,2358.006351,50,34,0,16,3,1994,Judith Wiesner
200772,2357.731714,75,47,0,28,0,2002,Anastasia Myskina
200113,2357.611401,60,40,0,20,0,1998,Anna Kournikova
201425,2356.963723,62,39,0,23,0,2014,Lucie Safarova
200597,2356.781373,43,31,0,12,0,1993,Mary Joe Fernandez
200067,2356.765971,72,47,0,25,2,2006,Patty Schnyder
201490,2356.334195,55,41,0,14,3,2015,Timea Bacsinszky
200039,2356.030629,64,42,0,22,3,2000,Chanda Rubin
200069,2356.003521,65,40,0,25,3,2004,Nadia Petrova
200049,2355.610281,75,52,0,23,0,2000,Conchita Martinez
201421,2355.427677,54,33,0,21,1,2011,Ana Ivanovic
200108,2355.070027,62,39,0,23,0,2001,Elena Dementieva
200559,2354.917588,23,18,0,5,21,1996,Kristine Kunce
200081,2353.093942,60,36,0,24,0,1997,Anke Huber
200051,2352.782785,62,37,0,25,0,1998,Irina Spirlea
201325,2352.650573,68,44,0,24,3,2012,Samantha Stosur
201493,2352.627176,71,47,0,24,0,2014,Angelique Kerber
200086,2352.578543,63,38,0,25,0,2002,Magdalena Maleeva
200748,2352.388733,48,33,0,15,5,2014,Venus Williams
200067,2352.11903,75,54,0,21,0,1998,Patty Schnyder
200601,2351.977693,44,30,0,14,7,1991,Leila Meskhi
200112,2351.8307,69,47,0,22,0,1999,Julie Halard Decugis
200700,2351.752765,68,42,0,26,1,1998,Silvia Farina Elia
200482,2351.625616,46,30,0,16,7,1995,Judith Wiesner
201521,2351.545612,77,52,0,25,1,2014,Carla Suarez Navarro
201418,2350.844566,12,12,0,0,9,1999,Ting Li
200120,2350.33432,80,53,0,27,0,2002,Jelena Dokic
200051,2350.037239,56,36,0,20,0,1996,Irina Spirlea
200128,2349.762034,49,33,0,16,1,1993,Lindsay Davenport
200604,2349.74638,28,21,0,7,1,1995,Barbara Paulus
201336,2349.415704,65,44,0,21,4,2006,Dinara Safina
200651,2349.381129,47,31,0,16,3,1993,Sabine Hack
201513,2349.350078,54,35,0,19,2,2013,Sabine Lisicki
200049,2349.015934,60,40,0,20,0,1998,Conchita Martinez
201506,2349.006442,72,48,0,24,1,2013,Sara Errani
201662,2348.980623,68,44,0,24,1,2014,Karolina Pliskova
200041,2348.960934,52,35,0,17,3,2004,Amy Frazier
200764,2348.934218,49,30,0,19,4,2002,Elena Bovina
201495,2348.780826,66,39,0,27,2,2008,Dominika Cibulkova
201311,2348.746531,72,44,0,28,2,2012,Roberta Vinci
201286,2348.596148,70,43,0,27,2,2008,Anabel Medina Garrigues
200414,2347.914546,20,16,0,4,23,1997,Steffi Graf
200017,2347.744299,66,45,0,21,0,2000,Arantxa Sanchez Vicario
201085,2347.412502,15,13,0,2,8,1996,Shinobu Asagoe
200428,2347.406981,60,39,0,21,1,1991,Lori Mcneil
200011,2347.393147,66,41,0,25,2,2008,Katarina Srebotnik
201212,2347.352775,64,41,0,23,0,2010,Francesca Schiavone
200128,2347.177084,31,24,0,7,10,2008,Lindsay Davenport
201499,2346.607879,59,35,0,24,0,2015,Anastasia Pavlyuchenkova
200604,2346.547325,57,39,0,18,0,1996,Barbara Paulus
201499,2346.439219,61,40,0,21,0,2011,Anastasia Pavlyuchenkova
200034,2345.968016,23,19,0,4,45,1998,Amanda Grahame
201466,2345.921952,34,25,0,9,7,2012,Kaia Kanepi
200539,2345.636665,47,34,0,13,1,1995,Jana Novotna
200554,2345.256532,58,39,0,19,0,1996,Brenda Schultz Mccarthy
200116,2344.764763,62,40,0,22,0,1998,Natalia Zvereva
200041,2344.593148,43,28,0,15,1,1994,Amy Frazier
201386,2344.412483,35,23,0,12,2,2008,Jie Zheng
201421,2344.409539,63,40,0,23,0,2013,Ana Ivanovic
202494,2344.269081,64,39,0,25,4,2014,Elina Svitolina
201424,2344.120405,61,39,0,22,1,2009,Shahar Peer
200112,2343.028839,63,41,0,22,0,1994,Julie Halard Decugis
201585,2342.621344,63,40,0,23,2,2013,Sloane Stephens
200667,2342.563739,34,23,0,11,24,1994,Ines Gorrochategui
200699,2342.437751,28,19,0,9,3,1996,Meredith Mcgrath
201419,2342.093941,43,29,0,14,2,2008,Na Li
200041,2341.953593,45,31,0,14,2,1990,Amy Frazier
200482,2341.947158,49,31,0,18,5,1992,Judith Wiesner
201290,2341.757159,65,40,0,25,2,2006,Daniela Hantuchova
201424,2341.636804,64,43,0,21,3,2007,Shahar Peer
200684,2341.190337,46,30,0,16,0,1996,Shi Ting Wang
201662,2341.055515,79,53,0,26,0,2015,Karolina Pliskova
201085,2340.945336,18,14,0,4,9,1997,Shinobu Asagoe
200037,2340.756697,47,30,0,17,4,1992,Sabine Appelmans
200597,2340.666782,35,25,0,10,4,1994,Mary Joe Fernandez
200020,2340.57676,52,31,0,21,1,1997,Lisa Raymond
201394,2340.458235,66,40,0,26,4,2005,Anna Lena Groenefeld
200009,2340.081523,54,35,0,19,4,2000,Tamarine Tanasugarn
200112,2339.923578,57,34,0,23,0,1998,Julie Halard Decugis
200096,2339.881642,32,23,0,9,3,1991,Mary Pierce
201329,2339.544775,70,46,0,24,1,2003,Vera Zvonareva
200112,2339.521025,67,44,0,23,1,1991,Julie Halard Decugis
201521,2338.980747,69,43,0,26,2,2013,Carla Suarez Navarro
201336,2338.892925,60,38,0,22,2,2007,Dinara Safina
200554,2338.575406,67,44,0,23,0,1994,Brenda Schultz Mccarthy
201421,2338.496859,58,37,0,21,1,2012,Ana Ivanovic
200097,2338.236744,55,34,0,21,6,2001,Nathalie Tauziat
201474,2338.164994,50,31,0,19,2,2007,Agnieszka Radwanska
203533,2338.123605,62,40,0,22,1,2015,Anna Karolina Schmiedlova
200482,2338.058832,49,31,0,18,5,1993,Judith Wiesner
200064,2337.965715,57,35,0,22,1,1995,Amanda Coetzer
200067,2337.832853,62,36,0,26,0,2002,Patty Schnyder
200725,2337.281984,46,29,0,17,7,1994,Sandra Cecchini
201212,2336.99966,53,29,0,24,2,2007,Francesca Schiavone
202753,2336.825064,39,28,0,11,33,1997,Esme De Villiers
200128,2336.663258,47,33,0,14,1,1995,Lindsay Davenport
200016,2336.657768,61,36,0,25,0,1999,Sandrine Testud
200006,2336.231972,64,41,0,23,0,1996,Karina Habsudova
200735,2335.721857,17,14,0,3,10,2001,Miho Saeki
200079,2335.534331,27,20,0,7,10,2012,Kim Clijsters
201355,2335.3772,55,31,0,24,2,2007,Flavia Pennetta
200116,2335.246281,49,30,0,19,2,1991,Natalia Zvereva
201474,2335.18125,67,45,0,22,2,2014,Agnieszka Radwanska
200064,2335.178839,57,38,0,19,0,1994,Amanda Coetzer
200041,2335.081639,50,31,0,19,1,1999,Amy Frazier
201352,2335,12,11,0,1,59,2000,Akiko Morigami
201410,2335,14,12,0,2,45,2003,Monique Adamczak
202469,2334.864869,60,38,0,22,1,2014,Garbine Muguruza
200020,2334.632729,54,33,0,21,7,2001,Lisa Raymond
200723,2333.957297,68,45,0,23,0,1997,Iva Majoli
201492,2333.255658,64,41,0,23,0,2014,Andrea Petkovic
200083,2333.132097,55,31,0,24,4,2002,Alexandra Stevenson
200482,2333.043035,63,37,0,26,0,1996,Judith Wiesner
201364,2332.994922,46,30,0,16,0,2004,Tatiana Golovin
200748,2332.924396,33,20,0,13,1,1997,Venus Williams
200046,2332.558298,70,45,0,25,6,2001,Meghann Shaughnessy
200684,2332.44055,39,27,0,12,0,1994,Shi Ting Wang
200080,2331.874689,73,47,0,26,0,1998,Dominique Monami
200455,2331.870608,45,28,0,17,2,1993,Katerina Maleeva
200065,2331.778298,41,27,0,14,9,2009,Amelie Mauresmo
200597,2331.155396,48,32,0,16,1,1996,Mary Joe Fernandez
201320,2330.763606,45,27,0,18,3,2014,Svetlana Kuznetsova
200059,2330.751407,60,38,0,22,4,1999,Ruxandra Dragomir Ilie
200684,2330.673563,30,21,0,9,7,1993,Shi Ting Wang
201513,2330.543421,49,31,0,18,1,2009,Sabine Lisicki
200041,2330.398556,43,28,0,15,2,1995,Amy Frazier
201355,2330.13733,59,38,0,21,3,2005,Flavia Pennetta
201419,2329.989811,56,36,0,20,1,2010,Na Li
201344,2329.835086,51,32,0,19,1,2005,Klara Koukalova
200617,2329.217474,43,29,0,14,9,1992,Kimiko Date Krumm
200482,2329.149437,59,41,0,18,1,1990,Judith Wiesner
201286,2329.022917,57,35,0,22,1,2011,Anabel Medina Garrigues
201397,2328.804118,71,48,0,23,1,2011,Shuai Peng
201287,2328.569798,44,27,0,17,5,2011,Maria Jose Martinez Sanchez
200113,2328.5411,54,35,0,19,0,1999,Anna Kournikova
200081,2328.459954,58,32,0,26,0,1999,Anke Huber
201419,2328.344317,50,33,0,17,2,2011,Na Li
202446,2328.306085,64,41,0,23,2,2014,Eugenie Bouchard
201320,2327.83813,31,22,0,9,7,2002,Svetlana Kuznetsova
201320,2327.59579,44,27,0,17,5,2010,Svetlana Kuznetsova
200037,2327.364176,47,30,0,17,3,1996,Sabine Appelmans
200049,2327.08019,60,38,0,22,0,1999,Conchita Martinez
201505,2327.056238,62,41,0,21,1,2014,Ekaterina Makarova
201419,2326.730736,62,40,0,22,4,2006,Na Li
200112,2326.624794,42,31,0,11,4,1996,Julie Halard Decugis
201311,2326.553902,48,28,0,20,3,2010,Roberta Vinci
201514,2326.374233,45,28,0,17,2,2008,Sorana Cirstea
200065,2326.205667,39,26,0,13,9,2000,Amelie Mauresmo
200644,2326.088205,36,23,0,13,9,1992,Naoko Sawamatsu
200377,2326.072538,42,26,0,16,0,1993,Helena Sukova
200530,2326.06262,57,36,0,21,2,1991,Radomira Zrubakova
201466,2326.051448,54,33,0,21,2,2008,Kaia Kanepi
200011,2325.831349,50,31,0,19,2,2005,Katarina Srebotnik
201515,2325.746296,57,33,0,24,1,2010,Alisa Kleybanova
201212,2325.632644,62,37,0,25,5,2004,Francesca Schiavone
200404,2325.217635,56,36,0,20,0,1992,Zina Garrison
201373,2325.137362,60,37,0,23,3,2010,Maria Kirilenko
200404,2325.050327,41,25,0,16,2,1995,Zina Garrison
201505,2325.014673,45,26,0,19,8,2013,Ekaterina Makarova
200455,2324.942578,53,33,0,20,0,1992,Katerina Maleeva
200067,2324.657486,62,38,0,24,2,2008,Patty Schnyder
200604,2324.547128,50,33,0,17,3,1997,Barbara Paulus
201290,2324.50225,64,39,0,25,3,2009,Daniela Hantuchova
201294,2324.418561,66,41,0,25,4,2012,Marion Bartoli
201320,2324.222689,48,28,0,20,1,2015,Svetlana Kuznetsova
200048,2323.528337,50,26,0,24,4,2004,Elena Likhovtseva
200116,2323.469003,49,29,0,20,3,1997,Natalia Zvereva
200016,2323.273513,52,31,0,21,3,2000,Sandrine Testud
200764,2323.200035,48,26,0,22,5,2003,Elena Bovina
200601,2322.915013,42,26,0,16,2,1992,Leila Meskhi
200098,2322.89531,45,27,0,18,0,1997,Henrieta Nagyova
201446,2322.876393,69,45,0,24,2,2007,Sybille Bammer
200497,2322.787009,40,23,0,17,4,1992,Patricia Hy Boulais
200109,2322.189931,52,34,0,18,12,2003,Nathalie Dechy
201499,2322.028243,56,33,0,23,0,2013,Anastasia Pavlyuchenkova
200033,2321.389042,16,12,0,4,10,2006,Serena Williams
200120,2321.2791,55,35,0,20,5,2000,Jelena Dokic
200098,2321.201244,56,39,0,17,0,1998,Henrieta Nagyova
200097,2320.490749,62,36,0,26,3,2000,Nathalie Tauziat
203089,2320.451412,17,13,0,4,52,2001,Kristen Van Elden
200065,2320.198216,51,32,0,19,2,2008,Amelie Mauresmo
201499,2320.109983,60,39,0,21,1,2010,Anastasia Pavlyuchenkova
202993,2319.966185,15,12,0,3,10,1997,Sachie Umehara
200067,2319.946205,55,32,0,23,5,2003,Patty Schnyder
201421,2319.528431,49,30,0,19,3,2015,Ana Ivanovic
200051,2319.225673,55,36,0,19,2,1995,Irina Spirlea
200428,2318.846732,48,28,0,20,1,1993,Lori Mcneil
201587,2318.804518,50,28,0,22,2,2013,Bojana Jovanovski
201287,2318.048877,49,30,0,19,1,2009,Maria Jose Martinez Sanchez
200003,2317.82182,21,17,0,4,23,2008,Justine Henin
200109,2317.347531,62,37,0,25,0,2004,Nathalie Dechy
200086,2317.231875,59,35,0,24,6,2001,Magdalena Maleeva
200644,2316.949579,39,26,0,13,8,1994,Naoko Sawamatsu
200081,2316.913963,57,36,0,21,6,2001,Anke Huber
200109,2316.775014,68,41,0,27,1,2005,Nathalie Dechy
201427,2316.677018,59,36,0,23,2,2008,Alize Cornet
200096,2316.480796,43,25,0,18,0,2003,Mary Pierce
200098,2316.351741,44,26,0,18,4,2000,Henrieta Nagyova
200455,2316.081644,39,22,0,17,1,1994,Katerina Maleeva
200401,2315.20273,14,12,0,2,58,1994,Manuela Maleeva Fragniere
201512,2315.107438,40,24,0,16,3,2011,Monica Niculescu
201347,2315.07878,61,39,0,22,3,2011,Jelena Jankovic
201364,2314.893261,45,26,0,19,3,2006,Tatiana Golovin
201294,2314.425121,56,30,0,26,2,2008,Marion Bartoli
200377,2314.407433,35,21,0,14,4,1994,Helena Sukova
201479,2314.305448,24,16,0,8,1,2006,Olga Puchkova
200079,2313.889049,30,23,0,7,12,2011,Kim Clijsters
200043,2313.675206,51,31,0,20,6,2009,Virginie Razzano
201419,2313.201094,42,28,0,14,6,2005,Na Li
200041,2312.961954,52,30,0,22,3,2000,Amy Frazier
201373,2312.821408,53,29,0,24,0,2011,Maria Kirilenko
200017,2312.738103,42,25,0,17,0,1999,Arantxa Sanchez Vicario
200554,2312.385647,64,37,0,27,0,1997,Brenda Schultz Mccarthy
200067,2311.953602,48,28,0,20,3,2010,Patty Schnyder
200095,2311.796306,38,22,0,16,2,1996,Linda Wild
200079,2311.649476,23,16,0,7,1,1999,Kim Clijsters
200653,2311.47052,34,22,0,12,7,1995,Yayuk Basuki
200065,2311.414145,43,28,0,15,3,2007,Amelie Mauresmo
202446,2311.355519,49,30,0,19,2,2013,Eugenie Bouchard
201355,2311.243423,48,28,0,20,2,2015,Flavia Pennetta
200725,2311.146676,37,24,0,13,4,1990,Sandra Cecchini
200715,2310.888418,32,21,0,11,10,1998,Mariaan De Swardt
201619,2310.881966,50,31,0,19,1,2015,Madison Keys
200037,2310.614839,49,33,0,16,3,1994,Sabine Appelmans
200039,2310.536487,55,35,0,20,1,1999,Chanda Rubin
201294,2310.424696,57,36,0,21,4,2010,Marion Bartoli
200417,2310.193538,48,30,0,18,2,1991,Gigi Fernandez
201320,2310.060358,38,22,0,16,8,2003,Svetlana Kuznetsova
200113,2309.872993,29,18,0,11,6,1997,Anna Kournikova
200032,2309.857154,64,37,0,27,2,1998,Barbara Schett
201513,2309.819404,48,27,0,21,3,2014,Sabine Lisicki
200077,2309.810431,27,16,0,11,3,1996,Jennifer Capriati
201425,2309.626693,57,34,0,23,3,2009,Lucie Safarova
201474,2309.611084,54,34,0,20,5,2010,Agnieszka Radwanska
200069,2309.601379,52,32,0,20,5,2010,Nadia Petrova
200085,2309.414255,60,39,0,21,1,1998,Ai Sugiyama
201386,2309.220996,42,26,0,16,7,2006,Jie Zheng
201466,2309.074946,31,21,0,10,2,2013,Kaia Kanepi
200024,2308.781169,23,15,0,8,9,2003,Maria Vento Kabchi
201478,2308.60286,46,27,0,19,3,2014,Varvara Lepchenko
201212,2308.536241,57,32,0,25,5,2003,Francesca Schiavone
201320,2308.39751,47,29,0,18,2,2013,Svetlana Kuznetsova
200660,2308.378468,33,20,0,13,1,1996,Kimberly Po Messerli
200107,2308.210862,58,40,0,18,4,2004,Paola Suarez
201425,2308.053066,51,27,0,24,2,2013,Lucie Safarova
200037,2307.868033,36,21,0,15,3,1993,Sabine Appelmans
201504,2307.813938,52,29,0,23,3,2010,Julia Goerges
200001,2307.502151,33,20,0,13,2,1995,Martina Hingis
201325,2307.088881,58,34,0,24,4,2015,Samantha Stosur
201294,2306.974098,40,25,0,15,10,2013,Marion Bartoli
200725,2306.936654,42,25,0,17,10,1992,Sandra Cecchini
200017,2306.931419,59,36,0,23,1,2001,Arantxa Sanchez Vicario
201320,2306.870831,55,34,0,21,0,2011,Svetlana Kuznetsova
201497,2306.539073,49,30,0,19,5,2010,Agnes Szavay
200651,2306.534766,53,35,0,18,0,1994,Sabine Hack
202987,2306.522972,16,12,0,4,8,1996,Maiko Inoue
200548,2306.498005,46,29,0,17,2,1993,Patty Fendick
201201,2306.466185,14,11,0,3,10,1997,Surina De Beer
200049,2306.241453,48,29,0,19,2,2005,Conchita Martinez
200112,2306.18337,57,32,0,25,3,2000,Julie Halard Decugis
200037,2305.945159,48,30,0,18,4,1995,Sabine Appelmans
200080,2305.844258,63,38,0,25,0,1999,Dominique Monami
201212,2305.55103,57,35,0,22,3,2011,Francesca Schiavone
201585,2305.487098,54,34,0,20,3,2015,Sloane Stephens
201425,2305.341396,53,32,0,21,2,2015,Lucie Safarova
201495,2305.227348,64,37,0,27,4,2012,Dominika Cibulkova
201486,2305.051009,60,34,0,26,3,2009,Aleksandra Wozniak
200040,2304.970713,43,27,0,16,6,2005,Anna Smashnova
200595,2304.804803,49,30,0,19,1,1993,Ann Wunderlich
200039,2304.723849,29,20,0,9,1,1996,Chanda Rubin
201347,2304.709778,56,30,0,26,3,2004,Jelena Jankovic
201506,2304.625924,53,31,0,22,2,2008,Sara Errani
200428,2304.514499,41,26,0,15,2,1994,Lori Mcneil
201414,2304.405244,26,17,0,9,2,2005,Michaella Krajicek
200040,2304.261418,74,47,0,27,0,2002,Anna Smashnova
200095,2304.245375,42,24,0,18,2,1993,Linda Wild
201373,2304.222061,50,29,0,21,4,2005,Maria Kirilenko
200010,2303.787555,61,35,0,26,7,2001,Rita Grande
201416,2303.671605,62,37,0,25,2,2007,Alona Bondarenko
200069,2303.579543,51,30,0,21,3,2009,Nadia Petrova
200006,2303.063951,31,18,0,13,3,1994,Karina Habsudova
201506,2302.940167,76,48,0,28,1,2015,Sara Errani
201465,2302.836753,19,13,0,6,4,2012,Kirsten Flipkens
200469,2302.759308,45,30,0,15,13,1993,Nicole Bradtke
201373,2302.697376,54,33,0,21,2,2012,Maria Kirilenko
200630,2302.531083,45,28,0,17,11,1991,Laura Gildemeister
200112,2302.483588,48,28,0,20,3,1993,Julie Halard Decugis
201305,2302.477703,57,33,0,24,4,2002,Eleni Daniilidou
200029,2302.2915,24,17,0,7,45,1998,Lisa Mcshea
200595,2301.997502,48,27,0,21,5,1994,Ann Wunderlich
200653,2301.980215,43,24,0,19,1,1996,Yayuk Basuki
201492,2301.972482,61,35,0,26,3,2010,Andrea Petkovic
201290,2301.879947,70,41,0,29,1,2011,Daniela Hantuchova
201427,2301.147414,62,37,0,25,1,2014,Alize Cornet
200041,2301.038216,50,33,0,17,0,1992,Amy Frazier
200417,2300.683528,42,25,0,17,1,1992,Gigi Fernandez
201455,2300.133209,51,31,0,20,3,2009,Elena Vesnina
200422,2300.130378,41,27,0,14,2,1990,Raffaella Reggi Concato
200601,2300.121638,41,26,0,15,3,1994,Leila Meskhi
200079,2300.058891,18,14,0,4,25,2007,Kim Clijsters
200029,2299.788424,28,17,0,11,33,1997,Lisa Mcshea
200094,2299.76968,42,25,0,17,3,1993,Barbara Rittner
200085,2299.685992,58,33,0,25,4,2004,Ai Sugiyama
200002,2299.669424,18,14,0,4,3,1997,Mirjana Lucic
200098,2299.601703,34,20,0,14,0,1996,Henrieta Nagyova
200033,2299.44315,30,21,0,9,7,2005,Serena Williams
201297,2299.430759,51,29,0,22,5,2002,Maja Matevzic
200086,2299.208701,50,25,0,25,6,2000,Magdalena Maleeva
201349,2299.162846,50,29,0,21,1,2009,Melinda Czink
200097,2298.801944,50,29,0,21,1,1994,Nathalie Tauziat
200032,2298.751448,56,32,0,24,6,2000,Barbara Schett
201416,2298.672719,51,28,0,23,2,2008,Alona Bondarenko
201435,2298.62248,45,24,0,21,3,2009,Kateryna Bondarenko
201515,2298.593525,56,32,0,24,3,2009,Alisa Kleybanova
201320,2298.577736,46,29,0,17,3,2005,Svetlana Kuznetsova
201490,2298.574151,29,17,0,12,3,2009,Timea Bacsinszky
201355,2298.494578,50,30,0,20,1,2014,Flavia Pennetta
201387,2298.47273,53,32,0,21,2,2012,Sofia Arvidsson
201455,2298.450323,50,30,0,20,0,2013,Elena Vesnina
201420,2298.27933,50,30,0,20,3,2007,Sania Mirza
201212,2298.108703,64,39,0,25,1,2006,Francesca Schiavone
200653,2297.818819,56,34,0,22,1,1997,Yayuk Basuki
201414,2297.529075,45,28,0,17,1,2006,Michaella Krajicek
201400,2297.463959,19,14,0,5,3,2004,Nicole Vaidisova
201373,2297.43577,55,36,0,19,0,2013,Maria Kirilenko
200064,2297.405812,52,30,0,22,4,2002,Amanda Coetzer
201311,2297.216806,63,37,0,26,1,2011,Roberta Vinci
202494,2297.208594,65,41,0,24,1,2015,Elina Svitolina
200617,2296.371128,43,24,0,19,1,2010,Kimiko Date Krumm
200094,2296.329028,41,25,0,16,5,1992,Barbara Rittner
200023,2296.145471,29,18,0,11,9,1998,Bryanne Stewart
200080,2296.099716,46,26,0,20,11,2000,Dominique Monami
201311,2296.030707,57,31,0,26,1,2015,Roberta Vinci
200048,2296.018984,64,35,0,29,1,1998,Elena Likhovtseva
200067,2295.9783,58,34,0,24,4,2004,Patty Schnyder
200700,2295.96636,71,45,0,26,6,2001,Silvia Farina Elia
201325,2295.962827,58,34,0,24,1,2006,Samantha Stosur
201416,2295.820081,59,33,0,26,3,2009,Alona Bondarenko
200748,2295.755773,19,13,0,6,6,2006,Venus Williams
201386,2295.602861,45,29,0,16,6,2005,Jie Zheng
201397,2295.378414,47,24,0,23,5,2009,Shuai Peng
201355,2295.21041,55,33,0,22,3,2011,Flavia Pennetta
200037,2295.146142,46,25,0,21,2,1999,Sabine Appelmans
200081,2295.108632,45,25,0,20,1,1998,Anke Huber
200048,2295.051001,52,30,0,22,2,2005,Elena Likhovtseva
200404,2295.012858,40,24,0,16,1,1994,Zina Garrison
200676,2294.871569,27,17,0,10,8,1994,Mana Endo
202173,2294.595435,20,14,0,6,18,2003,Joana Cortez
200064,2294.247286,55,32,0,23,0,1998,Amanda Coetzer
201504,2293.99127,63,38,0,25,3,2011,Julia Goerges
201600,2293.987641,43,26,0,17,8,2013,Jamie Hampton
201466,2293.978356,38,20,0,18,3,2011,Kaia Kanepi
201371,2293.934662,34,19,0,15,4,2007,Vera Dushevina
201364,2293.764342,55,33,0,22,2,2005,Tatiana Golovin
200626,2293.458638,31,19,0,12,8,1991,Emanuela Zardo
201431,2293.343391,45,26,0,19,1,2009,Aravane Rezai
201619,2293.265129,41,24,0,17,3,2013,Madison Keys
201348,2293.198599,46,28,0,18,5,2014,Casey Dellacqua
200472,2292.797654,33,20,0,13,2,1993,Helen Kelesi
200554,2292.759297,53,31,0,22,1,1992,Brenda Schultz Mccarthy
201425,2292.655188,53,30,0,23,1,2012,Lucie Safarova
200772,2292.548009,49,31,0,18,3,2006,Anastasia Myskina
201496,2292.442645,63,40,0,23,1,2015,Caroline Wozniacki
202427,2291.977917,22,13,0,9,4,2015,Johanna Konta
200644,2291.976044,20,14,0,6,13,1990,Naoko Sawamatsu
200554,2291.86556,43,24,0,19,2,1991,Brenda Schultz Mccarthy
201336,2291.623357,17,12,0,5,7,2002,Dinara Safina
200006,2291.483526,40,24,0,16,4,1999,Karina Habsudova
200020,2291.311617,42,23,0,19,1,1996,Lisa Raymond
201425,2291.298604,47,30,0,17,5,2007,Lucie Safarova
201335,2291.149689,25,17,0,8,5,2002,Myriam Casanova
201363,2290.648042,58,34,0,24,2,2007,Gisela Dulko
200020,2290.549952,46,27,0,19,0,2003,Lisa Raymond
200684,2290.483508,26,17,0,9,1,1995,Shi Ting Wang
201371,2290.40797,42,24,0,18,1,2009,Vera Dushevina
200108,2290.384537,66,39,0,27,0,2002,Elena Dementieva
200360,2290.161599,43,25,0,18,1,1992,Pam Shriver
200097,2290.004437,46,27,0,19,2,1995,Nathalie Tauziat
201505,2289.94206,42,26,0,16,9,2015,Ekaterina Makarova
200751,2289.927589,15,11,0,4,26,2001,Conchita Martinez Granados
200563,2289.842102,17,12,0,5,50,1997,Jane Taylor
200644,2289.709468,36,23,0,13,11,1993,Naoko Sawamatsu
200497,2289.248824,38,22,0,16,2,1993,Patricia Hy Boulais
201486,2289.218853,37,22,0,15,1,2008,Aleksandra Wozniak
200009,2289.1631,26,17,0,9,4,2010,Tamarine Tanasugarn
200700,2289.122579,69,44,0,25,4,2004,Silvia Farina Elia
204174,2289.10869,12,9,0,3,9,1999,Satoko Kurioka
200644,2289.076652,37,24,0,13,6,1995,Naoko Sawamatsu
201474,2289.050335,23,15,0,8,1,2006,Agnieszka Radwanska
201425,2289.041567,61,35,0,26,0,2011,Lucie Safarova
201499,2288.527416,46,26,0,20,3,2014,Anastasia Pavlyuchenkova
201318,2288.468379,33,19,0,14,1,2008,Bethanie Mattek Sands
200650,2288.111378,37,23,0,14,6,1990,Isabel Cueto
200107,2287.960568,44,29,0,15,7,2001,Paola Suarez
201287,2287.953812,42,25,0,17,3,2010,Maria Jose Martinez Sanchez
201533,2287.739909,18,13,0,5,3,2013,Shuai Zhang
201540,2287.559725,62,36,0,26,3,2015,Kristina Mladenovic
200109,2287.527547,55,32,0,23,4,1999,Nathalie Dechy
201545,2287.430007,40,24,0,16,4,2010,Anastasija Sevastova
201286,2287.417128,53,29,0,24,2,2005,Anabel Medina Garrigues
201615,2287.180135,39,22,0,17,3,2015,Lesia Tsurenko
200096,2287.134932,43,26,0,17,3,2004,Mary Pierce
200109,2286.797545,60,34,0,26,4,2002,Nathalie Dechy
200530,2286.602469,50,31,0,19,4,1992,Radomira Zrubakova
206902,2286.536946,7,7,0,0,31,1998,Yamile Cordova
200095,2286.337619,30,17,0,13,3,1995,Linda Wild
200048,2286.260332,57,33,0,24,2,1996,Elena Likhovtseva
200002,2286.134416,7,7,0,0,17,1996,Mirjana Lucic
201517,2285.932828,51,29,0,22,2,2013,Magdalena Rybarikova
201373,2285.902498,54,28,0,26,2,2007,Maria Kirilenko
200110,2285.792481,34,22,0,12,6,1999,Fabiola Zuluaga
200026,2285.785724,41,23,0,18,3,1993,Florencia Labat
201366,2285.756587,53,29,0,24,3,2014,Barbora Zahlavova Strycova
200106,2285.753259,58,36,0,22,7,2001,Angeles Montolio
200011,2285.742945,46,28,0,18,4,2002,Katarina Srebotnik
200020,2285.716009,46,26,0,20,5,2000,Lisa Raymond
201419,2285.522989,34,22,0,12,20,2007,Na Li
200069,2285.404729,46,25,0,21,1,2011,Nadia Petrova
200697,2285.277436,58,32,0,26,2,2002,Janette Husarova
201535,2285.267595,36,22,0,14,4,2014,Coco Vandeweghe
201397,2285.014094,50,28,0,22,4,2014,Shuai Peng
200604,2284.882688,33,18,0,15,5,1991,Barbara Paulus
201524,2284.865315,56,29,0,27,4,2012,Urszula Radwanska
200041,2284.787049,43,25,0,18,2,1991,Amy Frazier
201420,2284.614037,43,27,0,16,4,2005,Sania Mirza
200041,2284.221578,36,20,0,16,1,1996,Amy Frazier
200037,2284.074332,67,39,0,28,0,1997,Sabine Appelmans
200007,2283.953725,15,11,0,4,7,1996,Silvija Talaja
201593,2283.840317,44,23,0,21,5,2012,Irina Camelia Begu
201508,2283.695644,24,15,0,9,4,2011,Petra Cetkovska
200011,2283.622826,54,30,0,24,2,2006,Katarina Srebotnik
200098,2283.573636,52,29,0,23,5,2001,Henrieta Nagyova
201085,2283.217541,41,25,0,16,8,2003,Shinobu Asagoe
201355,2283.031459,52,32,0,20,8,2006,Flavia Pennetta
201336,2282.831463,33,18,0,15,8,2003,Dinara Safina
200601,2282.782955,39,22,0,17,3,1993,Leila Meskhi
201421,2282.554705,39,25,0,14,6,2009,Ana Ivanovic
200630,2282.48983,41,24,0,17,2,1990,Laura Gildemeister
200002,2282.468296,28,17,0,11,7,1998,Mirjana Lucic
201302,2282.365874,34,21,0,13,8,2002,Clarisa Fernandez
201492,2282.358206,33,19,0,14,2,2013,Andrea Petkovic
200094,2282.270357,43,25,0,18,3,1994,Barbara Rittner
200003,2282.230443,19,13,0,6,1,1999,Justine Henin
200089,2281.961207,51,30,0,21,3,1993,Miriam Oremans
201290,2281.95778,59,35,0,24,1,2010,Daniela Hantuchova
201610,2281.843621,34,20,0,14,4,2014,Zarina Diyas
201347,2281.665627,60,38,0,22,4,2014,Jelena Jankovic
201584,2281.64603,40,23,0,17,3,2011,Ksenia Pervak
201444,2281.544299,39,24,0,15,2,2012,Su Wei Hsieh
201204,2281.533131,55,31,0,24,5,2001,Iroda Tulyaganova
201329,2281.433269,30,19,0,11,4,2002,Vera Zvonareva
201518,2281.354336,50,31,0,19,9,2011,Yanina Wickmayer
200080,2281.345881,34,20,0,14,6,1993,Dominique Monami
200748,2281.319216,27,16,0,11,4,2013,Venus Williams
202149,2281,12,9,0,3,50,1998,Eva Krejcova
201847,2281,14,10,0,4,59,2000,Mareze Joubert
203094,2281,14,10,0,4,63,2002,Petra Russegger
203184,2281,12,9,0,3,56,2002,Beti Sekulovski
202788,2281,12,9,0,3,45,2003,Kildine Chevalier
200039,2280.851998,45,28,0,17,1,1994,Chanda Rubin
200085,2280.559115,60,32,0,28,1,1997,Ai Sugiyama
200649,2280.303214,46,29,0,17,4,1994,Ginger Helgeson Nielsen
200651,2280.302655,35,21,0,14,10,1992,Sabine Hack
201368,2280.26879,57,33,0,24,4,2004,Karolina Sprem
201397,2280.225123,37,20,0,17,6,2006,Shuai Peng
201425,2279.748926,24,15,0,9,2,2005,Lucie Safarova
200085,2279.521449,61,35,0,26,4,2002,Ai Sugiyama
201360,2279.399201,41,22,0,19,1,2007,Julia Vakulenko
200112,2279.245673,37,23,0,14,3,1992,Julie Halard Decugis
200118,2279.085719,28,18,0,10,11,1997,Virginia Ruano Pascual
201501,2279.069738,53,28,0,25,3,2009,Olga Govortsova
201423,2278.640323,30,19,0,11,2,2013,Yvonne Meusburger
200638,2278.581847,45,27,0,18,6,1993,Stephanie Rottier
201504,2278.48669,64,36,0,28,4,2012,Julia Goerges
200075,2278.438598,17,12,0,5,1,1995,Jing Qian Yi
200667,2277.84991,39,23,0,16,5,1993,Ines Gorrochategui
200377,2277.722047,40,24,0,16,2,1995,Helena Sukova
200002,2277.610488,20,12,0,8,8,2014,Mirjana Lucic
200020,2277.523766,41,25,0,16,2,1995,Lisa Raymond
200085,2277.495806,55,30,0,25,1,2006,Ai Sugiyama
201325,2277.469556,30,18,0,12,2,2008,Samantha Stosur
200096,2277.380628,32,19,0,13,9,1996,Mary Pierce
200117,2277.235757,43,22,0,21,1,2005,Kveta Peschke
200039,2277.185882,31,19,0,12,10,2004,Chanda Rubin
201729,2277.027153,8,7,0,1,41,1998,Larissa Schaerer
203002,2276.986591,6,6,0,0,32,1998,Karin Palme
200027,2276.89998,64,39,0,25,5,2003,Magui Serna
201054,2276.881993,22,14,0,8,12,1990,Katia Piccolini
201426,2276.865837,13,9,0,4,5,2007,Pauline Parmentier
201506,2276.846228,59,35,0,24,5,2014,Sara Errani
200085,2276.685772,55,28,0,27,1,2005,Ai Sugiyama
200046,2276.610076,47,27,0,20,1,2006,Meghann Shaughnessy
200665,2276.493834,35,22,0,13,3,1995,Yone Kamio
201373,2276.435727,56,34,0,22,2,2008,Maria Kirilenko
201363,2276.400697,59,34,0,25,2,2005,Gisela Dulko
201082,2276.265233,16,11,0,5,19,1997,Lorna Woodroffe
203058,2276.170921,13,9,0,4,9,1998,Yoshiko Sasano
200015,2276.167962,45,27,0,18,5,2003,Petra Mandula
201290,2276.153892,39,22,0,17,7,2001,Daniela Hantuchova
200026,2276.007963,44,28,0,16,5,1994,Florencia Labat
201729,2275.986687,6,6,0,0,25,1997,Larissa Schaerer
200450,2275.947484,40,20,0,20,3,1994,Larisa Savchenko
200109,2275.916621,51,31,0,20,15,2000,Nathalie Dechy
201458,2275.513417,24,15,0,9,7,2014,Victoria Azarenka
202329,2275.425672,6,6,0,0,32,1998,Jessica Fernandez
201419,2275.310522,7,6,0,1,8,2004,Na Li
200026,2275.303698,38,20,0,18,7,1992,Florencia Labat
206376,2275.08014,6,6,0,0,27,2012,Nour Abbes
200660,2275.07112,39,20,0,19,1,1993,Kimberly Po Messerli
200020,2274.991858,50,29,0,21,4,2002,Lisa Raymond
201427,2274.922355,64,36,0,28,0,2013,Alize Cornet
200120,2274.733059,58,28,0,30,5,2003,Jelena Dokic
200037,2274.523475,33,21,0,12,4,1990,Sabine Appelmans
200111,2274.495094,41,22,0,19,5,2003,Lina Krasnoroutskaya
201505,2274.382028,45,26,0,19,4,2012,Ekaterina Makarova
200116,2274.359455,30,16,0,14,4,1996,Natalia Zvereva
201386,2274.251263,50,28,0,22,5,2009,Jie Zheng
200764,2274.138736,21,13,0,8,22,2005,Elena Bovina
201481,2273.992052,32,17,0,15,2,2007,Tamira Paszek
203084,2273.928514,18,12,0,6,39,2001,Daniela Olivera
201448,2273.842985,24,14,0,10,3,2011,Galina Voskoboeva
200049,2273.615384,54,28,0,26,2,2002,Conchita Martinez
200049,2273.52603,51,30,0,21,6,2003,Conchita Martinez
200117,2273.515322,38,20,0,18,2,2000,Kveta Peschke
201347,2273.085435,61,38,0,23,2,2010,Jelena Jankovic
200045,2273.024102,34,20,0,14,1,1998,Tara Snyder
201521,2272.905387,66,41,0,25,1,2015,Carla Suarez Navarro
200644,2272.853262,47,24,0,23,4,1997,Naoko Sawamatsu
202429,2272.849746,48,28,0,20,3,2014,Camila Giorgi
201083,2272.800789,23,13,0,10,2,2000,Daja Bedanova
201417,2272.620253,19,12,0,7,4,2004,Marta Domachowska
200032,2272.433494,42,23,0,19,3,1996,Barbara Schett
201619,2272.366768,51,28,0,23,4,2014,Madison Keys
200063,2272.326203,66,35,0,31,1,2002,Tatiana Panova
200699,2272.322548,27,15,0,12,2,1990,Meredith Mcgrath
200494,2272.315285,39,23,0,16,6,1990,Dianne Van Rensburg
201585,2272.230344,38,21,0,17,10,2012,Sloane Stephens
201431,2272.192785,18,12,0,6,1,2006,Aravane Rezai
200725,2271.537718,37,23,0,14,9,1991,Sandra Cecchini
200632,2271.468548,43,25,0,18,4,1992,Andrea Strnadova
200032,2271.35835,56,31,0,25,7,2001,Barbara Schett
200049,2271.353504,35,20,0,15,1,2001,Conchita Martinez
201363,2271.330744,50,30,0,20,6,2009,Gisela Dulko
201457,2271.180542,31,19,0,12,3,2010,Jarmila Gajdosova
201305,2271.178428,51,27,0,24,1,2006,Eleni Daniilidou
200417,2271.114965,34,17,0,17,4,1994,Gigi Fernandez
201520,2271.107121,38,21,0,17,3,2009,Petra Kvitova
201344,2271.033384,54,29,0,25,3,2011,Klara Koukalova
200597,2271.022122,30,17,0,13,6,1999,Mary Joe Fernandez
200086,2271.007238,51,30,0,21,7,2003,Magdalena Maleeva
201513,2270.916988,42,22,0,20,9,2015,Sabine Lisicki
200110,2270.898298,49,29,0,20,4,2004,Fabiola Zuluaga
201286,2270.892971,62,37,0,25,4,2006,Anabel Medina Garrigues
200673,2270.829105,36,21,0,15,2,1990,Susan Sloane Lundy
200026,2270.77176,33,19,0,14,3,1995,Florencia Labat
201540,2270.751007,15,10,0,5,2,2012,Kristina Mladenovic
200064,2270.720266,57,33,0,24,0,1996,Amanda Coetzer
201355,2270.603849,35,21,0,14,13,2012,Flavia Pennetta
201306,2270.441577,39,21,0,18,4,2002,Marie Gaiane Mikaelian
200064,2270.302863,53,32,0,21,6,2001,Amanda Coetzer
200041,2270.262359,37,19,0,18,4,2002,Amy Frazier
200539,2270.255641,41,26,0,15,6,1999,Jana Novotna
201495,2270.227201,56,32,0,24,3,2010,Dominika Cibulkova
201286,2270.073763,12,9,0,3,64,2002,Anabel Medina Garrigues
200094,2269.978172,39,21,0,18,4,1991,Barbara Rittner
200026,2269.858976,47,27,0,20,0,1996,Florencia Labat
201435,2269.821261,26,16,0,10,4,2011,Kateryna Bondarenko
200118,2269.636474,38,22,0,16,3,1998,Virginia Ruano Pascual
201518,2269.557942,56,35,0,21,1,2010,Yanina Wickmayer
200032,2269.153611,48,26,0,22,3,2002,Barbara Schett
200067,2268.861847,48,24,0,24,5,2001,Patty Schnyder
201083,2268.742527,40,20,0,20,7,2001,Daja Bedanova
201420,2268.69366,30,17,0,13,4,2009,Sania Mirza
200357,2268.585652,46,26,0,20,2,1990,Rosalyn Nideffer
200020,2268.559885,52,29,0,23,1,1998,Lisa Raymond
200682,2268.336998,47,25,0,22,1,1997,Joannette Kruger
200011,2267.552455,51,28,0,23,2,2007,Katarina Srebotnik
200482,2267.534301,30,18,0,12,6,1997,Judith Wiesner
203143,2267.5,11,8,0,3,56,2002,Nicole Sewell
203010,2267.492429,7,6,0,1,10,1997,Ryoko Takemura
200034,2267.403573,25,15,0,10,10,1997,Amanda Grahame
200016,2267.337783,38,21,0,17,3,1996,Sandrine Testud
200061,2267.330659,46,24,0,22,7,2001,Gala Leon Garcia
201590,2267.312063,47,24,0,23,3,2014,Alison Riske
201506,2267.271784,66,37,0,29,3,2010,Sara Errani
200027,2267.192417,52,28,0,24,2,1998,Magui Serna
201327,2267.159397,28,16,0,12,1,2002,Angelique Widjaja
200085,2267.058983,53,28,0,25,5,2001,Ai Sugiyama
201352,2266.975706,13,9,0,4,8,1996,Akiko Morigami
202265,2266.975706,13,9,0,4,59,2000,Mirielle Dittmann
203089,2266.975706,13,9,0,4,59,2000,Kristen Van Elden
203117,2266.975706,11,8,0,3,59,2000,Jenny Belobrajdic
203184,2266.975706,9,7,0,2,52,2001,Beti Sekulovski
201433,2266.975706,13,9,0,4,45,2003,Sarah Borwell
200007,2266.927063,56,32,0,24,0,1999,Silvija Talaja
201498,2266.907903,35,20,0,15,2,2013,Karin Knapp
200378,2266.904028,30,16,0,14,2,1990,Anne Smith
200501,2266.691533,44,22,0,22,1,1994,Marianne Werdel Witmeyer
201593,2266.616851,53,31,0,22,3,2015,Irina Camelia Begu
201348,2266.473243,11,8,0,3,56,2002,Casey Dellacqua
201293,2266.461411,10,8,0,2,24,2002,Catalina Castano
202149,2266.449837,13,9,0,4,62,1997,Eva Krejcova
201478,2266.303574,45,25,0,20,4,2012,Varvara Lepchenko
200003,2266.150163,31,17,0,14,1,2000,Justine Henin
200084,2266.038225,45,23,0,22,4,1995,Asa Svensson
200051,2265.855581,15,10,0,5,3,1993,Irina Spirlea
201387,2265.780137,24,15,0,9,1,2005,Sofia Arvidsson
201288,2265.664769,5,5,0,0,45,1992,Maja Palaversic Cooper Smith
200059,2265.631013,63,37,0,26,0,1997,Ruxandra Dragomir Ilie
201593,2265.622802,27,16,0,11,5,2011,Irina Camelia Begu
206583,2265.465953,5,5,0,0,52,1999,Monica Poveda
200089,2265.428685,33,19,0,14,8,2000,Miriam Oremans
201403,2265.415738,45,24,0,21,2,2005,Anna Chakvetadze
200703,2265.40736,48,27,0,21,2,1996,Katarina Studenikova
207947,2265.328881,7,6,0,1,28,2001,Yamile Fors Guerra
200058,2265.254769,5,5,0,0,46,1997,Anna Foldenyi Dicker
201621,2265.120397,46,23,0,23,3,2014,Mona Barthel
200595,2265.04856,40,23,0,17,1,1992,Ann Wunderlich
200729,2264.968067,24,13,0,11,3,1995,Lindsay Lee Waters
202281,2264.950652,5,5,0,0,35,2004,Ivanna Israilova
200085,2264.904313,52,28,0,24,2,1999,Ai Sugiyama
203570,2264.813697,5,5,0,0,41,2012,Bermet Duvanaeva
201459,2264.691141,12,8,0,4,6,2005,Zi Yan
200105,2264.678557,45,26,0,19,4,1990,Rachel Mcquillan
200110,2264.645471,42,23,0,19,7,2003,Fabiola Zuluaga
200039,2264.611016,39,20,0,19,3,1998,Chanda Rubin
200450,2264.598966,42,24,0,18,1,1993,Larisa Savchenko
206910,2264.58208,7,6,0,1,31,1998,Mari Toro
201397,2264.504921,51,26,0,25,2,2008,Shuai Peng
201586,2264.498904,35,18,0,17,5,2012,Heather Watson
204591,2264.426915,13,9,0,4,46,2002,Elsa Oriain
212410,2264.422413,5,5,0,0,29,1996,Belkis Rodriguez
201323,2264.350993,37,20,0,17,3,2003,Saori Obata
201590,2264.335982,17,11,0,6,8,2013,Alison Riske
200501,2264.253163,39,21,0,18,1,1993,Marianne Werdel Witmeyer
200421,2264.229789,38,21,0,17,4,1992,Pascale Paradis Mangon
201306,2264.202012,14,9,0,5,8,2001,Marie Gaiane Mikaelian
201603,2264.164014,21,12,0,9,4,2014,Shelby Rogers
202339,2264.034524,5,5,0,0,37,2013,Ayu Fani Damayanti
201347,2263.976175,67,38,0,29,1,2005,Jelena Jankovic
201380,2263.956996,5,5,0,0,25,1998,Claudine Schaul
200696,2263.895165,5,5,0,0,25,1995,Christina Papadaki
200653,2263.883113,37,23,0,14,1,1994,Yayuk Basuki
208260,2263.836531,5,5,0,0,26,2006,Dijana Stojic
201490,2263.781957,23,13,0,10,3,2014,Timea Bacsinszky
200377,2263.769034,37,21,0,16,5,1996,Helena Sukova
200660,2263.743114,48,28,0,20,3,1997,Kimberly Po Messerli
200044,2263.652351,35,20,0,15,0,1999,Denisa Chladkova
201514,2263.619765,62,35,0,27,3,2013,Sorana Cirstea
204540,2263.55255,5,5,0,0,43,1994,Maria Virginia Francesca
200664,2263.538521,13,7,0,6,2,1990,Stephanie Rehe
201446,2263.510858,54,29,0,25,1,2008,Sybille Bammer
207543,2263.48692,5,5,0,0,44,2001,Jennifer Saret
200700,2263.46188,60,33,0,27,3,1999,Silvia Farina Elia
202510,2263.418877,5,5,0,0,33,1997,Natacha Randriantefy
204123,2263.371149,5,5,0,0,44,1994,Maria Dolores Campana
201397,2263.28242,36,20,0,16,6,2005,Shuai Peng
201441,2263.076713,7,6,0,1,13,2008,Emma Laine
201555,2263.027564,56,30,0,26,3,2011,Polona Hercog
207536,2262.990861,5,5,0,0,52,1999,Carla Rodriguez
200075,2262.924223,5,5,0,0,56,1997,Jing Qian Yi
204123,2262.900668,5,5,0,0,27,1996,Maria Dolores Campana
202506,2262.80072,16,10,0,6,3,2015,Margarita Gasparyan
202505,2262.791161,37,19,0,18,4,2014,Belinda Bencic
201403,2262.759398,33,18,0,15,3,2010,Anna Chakvetadze
201322,2262.574384,5,5,0,0,34,1997,Eva Dyrberg
204169,2262.488374,5,5,0,0,44,2000,Luiza Biktyakova
201363,2262.486396,45,24,0,21,8,2004,Gisela Dulko
204690,2262.483522,5,5,0,0,44,2001,Czarina Mae Arevalo
206174,2262.470901,5,5,0,0,27,2012,Cecilia Costa Melgar
200124,2262.40897,57,31,0,26,4,2000,Anne Kremer
201204,2262.38442,44,25,0,19,16,2003,Iroda Tulyaganova
200563,2262.290129,14,9,0,5,54,1996,Jane Taylor
200020,2262.285454,36,19,0,17,1,1994,Lisa Raymond
200001,2262.172618,32,20,0,12,7,2007,Martina Hingis
206060,2262.010598,5,5,0,0,27,2012,Ani Amiraghyan
202275,2262.006171,5,5,0,0,56,1997,Tagifano Soonalole
201355,2262.003384,39,19,0,20,3,2013,Flavia Pennetta
200009,2261.991661,56,32,0,24,3,2003,Tamarine Tanasugarn
204561,2261.956559,5,5,0,0,33,1997,Ana Gaspar
201850,2261.956082,5,5,0,0,25,1998,Nino Louarsabishvili
201212,2261.940081,50,26,0,24,2,2008,Francesca Schiavone
201355,2261.929955,52,30,0,22,5,2004,Flavia Pennetta
201498,2261.866442,42,22,0,20,9,2015,Karin Knapp
204488,2261.69419,7,6,0,1,25,1997,Elena Juricich
200511,2261.674019,5,5,0,0,25,1995,Amy Jonsson Raaholt
205600,2261.565311,5,5,0,0,26,2009,Anna Movsisyan
200039,2261.498154,32,16,0,16,7,2001,Chanda Rubin
201390,2261.48721,5,5,0,0,26,2006,Mervana Jugic Salkic
200061,2261.430856,42,23,0,19,6,2000,Gala Leon Garcia
200049,2261.162103,39,22,0,17,11,2004,Conchita Martinez
200127,2261.142493,49,28,0,21,0,1999,Sarah Pitkowski Malcor
201836,2261.099463,5,5,0,0,52,2000,Svetlana Komleva
212165,2261.03093,5,5,0,0,27,2002,Anneliese Rose
200016,2260.987222,35,19,0,16,3,1995,Sandrine Testud
206529,2260.963613,5,5,0,0,46,1996,Hanna Katri Aalto
204756,2260.802668,5,5,0,0,22,1993,Maria Alejandra Quezada
200632,2260.765891,41,23,0,18,5,1991,Andrea Strnadova
201567,2260.706914,61,35,0,26,3,2010,Alexandra Dulgheru
201392,2260.610133,31,17,0,14,1,2006,Severine Beltrame
200124,2260.361343,10,7,0,3,3,1998,Anne Kremer
200041,2260.228094,19,10,0,9,1,1993,Amy Frazier
203855,2260.201193,22,14,0,8,9,1999,Kate Warne Holland
200048,2260.0837,19,11,0,8,6,1993,Elena Likhovtseva
200085,2259.955076,33,16,0,17,3,1995,Ai Sugiyama
202429,2259.868851,50,27,0,23,4,2015,Camila Giorgi
204481,2259.866915,24,13,0,11,10,1997,Kylie Moulds
201465,2259.847792,58,33,0,25,2,2013,Kirsten Flipkens
200506,2259.771807,29,16,0,13,4,1992,Wiltrud Probst
200671,2259.509856,25,15,0,10,19,1995,Meike Babel
200008,2259.378221,45,27,0,18,5,2003,Alicia Molik
201628,2259.348808,7,6,0,1,5,1996,Li Li
200089,2259.261777,41,22,0,19,4,1995,Miriam Oremans
200640,2259.10265,38,20,0,18,2,1990,Mercedes Paz
200051,2258.96439,42,24,0,18,3,1994,Irina Spirlea
206904,2258.751641,7,6,0,1,31,1998,Yoannis Montesino
200122,2258.721293,53,29,0,24,4,2002,Tina Pisnik
200653,2258.695207,31,19,0,12,2,1991,Yayuk Basuki
200548,2258.625016,34,17,0,17,2,1992,Patty Fendick
200612,2258.610555,29,15,0,14,2,1990,Natalia Medvedeva
201313,2258.57697,22,13,0,9,1,2002,Yoon Jeong Cho
201327,2258.499641,6,5,0,1,11,2001,Angelique Widjaja
201293,2258.05263,43,25,0,18,4,2005,Catalina Castano
202653,2258.047229,26,15,0,11,3,2015,Denisa Allertova
200040,2258.004398,53,30,0,23,6,2000,Anna Smashnova
201447,2257.948332,30,16,0,14,1,2006,Vania King
201486,2257.803832,7,6,0,1,17,2004,Aleksandra Wozniak
201493,2257.748527,42,23,0,19,3,2010,Angelique Kerber
200754,2257.392826,34,19,0,15,4,2002,Jill Craybas
201495,2257.300779,35,19,0,16,3,2015,Dominika Cibulkova
201450,2257.248707,10,7,0,3,7,2005,Tsvetana Pironkova
201292,2257.216334,23,13,0,10,5,2001,Martina Sucha
201523,2257.206605,19,11,0,8,8,2011,Marina Erakovic
201468,2257.021274,34,20,0,14,4,2012,Yaroslava Shvedova
200360,2257.006262,39,21,0,18,5,1991,Pam Shriver
200116,2256.943629,48,26,0,22,4,1999,Natalia Zvereva
200644,2256.851289,39,22,0,17,11,1991,Naoko Sawamatsu
200428,2256.837498,38,19,0,19,2,1995,Lori Mcneil
201495,2256.719342,53,28,0,25,2,2013,Dominika Cibulkova
201402,2256.57146,16,11,0,5,3,2004,Sesil Karatantcheva
200354,2256.528838,32,17,0,15,4,1990,Claudia Kohde Kilsch
200032,2256.468683,46,23,0,23,5,1997,Barbara Schett
200086,2256.36585,20,12,0,8,0,1999,Magdalena Maleeva
201371,2256.146945,38,19,0,19,3,2010,Vera Dushevina
201517,2256.139804,9,7,0,2,17,2006,Magdalena Rybarikova
201402,2256.088224,36,20,0,16,1,2005,Sesil Karatantcheva
202292,2255.926749,12,8,0,4,9,1999,Ayami Takase
200067,2255.907106,45,23,0,22,3,2009,Patty Schnyder
200066,2255.848365,35,21,0,14,6,1999,Cristina Torrens Valero
201454,2255.7731,11,8,0,3,5,2005,Akgul Amanmuradova
200606,2255.667973,16,9,0,7,0,1994,Nana Smith
201573,2255.662909,32,16,0,16,5,2012,Laura Robson
200667,2255.580924,28,16,0,12,3,1995,Ines Gorrochategui
201397,2255.560272,37,19,0,18,3,2007,Shuai Peng
204175,2255.547687,12,8,0,4,9,1998,Akiko Gunji
201328,2255.534777,19,12,0,7,14,2007,Milagros Sequera
200064,2255.4781,52,32,0,20,6,2003,Amanda Coetzer
200772,2255.427479,16,10,0,6,0,1999,Anastasia Myskina
200082,2255.407894,42,24,0,18,4,1995,Kristie Boogert
201212,2255.237917,49,25,0,24,2,2013,Francesca Schiavone
200061,2255.062015,37,19,0,18,10,1998,Gala Leon Garcia
200125,2254.849393,45,22,0,23,2,1999,Corina Morariu
200469,2254.774671,42,22,0,20,2,1991,Nicole Bradtke
200740,2254.546263,9,7,0,2,3,1996,Elena Tatarkova
200617,2254.427576,24,13,0,11,11,1991,Kimiko Date Krumm
203071,2254.15924,15,9,0,6,52,1997,Jenny Ann Fetch
200067,2254.089846,59,33,0,26,9,2000,Patty Schnyder
200113,2254.075158,53,28,0,25,7,2002,Anna Kournikova
204474,2254,12,8,0,4,52,1999,Susan Cowan
201708,2254,12,8,0,4,59,2000,Natalie Grandin
201488,2254,12,8,0,4,63,2002,Jorgelina Cravero
201667,2254,4,4,0,0,50,2011,Ling Zhang
202339,2254,4,4,0,0,50,2011,Ayu Fani Damayanti
203290,2253.955765,4,4,0,0,25,2010,Piia Suomalainen
201209,2253.937991,10,7,0,3,14,2004,Selima Sfar
201373,2253.765526,45,21,0,24,3,2009,Maria Kirilenko
201292,2253.709045,41,21,0,20,3,2004,Martina Sucha
201528,2253.662573,25,12,0,13,0,2009,Melanie Oudin
201416,2253.598419,46,24,0,22,2,2006,Alona Bondarenko
202440,2253.542626,23,15,0,8,5,2013,Paula Ormaechea
201539,2253.440962,38,19,0,19,4,2011,Christina Mchale
203191,2253.437517,4,4,0,0,30,2011,Danica Krstajic
204539,2253.362355,4,4,0,0,25,1997,Laura Bernal
200715,2253.249418,20,10,0,10,4,1995,Mariaan De Swardt
201578,2253.198918,28,15,0,13,2,2012,Kai Chen Chang
201521,2253.124178,38,23,0,15,3,2010,Carla Suarez Navarro
200041,2253.121809,34,18,0,16,1,2005,Amy Frazier
202745,2252.930348,4,4,0,0,53,1998,Uzma Khan
207460,2252.912367,4,4,0,0,39,1992,Isabela Petrov
206913,2252.855996,4,4,0,0,36,2000,Paola Guerrero
202071,2252.837971,4,4,0,0,34,1997,Dragana Zaric
214082,2252.761994,12,7,0,5,3,2015,Darya Kasatkina
200657,2252.755708,23,15,0,8,3,1993,Radka Bobkova
201086,2252.606479,16,10,0,6,16,2008,Greta Arn
200117,2252.595437,33,15,0,18,2,1999,Kveta Peschke
201899,2252.532567,4,4,0,0,39,1992,Luciana Tella
201305,2252.494667,56,27,0,29,2,2007,Eleni Daniilidou
203882,2252.469206,4,4,0,0,45,1993,Lucila Becerra
206039,2252.464949,4,4,0,0,31,2010,Marie Elise Casares
202071,2252.451255,4,4,0,0,25,1995,Dragana Zaric
207166,2252.414494,4,4,0,0,30,1999,Ismet Duygu Aksit Oal
203521,2252.412532,4,4,0,0,23,2011,Andrea Gamiz
207947,2252.410758,4,4,0,0,52,1999,Yamile Fors Guerra
202604,2252.410073,4,4,0,0,25,2013,Despina Papamichail
205143,2252.409646,4,4,0,0,33,2003,Valentina Castro
202331,2252.409143,4,4,0,0,33,2003,Vilmarie Castellvi
209192,2252.389739,4,4,0,0,26,2009,Misleydis Diaz Gonzalez
204595,2252.372749,4,4,0,0,52,2000,Charlotte Aagaard
200078,2252.31841,27,14,0,13,3,1999,Barbara Schwartz
201204,2252.291889,24,15,0,9,4,2000,Iroda Tulyaganova
200699,2252.253888,38,22,0,16,1,1994,Meredith Mcgrath
201642,2252.228264,6,5,0,1,26,2012,Fatima El Allami
200087,2252.227361,8,6,0,2,13,2001,Seda Noorlander
201344,2252.194501,46,24,0,22,4,2012,Klara Koukalova
200009,2252.176401,38,20,0,18,1,2008,Tamarine Tanasugarn
200020,2252.074177,45,22,0,23,1,1999,Lisa Raymond
200012,2252.073751,4,4,0,0,34,2003,Jana Nejedly
202714,2252.002272,4,4,0,0,25,1998,Marina Lazarovska
201683,2251.966857,6,5,0,1,31,2010,Bianca Botto
212571,2251.966691,4,4,0,0,52,1995,Chern Yi Chiew
202705,2251.965959,4,4,0,0,45,2010,Veronica Cepede Royg
206505,2251.964496,4,4,0,0,25,1998,Kirsi Lampinen
212082,2251.949683,4,4,0,0,30,2004,Lisa Camenzuli
201545,2251.929224,4,4,0,0,25,2008,Anastasija Sevastova
202705,2251.928496,4,4,0,0,31,2007,Veronica Cepede Royg
201441,2251.909692,4,4,0,0,26,2014,Emma Laine
212081,2251.89449,4,4,0,0,32,1997,Helen Asciak
206240,2251.891173,4,4,0,0,31,2010,Patricia Ku Flores
200748,2251.7907,12,8,0,4,9,2011,Venus Williams
200723,2251.720335,47,26,0,21,1,1998,Iva Majoli
204578,2251.578503,6,5,0,1,27,1996,Deborah Gaviria
201499,2251.567833,45,24,0,21,3,2009,Anastasia Pavlyuchenkova
200085,2251.522638,50,26,0,24,2,2008,Ai Sugiyama
204420,2251.504426,4,4,0,0,27,2012,Marcela Zacarias
201450,2251.499539,34,18,0,16,3,2006,Tsvetana Pironkova
202714,2251.47164,4,4,0,0,52,2000,Marina Lazarovska
207947,2251.466733,4,4,0,0,26,2009,Yamile Fors Guerra
208983,2251.462159,4,4,0,0,25,2008,Larikah Russell
207543,2251.461867,4,4,0,0,57,1997,Jennifer Saret
211533,2251.446672,4,4,0,0,25,2013,Jelena Ostapenko
202365,2251.446671,4,4,0,0,37,2013,Lavinia Tananta
201466,2251.428973,4,4,0,0,52,2000,Kaia Kanepi
200092,2251.426074,4,4,0,0,34,1997,Sandra Nacuk
202266,2251.42536,4,4,0,0,52,2000,Kelly Liggan
200700,2251.399288,74,44,0,30,0,2002,Silvia Farina Elia
205143,2251.389599,4,4,0,0,28,2001,Valentina Castro
201969,2251.389528,4,4,0,0,20,1991,Karin Ptaszek
200667,2251.306683,24,14,0,10,10,1999,Ines Gorrochategui
200501,2251.303001,40,21,0,19,2,1991,Marianne Werdel Witmeyer
200048,2251.267678,50,25,0,25,7,2001,Elena Likhovtseva
201318,2251.213291,28,14,0,14,5,2015,Bethanie Mattek Sands
200667,2251.188145,10,7,0,3,0,1991,Ines Gorrochategui
201419,2251.091213,10,7,0,3,10,2000,Na Li
200095,2251.068241,39,20,0,19,2,1991,Linda Wild
200048,2251.061658,60,31,0,29,3,2000,Elena Likhovtseva
200050,2251.023527,8,6,0,2,10,1995,Sandra Kleinova
206910,2250.986282,4,4,0,0,28,2001,Mari Toro
200693,2250.985503,30,16,0,14,3,1994,Elena Makarova
202942,2250.969134,4,4,0,0,32,1994,Maricris Gentz
201281,2250.964927,21,11,0,10,4,2002,Laura Granville
202779,2250.950286,4,4,0,0,26,2005,Tinatin Kavlashvili
207166,2250.941852,4,4,0,0,30,2001,Ismet Duygu Aksit Oal
202245,2250.93964,4,4,0,0,36,2002,Desislava Topalova
202348,2250.926915,4,4,0,0,26,2014,Lina Stanciute
212165,2250.922347,4,4,0,0,36,2000,Anneliese Rose
205918,2250.896837,4,4,0,0,31,2011,Ulrikke Eikeri
201411,2250.636181,40,22,0,18,4,2006,Aiko Nakamura
202752,2250.622159,12,8,0,4,10,1997,Aurandrea Narvaez
200064,2250.589577,67,41,0,26,0,1999,Amanda Coetzer
203939,2250.535272,6,5,0,1,27,1996,Maria Eugenia Rojas
202581,2250.47946,4,4,0,0,30,2011,Chanel Simmonds
205918,2250.445928,4,4,0,0,25,2008,Ulrikke Eikeri
206891,2250.431764,4,4,0,0,46,1996,Sandra Olsen
201729,2250.430982,4,4,0,0,35,2004,Larissa Schaerer
203244,2250.424141,4,4,0,0,31,2007,Estefania Craciun
201390,2250.421951,4,4,0,0,30,2001,Mervana Jugic Salkic
203067,2250.419724,4,4,0,0,57,1997,Irina Yarikova
200743,2250.411642,4,4,0,0,52,1995,Nirupama Sanjeev
206447,2250.35909,6,5,0,1,31,1998,Ingrid Gonzalez
200716,2250.355387,28,16,0,12,1,1995,Sung Hee Park
201204,2250.305219,12,8,0,4,5,2006,Iroda Tulyaganova
200076,2250.118667,36,20,0,16,11,1996,Laurence Courtois
201431,2250.068299,61,36,0,25,1,2010,Aravane Rezai
201674,2250.032378,4,4,0,0,43,2014,Sabina Sharipova
201591,2249.938405,4,4,0,0,53,2000,Margalita Chakhnashvili
201414,2249.888696,19,12,0,7,8,2011,Michaella Krajicek
201486,2249.855977,38,20,0,18,9,2012,Aleksandra Wozniak
200036,2249.557925,45,24,0,21,8,2002,Nicole Pratt
202946,2249.442506,14,9,0,5,27,2003,Christina Zachariadou
200542,2249.43756,35,19,0,16,4,1993,Clare Wood
202460,2249.386819,8,6,0,2,14,2012,Ons Jabeur
200052,2249.326664,41,22,0,19,0,1998,Olga Barabanschikova
202705,2249.3243,6,5,0,1,14,2012,Veronica Cepede Royg
201380,2249.311123,6,5,0,1,14,2000,Claudine Schaul
200041,2249.261888,34,17,0,17,1,1997,Amy Frazier
200118,2249.224107,37,19,0,18,5,2003,Virginia Ruano Pascual
201518,2249.155833,35,18,0,17,3,2015,Yanina Wickmayer
201368,2249.010923,24,14,0,10,5,2003,Karolina Sprem
202942,2248.982159,6,5,0,1,44,2000,Maricris Gentz
200089,2248.949745,34,16,0,18,3,1994,Miriam Oremans
201512,2248.910618,42,23,0,19,3,2014,Monica Niculescu
201624,2248.886776,6,5,0,1,17,1996,Eun Ha Kim
200046,2248.848829,43,23,0,20,5,2000,Meghann Shaughnessy
200595,2248.840025,43,22,0,21,3,1990,Ann Wunderlich
201212,2248.812916,11,7,0,4,16,2000,Francesca Schiavone
200676,2248.722473,27,15,0,12,9,1993,Mana Endo
211702,2248.646866,8,6,0,2,4,2015,Nao Hibino
203584,2248.552273,4,4,0,0,23,2011,Adriana Perez
200511,2248.544124,8,6,0,2,22,1991,Amy Jonsson Raaholt
200089,2248.476316,36,18,0,18,4,1997,Miriam Oremans
200124,2248.473857,63,34,0,29,5,2001,Anne Kremer
201547,2248.381252,14,8,0,6,5,2008,Michelle Larcher De Brito
202440,2248.33389,15,10,0,5,20,2012,Paula Ormaechea
200014,2248.285773,6,5,0,1,20,2001,Tzipi Obziler
200041,2248.281303,27,14,0,13,4,2003,Amy Frazier
200125,2248.264972,46,25,0,21,1,1998,Corina Morariu
201517,2248.219382,53,27,0,26,1,2009,Magdalena Rybarikova
201291,2248.165079,28,17,0,11,2,2008,Nuria Llagostera Vives
200066,2248.112633,54,30,0,24,7,2001,Cristina Torrens Valero
202509,2248.057528,6,5,0,1,25,1997,Joelle Schad
202507,2247.990852,6,5,0,1,0,2012,Wing Yau Venise Chan
212378,2247.981701,6,5,0,1,31,1998,Joanna Bauza
200021,2247.834015,40,21,0,19,7,1992,Alexia Dechaume Balleret
201352,2247.682986,42,22,0,20,5,2005,Akiko Morigami
201492,2247.655761,19,11,0,8,4,2009,Andrea Petkovic
202321,2247.653434,14,9,0,5,3,2003,Napaporn Tongsalee
202348,2247.617642,6,5,0,1,27,2012,Lina Stanciute
204690,2247.601461,6,5,0,1,44,2000,Czarina Mae Arevalo
200020,2247.541289,13,7,0,6,1,1992,Lisa Raymond
202988,2247.519423,7,5,0,2,9,1999,Kyung Yee Chae
201286,2247.478252,51,27,0,24,2,2007,Anabel Medina Garrigues
201419,2247.433366,6,5,0,1,20,2002,Na Li
200083,2247.229447,24,13,0,11,1,1999,Alexandra Stevenson
201523,2247.214545,37,21,0,16,7,2013,Marina Erakovic
201386,2247.105572,41,23,0,18,9,2010,Jie Zheng
202413,2247.024953,6,5,0,1,27,2012,Florencia Molinero
200080,2247.013288,21,12,0,9,3,1995,Dominique Monami
200006,2246.816095,29,14,0,15,3,1991,Karina Habsudova
201541,2246.793654,39,20,0,19,4,2011,Chanelle Scheepers
202499,2246.756898,10,7,0,3,0,2012,Donna Vekic
200065,2246.692576,40,20,0,20,2,1998,Amelie Mauresmo
201379,2246.677326,55,30,0,25,1,2006,Mara Santangelo
201605,2246.619841,7,5,0,2,3,2010,Mandy Minella
201497,2246.605314,47,24,0,23,1,2009,Agnes Szavay
200114,2246.576907,21,13,0,8,3,2002,Patricia Wartusch
201963,2246.528762,6,5,0,1,9,1995,Sofia Prazeres
201290,2246.394762,51,26,0,25,2,2013,Daniela Hantuchova
200040,2246.328805,8,6,0,2,18,1993,Anna Smashnova
200649,2246.200156,42,22,0,20,1,1993,Ginger Helgeson Nielsen
212089,2246.196903,6,5,0,1,25,1997,Madeline Sanchez
200069,2246.136715,12,7,0,5,4,2002,Nadia Petrova
200084,2246.091402,30,16,0,14,0,1999,Asa Svensson
200112,2246.08463,38,21,0,17,2,1995,Julie Halard Decugis
201555,2245.988084,55,29,0,26,3,2010,Polona Hercog
202460,2245.955559,10,7,0,3,6,2013,Ons Jabeur
200626,2245.953053,34,18,0,16,6,1992,Emanuela Zardo
200469,2245.945413,40,21,0,19,2,1990,Nicole Bradtke
201336,2245.929123,39,20,0,19,4,2004,Dinara Safina
200024,2245.892079,22,13,0,9,1,1997,Maria Vento Kabchi
200617,2245.89128,16,10,0,6,13,1990,Kimiko Date Krumm
202170,2245.682525,8,6,0,2,21,1992,Paula Cabezas
200651,2245.653079,39,22,0,17,1,1995,Sabine Hack
200078,2245.648919,25,14,0,11,12,2002,Barbara Schwartz
202694,2245.453345,25,15,0,10,4,2015,Teliana Pereira
201366,2245.445684,57,31,0,26,3,2015,Barbora Zahlavova Strycova
201457,2245.409281,55,31,0,24,4,2011,Jarmila Gajdosova
200105,2245.319092,48,26,0,22,5,1991,Rachel Mcquillan
201595,2245.295424,26,15,0,11,0,2012,Misaki Doi
201455,2245.230225,44,22,0,22,3,2010,Elena Vesnina
201596,2245.127297,46,25,0,21,3,2015,Johanna Larsson
200044,2245.009481,41,21,0,20,8,2004,Denisa Chladkova
201300,2244.992495,10,7,0,3,3,2004,Maria Emilia Salerni
201328,2244.979021,8,6,0,2,20,2001,Milagros Sequera
201331,2244.976614,45,25,0,20,3,2004,Iveta Benesova
200042,2244.956178,25,13,0,12,4,1996,Els Callens
201521,2244.936505,29,16,0,13,3,2011,Carla Suarez Navarro
200110,2244.913907,6,5,0,1,17,1997,Fabiola Zuluaga
200007,2244.903878,15,9,0,6,0,1998,Silvija Talaja
200700,2244.823455,50,25,0,25,5,2003,Silvia Farina Elia
200086,2244.763472,36,20,0,16,2,1996,Magdalena Maleeva
200725,2244.714755,33,19,0,14,5,1993,Sandra Cecchini
201458,2244.656114,8,6,0,2,6,2005,Victoria Azarenka
200634,2244.591789,15,9,0,6,3,1990,Elena Brioukhovets
200083,2244.557861,30,15,0,15,7,2001,Alexandra Stevenson
200723,2244.507955,27,14,0,13,1,1993,Iva Majoli
200682,2244.384248,38,21,0,17,4,1995,Joannette Kruger
200033,2244.356521,5,3,0,2,2,1997,Serena Williams
201614,2244.296352,49,26,0,23,3,2014,Caroline Garcia
202129,2244.213313,14,8,0,6,9,1999,Orawan Wongkamalasai
200086,2244.154667,34,18,0,16,5,1991,Magdalena Maleeva
201295,2244.085023,6,5,0,1,21,2004,Wynne Prakusya
202480,2244.071901,6,5,0,1,15,2014,Richel Hogenkamp
200120,2244.067002,27,15,0,12,2,1999,Jelena Dokic
200669,2244.027497,25,14,0,11,3,1991,Debbie Graham
201751,2244.000643,6,5,0,1,25,1996,Melissa Mazzotta
200693,2243.947432,31,16,0,15,9,1995,Elena Makarova
200090,2243.945836,53,26,0,27,3,2003,Anca Barna
201352,2243.902417,5,4,0,1,9,1999,Akiko Morigami
200655,2243.80461,26,14,0,12,10,1994,Nicole Arendt
201318,2243.688612,31,16,0,15,0,2010,Bethanie Mattek Sands
200700,2243.686778,41,21,0,20,7,1994,Silvia Farina Elia
202469,2243.651693,26,14,0,12,16,2013,Garbine Muguruza
200048,2243.616718,36,17,0,19,3,1994,Elena Likhovtseva
204058,2243.58416,11,7,0,4,9,1999,Nami Urabe
200605,2243.426048,39,21,0,18,9,1991,Regina Rajchrtova
201386,2243.331839,41,18,0,23,4,2011,Jie Zheng
200652,2243.315093,17,10,0,7,23,2003,Monica Seles
200720,2243.130535,13,8,0,5,8,1997,Dally Randriantefy
200554,2243.053134,43,24,0,19,1,1993,Brenda Schultz Mccarthy
202357,2243.003479,6,5,0,1,23,2006,Madalina Gojnea
202984,2242.954839,3,3,0,0,44,2001,Yang Jin Chung
201635,2242.931355,5,4,0,1,25,2008,Betina Jozami
200572,2242.902468,24,14,0,10,5,1996,Gabriela Sabatini
201410,2242.895756,7,5,0,2,45,1998,Monique Adamczak
200501,2242.876477,38,20,0,18,5,1995,Marianne Werdel Witmeyer
200014,2242.744326,25,14,0,11,6,2007,Tzipi Obziler
200597,2242.681332,16,8,0,8,1,1998,Mary Joe Fernandez
201596,2242.65865,24,15,0,9,3,2010,Johanna Larsson
200655,2242.658368,17,9,0,8,11,1997,Nicole Arendt
201501,2242.656907,26,14,0,12,1,2007,Olga Govortsova
200614,2242.482412,10,6,0,4,1,1994,Elena Pampoulova
200723,2242.456937,13,7,0,6,1,1992,Iva Majoli
201336,2242.451153,20,11,0,9,35,2011,Dinara Safina
200072,2242.383663,43,22,0,21,10,2000,Cara Black
203575,2242.331029,29,16,0,13,4,2015,Danka Kovinic
201331,2242.321444,40,22,0,18,2,2008,Iveta Benesova
201300,2242.258343,8,6,0,2,4,2000,Maria Emilia Salerni
201323,2242.153281,13,8,0,5,8,1997,Saori Obata
200063,2242.014701,51,23,0,28,4,2000,Tatiana Panova
201320,2241.997158,29,16,0,13,18,2012,Svetlana Kuznetsova
200107,2241.605194,55,31,0,24,4,2002,Paola Suarez
211269,2241.469774,3,3,0,0,43,2014,Eudice Wong Chong
201549,2241.442215,39,19,0,20,4,2012,Petra Martic
202413,2241.409457,5,4,0,1,46,2011,Florencia Molinero
212085,2241.387614,5,4,0,1,44,2000,Davilyn Godinet
202071,2241.330163,5,4,0,1,5,2000,Dragana Zaric
201595,2241.317108,29,14,0,15,3,2015,Misaki Doi
201308,2241.256463,43,22,0,21,8,2004,Maria Elena Camerin
200123,2241.242996,34,17,0,17,4,2003,Marlene Weingartner
201290,2241.21743,50,25,0,25,3,2004,Daniela Hantuchova
200753,2241.162082,16,9,0,7,45,1998,Cindy Watson
200104,2241.103974,36,20,0,16,7,2006,Emilie Loit
201844,2241.083025,5,4,0,1,23,1993,Agnese Gustmane
201447,2241.061034,27,13,0,14,4,2011,Vania King
200497,2240.925662,37,19,0,18,2,1991,Patricia Hy Boulais
204605,2240.9044,5,4,0,1,25,1995,Joana Pedroso
200669,2240.881259,40,21,0,19,3,1992,Debbie Graham
201621,2240.852249,50,24,0,26,3,2015,Mona Barthel
201514,2240.755168,57,30,0,27,4,2012,Sorana Cirstea
201290,2240.710021,42,22,0,20,2,2008,Daniela Hantuchova
200025,2240.675699,36,21,0,15,3,2003,Ludmila Cervanova
200036,2240.673043,51,26,0,25,3,2001,Nicole Pratt
200001,2240.626044,8,5,0,3,3,1994,Martina Hingis
205143,2240.517729,5,4,0,1,27,2002,Valentina Castro
203911,2240.500847,3,3,0,0,57,1996,Gaye Mcmanus
202014,2240.5,5,4,0,1,63,1998,Maria Eugenia Vento
203592,2240.5,9,6,0,3,59,2000,Melanie Ann Clayton
202283,2240.5,5,4,0,1,52,2001,Anouska Van Exel
203119,2240.5,11,7,0,4,52,2001,Melisa Arevalo
201384,2240.5,7,5,0,2,56,2002,Chia Jung Chuang
204945,2240.5,11,7,0,4,56,2002,Deanna Roberts
202803,2240.5,11,7,0,4,45,2003,Kaysie Smashey
203143,2240.5,11,7,0,4,45,2003,Nicole Sewell
208531,2240.499208,3,3,0,0,31,2014,Kirsten Andrea Weedon
212080,2240.479719,3,3,0,0,25,1995,Branislava Ivanovic
205276,2240.460211,3,3,0,0,27,2007,Alise Vaidere
201512,2240.460046,3,3,0,0,26,2005,Monica Niculescu
203362,2240.459288,3,3,0,0,42,2012,Vivian Segnini
200695,2240.446773,9,6,0,3,26,1994,Tina Krizan
212144,2240.439088,3,3,0,0,53,1999,Alissa Velts
200570,2240.438312,20,11,0,9,0,1990,Veronika Martinek
201495,2240.429072,57,33,0,24,1,2014,Dominika Cibulkova
200110,2240.411546,9,6,0,3,10,1998,Fabiola Zuluaga
201537,2240.408548,15,9,0,6,3,2013,Patricia Mayr Achleitner
200716,2240.32909,7,5,0,2,21,1992,Sung Hee Park
201481,2240.269165,9,6,0,3,2,2006,Tamira Paszek
200110,2240.135334,5,4,0,1,35,1996,Fabiola Zuluaga
200715,2240.124937,18,10,0,8,12,1991,Mariaan De Swardt
200634,2240.035185,3,3,0,0,46,1996,Elena Brioukhovets
200086,2240.025868,22,12,0,10,4,1990,Magdalena Maleeva
202265,2239.99526,7,5,0,2,62,1997,Mirielle Dittmann
205465,2239.995258,5,4,0,1,31,2007,Daniela Trigo
200110,2239.959818,30,18,0,12,9,2002,Fabiola Zuluaga
207944,2239.957764,3,3,0,0,47,1995,Cecilia Ampuero
202166,2239.957038,3,3,0,0,47,1995,Emilie Viqueira
210951,2239.956942,3,3,0,0,38,2013,Marian Jade Capadocia
201390,2239.95222,3,3,0,0,30,2011,Mervana Jugic Salkic
202389,2239.93873,3,3,0,0,39,2008,Sandra Martinovic
201541,2239.938115,3,3,0,0,44,2002,Chanelle Scheepers
202635,2239.935784,3,3,0,0,39,2008,Jin A Lee
208983,2239.917087,5,4,0,1,36,2000,Larikah Russell
204970,2239.896744,3,3,0,0,43,2002,Karina Ildor Jacobsgaard
201950,2239.881397,3,3,0,0,36,1996,Miriam Dagostini
201305,2239.878877,5,4,0,1,26,2009,Eleni Daniilidou
200485,2239.733523,36,20,0,16,6,1990,Manon Bollegraf
200453,2239.710153,47,25,0,22,2,1991,Catarina Lindqvist Ryan
200009,2239.687462,45,24,0,21,5,2001,Tamarine Tanasugarn
201290,2239.606632,51,28,0,23,5,2003,Daniela Hantuchova
202766,2239.527947,3,3,0,0,43,2002,Nicole Rencken
207914,2239.513139,3,3,0,0,35,2004,Paola Iovino
202900,2239.510917,3,3,0,0,31,2014,Maria Fernanda Alvarez Teran
206917,2239.492884,3,3,0,0,37,2000,Alexandra Guzman
202582,2239.491336,3,3,0,0,32,2007,Lizaan Du Plessis
200009,2239.474955,58,32,0,26,1,2002,Tamarine Tanasugarn
205111,2239.473243,3,3,0,0,27,2003,Nikoleta Kipritidou
202073,2239.472549,3,3,0,0,52,2002,Chin Bee Khoo
205348,2239.471755,3,3,0,0,36,2004,Wei Ping Lee
206213,2239.453842,3,3,0,0,43,2014,Amy Bowtell
201591,2239.452992,3,3,0,0,30,2001,Margalita Chakhnashvili
202789,2239.452992,3,3,0,0,30,2001,Salome Devidze
202930,2239.452992,3,3,0,0,40,2008,Jessica Roland Rosario
204275,2239.452992,3,3,0,0,46,2010,Zi Jun Yang
202646,2239.452992,3,3,0,0,47,2011,Ana Clara Duarte
207784,2239.452202,3,3,0,0,36,2004,Rui Jing Wong
203217,2239.433531,3,3,0,0,25,1995,Karoline Borgersen
207784,2239.433437,3,3,0,0,53,1999,Rui Jing Wong
204394,2239.433406,3,3,0,0,43,2014,Valentini Grammatikopoulou
208287,2239.432744,3,3,0,0,26,2005,Nihal Tarek Saleh
205361,2239.431244,3,3,0,0,26,2006,Nina Munch Soegaard
206583,2239.424344,5,4,0,1,27,2002,Monica Poveda
202629,2239.414612,5,4,0,1,41,2012,Gabriela Paz
202232,2239.412502,9,6,0,3,8,1996,Yuka Tanaka
210738,2239.379602,3,3,0,0,38,2013,Aldila Sutjiadi
212742,2239.364549,5,4,0,1,45,2000,Dina Dajani
209776,2239.352025,5,4,0,1,26,2009,Marina Novak
200360,2239.343183,13,8,0,5,35,1990,Pam Shriver
202470,2239.335394,40,20,0,20,3,2015,Annika Beck
201397,2239.262886,5,4,0,1,9,2001,Shuai Peng
211951,2239.186539,3,3,0,0,37,2013,Ana Konjuh
201499,2239.186153,18,10,0,8,5,2008,Anastasia Pavlyuchenkova
201397,2239.143085,30,16,0,14,3,2010,Shuai Peng
200044,2239.122529,6,4,0,2,0,1996,Denisa Chladkova
201591,2239.065271,5,4,0,1,25,1998,Margalita Chakhnashvili
200110,2239.058566,43,23,0,20,7,2000,Fabiola Zuluaga
202393,2239.008315,5,4,0,1,33,2003,Andrea Koch Benvenuto
200707,2239.005278,13,8,0,5,7,1993,Romana Tedjakusuma
212561,2239.004785,3,3,0,0,26,1997,Amira Samara
210920,2238.986193,5,4,0,1,23,2011,Kerrie Cartwright
202647,2238.969206,3,3,0,0,27,2014,Madrie Le Roux
202393,2238.968535,3,3,0,0,31,2014,Andrea Koch Benvenuto
212445,2238.968419,3,3,0,0,47,1995,Claudia Brause
201343,2238.967742,5,4,0,1,52,2000,Maret Ani
203091,2238.966185,11,7,0,4,10,1997,Yumiko Kitamura
202410,2238.953969,7,5,0,2,20,2014,Sofia Shapatava
204593,2238.949737,3,3,0,0,26,1995,Claire Curran
205570,2238.94895,3,3,0,0,30,2001,Helena Besovic
202864,2238.94895,3,3,0,0,35,2004,Amina Rakhim
202946,2238.936891,5,4,0,1,25,1995,Christina Zachariadou
209836,2238.934627,5,4,0,1,36,2000,Nikkita Fountain
202393,2238.933416,3,3,0,0,31,2005,Andrea Koch Benvenuto
202774,2238.933416,3,3,0,0,31,2006,Ka Po Tong
201683,2238.933416,3,3,0,0,26,2009,Bianca Botto
202818,2238.931003,3,3,0,0,26,2005,Samia Medjahdi
201390,2238.929517,3,3,0,0,39,2008,Mervana Jugic Salkic
205787,2238.924404,3,3,0,0,32,2006,Francesca Segarelli
212359,2238.913322,3,3,0,0,38,2000,Tari Ann Toro
203084,2238.91066,5,4,0,1,52,1999,Daniela Olivera
200069,2238.898523,44,22,0,22,0,2001,Nadia Petrova
207947,2238.859459,7,5,0,2,27,2002,Yamile Fors Guerra
206908,2238.848829,3,3,0,0,32,2006,Diana Espinal
201328,2238.832598,5,4,0,1,41,1999,Milagros Sequera
201318,2238.801789,31,16,0,15,7,2013,Bethanie Mattek Sands
201212,2238.731064,44,21,0,23,3,2002,Francesca Schiavone
205600,2238.577884,5,4,0,1,25,2008,Anna Movsisyan
205918,2238.505671,5,4,0,1,26,2009,Ulrikke Eikeri
212119,2238.504948,5,4,0,1,27,2002,Luisa Elfride Lopez
200014,2238.470084,14,8,0,6,6,2006,Tzipi Obziler
206717,2238.469279,5,4,0,1,52,2000,Asja Tankic
212186,2238.464469,3,3,0,0,35,2004,Yekaterina Morozova
201547,2238.449939,3,3,0,0,30,2011,Michelle Larcher De Brito
204595,2238.44643,3,3,0,0,27,1998,Charlotte Aagaard
202997,2238.438934,3,3,0,0,43,2002,Yvonne Doyle
202900,2238.429224,3,3,0,0,35,2004,Maria Fernanda Alvarez Teran
202392,2238.429224,3,3,0,0,26,2009,Melisa Miranda Otarola
202393,2238.421805,5,4,0,1,27,2012,Andrea Koch Benvenuto
206902,2238.399357,3,3,0,0,25,1997,Yamile Cordova
203290,2238.390165,3,3,0,0,27,2009,Piia Suomalainen
200651,2238.379978,32,17,0,15,0,1991,Sabine Hack
202509,2238.36531,7,5,0,2,15,1996,Joelle Schad
200450,2238.345478,35,19,0,16,2,1991,Larisa Savchenko
201380,2238.297279,7,5,0,2,4,2002,Claudine Schaul
201524,2238.221504,9,6,0,3,13,2006,Urszula Radwanska
201494,2238.206233,28,16,0,12,4,2007,Raluca Olaru
200122,2238.196624,51,24,0,27,4,2003,Tina Pisnik
200491,2238.10957,33,17,0,16,3,1995,Christina Singer
201506,2238.061641,17,10,0,7,7,2007,Sara Errani
202359,2238.059173,11,7,0,4,36,2003,Chin Wei Chan
206998,2238.045595,3,3,0,0,25,1997,Kadija Richards
200095,2238.044942,39,20,0,19,1,1994,Linda Wild
212139,2237.984814,3,3,0,0,29,2001,S BACCAR
202078,2237.975307,5,4,0,1,32,1997,Rosabel Moyen
206917,2237.967055,3,3,0,0,27,1996,Alexandra Guzman
212414,2237.958783,5,4,0,1,46,1992,Oksana Bushevitsa
207002,2237.954096,5,4,0,1,27,2002,Marcela Ivon Rodezno Hernandez
206912,2237.946934,3,3,0,0,36,2000,Myriam Cueva
207003,2237.927294,5,4,0,1,27,2002,Liz Cruz
203054,2237.925341,3,3,0,0,36,2003,Da Jung Hong
201666,2237.914102,3,3,0,0,27,2007,Cagla Buyukakcay
202277,2237.887908,3,3,0,0,32,2010,Mariana Correa
202521,2237.85162,7,5,0,2,31,1998,Neyssa Etienne
202370,2237.848131,3,3,0,0,31,2005,Jenifer Widjaja
200723,2237.836837,42,20,0,22,7,2001,Iva Majoli
201642,2237.774251,5,4,0,1,29,2010,Fatima El Allami
200586,2237.669818,18,10,0,8,11,1990,Federica Bonsignori
202257,2237.656238,5,4,0,1,39,1997,Carmina Giraldo
201384,2237.561139,13,8,0,5,35,2003,Chia Jung Chuang
212488,2237.538638,5,4,0,1,34,1997,Lamia Hameurlaine
206177,2237.515402,5,4,0,1,27,2012,Joana Eidukonyte
201441,2237.480617,5,4,0,1,15,2003,Emma Laine
206376,2237.460823,5,4,0,1,30,2011,Nour Abbes
212184,2237.452421,3,3,0,0,41,2012,Jenneta Halliyeva
201969,2237.439829,5,4,0,1,25,1995,Karin Ptaszek
201486,2237.418701,14,9,0,5,1,2006,Aleksandra Wozniak
201441,2237.335666,3,3,0,0,30,2001,Emma Laine
200485,2237.263907,22,12,0,10,23,1992,Manon Bollegraf
200593,2237.191587,28,15,0,13,15,1991,Karine Quentrec
203140,2237.162027,5,4,0,1,18,2003,Bruna Colosio
200016,2237.131504,32,17,0,15,22,2002,Sandrine Testud
202709,2237.105061,5,4,0,1,31,2007,Jessica Lehnhoff
201286,2237.093691,52,26,0,26,1,2004,Anabel Medina Garrigues
200743,2237.048975,7,5,0,2,37,1998,Nirupama Sanjeev
200644,2237.016305,38,19,0,19,5,1996,Naoko Sawamatsu
200046,2237.008843,57,29,0,28,4,2002,Meghann Shaughnessy
204356,2237.006775,5,4,0,1,37,2013,Emily Fanning
202509,2237.002608,7,5,0,2,31,1998,Joelle Schad
206904,2237.001857,5,4,0,1,27,1997,Yoannis Montesino
200503,2236.97928,41,22,0,19,2,1990,Gretchen Magers
206174,2236.965002,3,3,0,0,45,2010,Cecilia Costa Melgar
200716,2236.940467,3,3,0,0,24,1991,Sung Hee Park
202048,2236.900891,8,5,0,3,33,1997,Liza Andriyani
210160,2236.889636,5,4,0,1,23,2011,Carolina De Los Santos
201508,2236.815546,32,17,0,15,14,2012,Petra Cetkovska
204590,2236.777404,5,4,0,1,22,1991,Gina Niland
200067,2236.770107,52,29,0,23,2,1999,Patty Schnyder
201492,2236.753998,23,12,0,11,0,2012,Andrea Petkovic
200699,2236.736868,24,12,0,12,2,1993,Meredith Mcgrath
200009,2236.710081,16,9,0,7,4,2006,Tamarine Tanasugarn
200107,2236.667912,32,18,0,14,6,1999,Paola Suarez
201555,2236.666699,20,10,0,10,3,2013,Polona Hercog
207176,2236.558297,5,4,0,1,25,1998,Sona Saringulyan
204070,2236.550101,5,4,0,1,34,1997,Francesca Guardigli
201683,2236.547987,3,3,0,0,41,2012,Bianca Botto
201365,2236.541075,3,3,0,0,38,2001,Edina Gallovits Hall
204542,2236.486558,5,4,0,1,45,1993,Ninfa Marra
206587,2236.484562,5,4,0,1,27,2002,Daniela Alvarez
205010,2236.475521,5,4,0,1,26,2006,Magy Aziz
200097,2236.469521,54,30,0,24,1,1996,Nathalie Tauziat
201535,2236.448095,42,20,0,22,5,2015,Coco Vandeweghe
200360,2236.442026,27,14,0,13,1,1993,Pam Shriver
201963,2236.422922,5,4,0,1,15,1997,Sofia Prazeres
201588,2236.362464,38,20,0,18,9,2012,Anna Tatishvili
201596,2236.231654,3,3,0,0,32,2005,Johanna Larsson
200070,2236.205537,12,6,0,6,4,1996,Anne Gaelle Sidot
202421,2236.171292,38,19,0,19,3,2015,Alison Van Uytvanck
201809,2236.164134,7,5,0,2,5,1996,Hila Rosen
207944,2236.128823,5,4,0,1,43,1994,Cecilia Ampuero
201296,2236.115301,28,15,0,13,3,2001,Bianka Lamade
206904,2236.088687,5,4,0,1,22,1994,Yoannis Montesino
201390,2236.041175,5,4,0,1,25,1998,Mervana Jugic Salkic
207784,2236.040985,5,4,0,1,56,1997,Rui Jing Wong
201611,2236.040883,41,20,0,21,3,2015,Daria Gavrilova
201988,2235.969229,5,4,0,1,34,1997,Sofie Albinus
201594,2235.93944,50,26,0,24,4,2012,Simona Halep
200020,2235.918435,25,13,0,12,1,1993,Lisa Raymond
207583,2235.901721,5,4,0,1,43,2002,Katrina Bandere
200453,2235.861591,31,16,0,15,4,1990,Catarina Lindqvist Ryan
201468,2235.830052,38,21,0,17,3,2009,Yaroslava Shvedova
200046,2235.799775,61,35,0,26,0,2003,Meghann Shaughnessy
200009,2235.791663,45,23,0,22,0,1998,Tamarine Tanasugarn
200417,2235.699039,32,18,0,14,2,1990,Gigi Fernandez
201344,2235.68133,12,7,0,5,20,2002,Klara Koukalova
200118,2235.618797,28,15,0,13,5,2006,Virginia Ruano Pascual
201441,2235.600638,5,4,0,1,4,2004,Emma Laine
206903,2235.561696,5,4,0,1,27,2002,Glenny Cepeda
201209,2235.537022,5,4,0,1,34,1997,Selima Sfar
212578,2235.519254,5,4,0,1,25,1995,Michele Wagner
200428,2235.503047,14,8,0,6,10,1998,Lori Mcneil
206999,2235.498287,5,4,0,1,28,2001,Erika Villalobos Morsink
206766,2235.483309,5,4,0,1,26,1997,Nannette Duxin
205694,2235.476021,5,4,0,1,26,2009,Helene Auensen
201420,2235.410892,47,22,0,25,4,2006,Sania Mirza
200378,2235.358553,13,8,0,5,12,1991,Anne Smith
200707,2235.346436,7,5,0,2,11,2001,Romana Tedjakusuma
200651,2235.320382,27,15,0,12,11,1990,Sabine Hack
201294,2235.303378,49,26,0,23,4,2004,Marion Bartoli
203084,2235.282602,15,9,0,6,36,2002,Daniela Olivera
200614,2235.279759,17,9,0,8,10,1998,Elena Pampoulova
200061,2235.182185,33,16,0,17,6,1999,Gala Leon Garcia
201495,2234.999843,41,23,0,18,3,2009,Dominika Cibulkova
200601,2234.971789,7,5,0,2,59,1995,Leila Meskhi
201311,2234.911717,48,21,0,27,3,2014,Roberta Vinci
201847,2234.893336,20,12,0,8,9,1999,Mareze Joubert
201403,2234.890923,51,28,0,23,2,2008,Anna Chakvetadze
200469,2234.854924,40,23,0,17,12,1995,Nicole Bradtke
202045,2234.82338,5,4,0,1,15,1992,Il Soon Kim
200653,2234.822923,40,23,0,17,7,1993,Yayuk Basuki
200067,2234.780848,49,23,0,26,3,1997,Patty Schnyder
200669,2234.669033,9,5,0,4,11,1990,Debbie Graham
201425,2234.628622,52,27,0,25,3,2010,Lucie Safarova
200112,2234.585725,34,19,0,15,6,1990,Julie Halard Decugis
200104,2234.562572,48,24,0,24,0,2003,Emilie Loit
200085,2234.512729,45,24,0,21,1,1996,Ai Sugiyama
200643,2234.376329,12,7,0,5,7,1995,Petra Kamstra
200599,2234.301223,41,22,0,19,3,1991,Carrie Cunningham
201385,2234.256862,15,9,0,6,1,2002,Yuliana Fedak
201490,2234.214925,14,8,0,6,38,2011,Timea Bacsinszky
200020,2234.155223,43,21,0,22,3,2004,Lisa Raymond
201212,2234.147331,48,26,0,22,7,2001,Francesca Schiavone
206105,2234.102873,7,5,0,2,0,2012,Rutuja Bhosale
201293,2234.057289,7,5,0,2,44,2011,Catalina Castano
201305,2233.968028,46,25,0,21,4,2004,Eleni Daniilidou
200501,2233.960083,31,14,0,17,2,1990,Marianne Werdel Witmeyer
200095,2233.910926,40,19,0,21,1,1992,Linda Wild
200772,2233.905667,24,11,0,13,7,2001,Anastasia Myskina
201344,2233.903419,53,27,0,26,4,2004,Klara Koukalova
212718,2233.890685,7,5,0,2,31,1998,Claudia Castro
200035,2233.874836,20,10,0,10,11,1997,Maria Sanchez Lorenzo
201329,2233.86095,21,11,0,10,14,2012,Vera Zvonareva
201347,2233.742268,64,34,0,30,1,2012,Jelena Jankovic
200506,2233.73086,29,16,0,13,6,1990,Wiltrud Probst
201508,2233.693576,24,13,0,11,9,2014,Petra Cetkovska
201541,2233.658926,50,24,0,26,5,2012,Chanelle Scheepers
201455,2233.623405,39,18,0,21,4,2007,Elena Vesnina
201574,2233.432784,5,4,0,1,25,2007,Neuza Silva
200111,2233.392805,6,4,0,2,4,1999,Lina Krasnoroutskaya
200081,2233.360267,18,9,0,9,6,1990,Anke Huber
200702,2233.316221,35,17,0,18,5,1996,Naoko Kijimuta
201294,2233.26919,41,20,0,21,4,2003,Marion Bartoli
202170,2233.202304,6,4,0,2,21,1994,Paula Cabezas
200392,2233.154646,34,15,0,19,5,1991,Jo Durie
200753,2233.043436,16,9,0,7,52,1997,Cindy Watson
200667,2232.944803,17,9,0,8,11,1996,Ines Gorrochategui
201729,2232.650284,5,4,0,1,18,1993,Larissa Schaerer
201556,2232.47947,36,18,0,18,4,2012,Lucie Hradecka
202418,2232.295158,24,13,0,11,6,2013,Lara Arruabarrena
200684,2232.174607,29,15,0,14,1,1992,Shi Ting Wang
200481,2232.154438,36,19,0,17,3,1993,Elna Reinach
201620,2232.153908,7,5,0,2,9,2012,Monica Puig
201681,2232.070066,5,4,0,1,6,2004,Suchanun Viratprasert
201493,2232.060986,37,17,0,20,3,2011,Angelique Kerber
202173,2232.060189,5,4,0,1,13,2001,Joana Cortez
200043,2231.975567,23,11,0,12,4,2002,Virginie Razzano
201317,2231.935333,11,6,0,5,4,2003,Aniko Kapros
200612,2231.926654,42,19,0,23,3,1994,Natalia Medvedeva
201381,2231.89671,25,12,0,13,4,2006,Tian Tian Sun
201515,2231.868617,26,14,0,12,29,2011,Alisa Kleybanova
200006,2231.835327,50,26,0,24,3,1997,Karina Habsudova
201481,2231.723297,40,19,0,21,3,2011,Tamira Paszek
201424,2231.699479,48,26,0,22,5,2011,Shahar Peer
201466,2231.696452,34,17,0,17,1,2006,Kaia Kanepi
200693,2231.663189,24,11,0,13,3,1997,Elena Makarova
200096,2231.656761,17,9,0,8,2,2006,Mary Pierce
200709,2231.636262,8,5,0,3,43,1994,Rosana De Los Rios
200058,2231.635426,8,5,0,3,27,2000,Anna Foldenyi Dicker
202498,2231.622944,11,7,0,4,7,2013,Julia Glushko
200056,2231.593701,12,7,0,5,5,2001,Jelena Kostanic Tosic
211951,2231.521222,14,8,0,6,3,2014,Ana Konjuh
201087,2231.519061,25,13,0,12,3,2004,Mashona Washington
200624,2231.515131,34,16,0,18,1,1994,Tami Whitlinger Jones
201545,2231.512664,8,5,0,3,3,2015,Anastasija Sevastova
200561,2231.388528,28,16,0,12,4,1990,Cathy Caverzasio
200450,2231.368373,41,21,0,20,1,1992,Larisa Savchenko
202653,2231.310222,4,3,0,1,3,2014,Denisa Allertova
200676,2231.269947,27,15,0,12,8,1992,Mana Endo
201614,2231.257664,56,29,0,27,4,2015,Caroline Garcia
201085,2231.097274,22,12,0,10,10,2000,Shinobu Asagoe
203047,2231.065184,6,4,0,2,22,1993,Cecilia Hincapie
202292,2231.026873,10,6,0,4,9,1998,Ayami Takase
203575,2230.806719,7,5,0,2,2,2013,Danka Kovinic
200522,2230.773355,23,12,0,11,3,1993,Nicole Krijger Jagerman
200700,2230.6716,44,22,0,22,3,1997,Silvia Farina Elia
202170,2230.655955,7,5,0,2,22,1993,Paula Cabezas
202280,2230.650716,13,8,0,5,1,2002,Olga Kalyuzhnaya
201379,2230.529254,52,28,0,24,8,2007,Mara Santangelo
201455,2230.431925,40,19,0,21,3,2011,Elena Vesnina
200039,2230.400858,14,8,0,6,2,1991,Chanda Rubin
200060,2230.222172,30,15,0,15,7,2006,Tathiana Garbin
200026,2230.137979,37,19,0,18,0,1991,Florencia Labat
200036,2230.134344,35,18,0,17,0,1999,Nicole Pratt
201527,2230.075521,45,22,0,23,2,2013,Stefanie Voegele
200108,2229.949618,24,12,0,12,4,1999,Elena Dementieva
202275,2229.932087,4,3,0,1,44,2000,Tagifano Soonalole
200700,2229.885544,45,23,0,22,3,1996,Silvia Farina Elia
201318,2229.882105,34,18,0,16,9,2011,Bethanie Mattek Sands
200107,2229.871789,19,10,0,9,5,2006,Paola Suarez
200658,2229.789891,27,14,0,13,10,1994,Fang Li
200680,2229.735584,22,12,0,10,6,1992,Nadin Ercegovic
211533,2229.62161,12,7,0,5,6,2015,Jelena Ostapenko
200099,2229.598695,19,11,0,8,3,1998,Sonya Jeyaseelan
200647,2229.575286,5,3,0,2,10,1990,Noelle Van Lottum
200105,2229.547094,24,12,0,12,8,1997,Rachel Mcquillan
200048,2229.480136,52,28,0,24,2,1997,Elena Likhovtseva
200089,2229.392523,31,15,0,16,9,2001,Miriam Oremans
201729,2229.231984,9,6,0,3,22,1994,Larissa Schaerer
200627,2229.231081,30,15,0,15,4,1994,Petra Schwarz
200723,2229.159402,23,11,0,12,4,2000,Iva Majoli
201386,2228.92595,36,18,0,18,3,2013,Jie Zheng
201418,2228.918756,8,5,0,3,8,2004,Ting Li
200086,2228.826446,53,28,0,25,4,2004,Magdalena Maleeva
207956,2228.817158,8,5,0,3,28,2001,Yanet Nunez Mojarena
201567,2228.795117,11,6,0,5,3,2009,Alexandra Dulgheru
201444,2228.791266,7,5,0,2,5,2001,Su Wei Hsieh
201754,2228.761681,15,9,0,6,52,1999,Leanne Baker
200048,2228.74387,69,37,0,32,0,1999,Elena Likhovtseva
200098,2228.728522,4,3,0,1,11,1995,Henrieta Nagyova
201305,2228.679783,56,32,0,24,5,2003,Eleni Daniilidou
200621,2228.673394,27,13,0,14,3,1991,Isabelle Demongeot
201371,2228.666081,38,19,0,19,2,2005,Vera Dushevina
200776,2228.665655,6,4,0,2,14,1999,Angelika Bachmann
202129,2228.645291,10,6,0,4,0,1998,Orawan Wongkamalasai
201083,2228.640068,49,24,0,25,5,2002,Daja Bedanova
201556,2228.629344,25,14,0,11,3,2009,Lucie Hradecka
201495,2228.595967,37,18,0,19,4,2007,Dominika Cibulkova
201680,2228.580425,6,4,0,2,25,2010,Anna Gerasimou
200074,2228.565503,4,3,0,1,3,1998,Jane Chi
200713,2228.556834,12,7,0,5,0,1996,Yuka Yoshida
201512,2228.524017,41,20,0,21,3,2015,Monica Niculescu
200606,2228.51319,26,13,0,13,0,1996,Nana Smith
201416,2228.50169,46,25,0,21,3,2010,Alona Bondarenko
204715,2228.490494,4,3,0,1,52,1999,Cecilia Guillenea
201472,2228.444645,30,16,0,14,16,2013,Romina Oprandi
200626,2228.426851,25,13,0,12,7,1990,Emanuela Zardo
200040,2228.415761,55,31,0,24,6,2004,Anna Smashnova
200469,2228.361489,44,24,0,20,2,1992,Nicole Bradtke
201573,2228.359856,45,22,0,23,3,2013,Laura Robson
200041,2228.278619,25,12,0,13,1,1998,Amy Frazier
201963,2228.228924,4,3,0,1,41,1998,Sofia Prazeres
202329,2228.202376,4,3,0,1,38,2001,Jessica Fernandez
200710,2228.163965,4,3,0,1,21,1991,Magdalena Feistel
201424,2228.059343,45,24,0,21,4,2005,Shahar Peer
202930,2228.043959,4,3,0,1,28,2001,Jessica Roland Rosario
202303,2228.027492,4,3,0,1,35,2004,Carla Tiene
203034,2228.01376,10,6,0,4,9,1998,Lara Van Rooyen
200639,2228.006326,4,3,0,1,57,1996,Claudine Toleafoa
201499,2227.992389,46,21,0,25,4,2012,Anastasia Pavlyuchenkova
202073,2227.990017,4,3,0,1,53,1998,Chin Bee Khoo
202348,2227.967276,2,2,0,0,27,2003,Lina Stanciute
207427,2227.943887,2,2,0,0,29,2001,Ilona Jarkova
201295,2227.872151,4,3,0,1,53,1998,Wynne Prakusya
201311,2227.847921,46,23,0,23,3,2009,Roberta Vinci
200105,2227.738663,36,19,0,17,7,1992,Rachel Mcquillan
201681,2227.679714,6,4,0,2,4,2005,Suchanun Viratprasert
200497,2227.635804,33,16,0,17,2,1994,Patricia Hy Boulais
200072,2227.624802,20,10,0,10,2,1998,Cara Black
200777,2227.618433,12,7,0,5,11,2000,Marta Marrero
200500,2227.614639,9,6,0,3,18,1993,Pilar Vasquez
200697,2227.612034,4,3,0,1,6,1993,Janette Husarova
200043,2227.61186,6,4,0,2,21,2015,Virginie Razzano
202392,2227.573711,4,3,0,1,25,2008,Melisa Miranda Otarola
202339,2227.503951,2,2,0,0,40,2009,Ayu Fani Damayanti
204655,2227.503198,4,3,0,1,30,1999,Gulberk Gultekin
201343,2227.484396,2,2,0,0,30,1999,Maret Ani
202774,2227.48437,2,2,0,0,45,2001,Ka Po Tong
202745,2227.443704,4,3,0,1,53,1999,Uzma Khan
211491,2227.442509,2,2,0,0,41,2012,Maika Jae Tanpoco
212457,2227.42446,2,2,0,0,28,1996,Maria De Los Angeles Ycaza
204329,2227.424023,4,3,0,1,26,2009,Kimberley Cassar
201490,2227.422406,40,19,0,21,3,2010,Timea Bacsinszky
200730,2227.420845,4,3,0,1,21,1991,Min Tang
202700,2227.404826,2,2,0,0,23,2011,Simone Pratt
202170,2227.367634,4,3,0,1,40,1998,Paula Cabezas
204536,2227.307449,4,3,0,1,43,1994,Barbara Castro
201344,2227.281197,40,20,0,20,3,2010,Klara Koukalova
200010,2227.244084,43,22,0,21,0,1999,Rita Grande
201349,2227.242989,11,6,0,5,12,2003,Melinda Czink
205673,2227.236364,4,3,0,1,39,2008,Renee Reinhard
200044,2227.231694,39,20,0,19,5,2003,Denisa Chladkova
201304,2227.188977,6,4,0,2,22,2004,Elena Baltacha
201465,2227.18122,32,16,0,16,3,2010,Kirsten Flipkens
200574,2227.150569,37,20,0,17,2,1991,Eva Sviglerova
201514,2227.108428,14,8,0,6,4,2007,Sorana Cirstea
201809,2227.042609,4,3,0,1,47,1997,Hila Rosen
201304,2227.031475,6,4,0,2,22,2002,Elena Baltacha
201322,2227.021162,4,3,0,1,26,1998,Eva Dyrberg
202073,2227.020372,4,3,0,1,52,1995,Chin Bee Khoo
203002,2227.018732,2,2,0,0,41,1995,Karin Palme
200684,2227,2,2,0,0,25,1991,Shi Ting Wang
202746,2227,2,2,0,0,49,1996,Natalie Cahana
200731,2227,8,5,0,3,50,1998,Gail Biggs
202748,2227,8,5,0,3,50,1998,Tomoe Hotta
202265,2227,10,6,0,4,52,1999,Mirielle Dittmann
203062,2227,8,5,0,3,9,1999,Yu An Chen
204579,2227,10,6,0,4,59,2000,Giselle Swart
201285,2227,6,4,0,2,52,2001,Melissa Middleton
201325,2227,6,4,0,2,52,2001,Samantha Stosur
202716,2227,6,4,0,2,52,2001,Helen Crook
204574,2227,10,6,0,4,52,2001,Anna Nefedova
212102,2227,2,2,0,0,29,2001,Viviana Rivero
203119,2227,10,6,0,4,63,2002,Melisa Arevalo
201449,2227,10,6,0,4,45,2003,Lauren Breadmore
201577,2227,2,2,0,0,29,2003,Heidi El Tabakh
203089,2227,10,6,0,4,45,2003,Kristen Van Elden
204618,2227,10,6,0,4,45,2003,Caroline Ann Basu
202388,2227,2,2,0,0,33,2005,Dilyara Saidkhodjaeva
202507,2227,2,2,0,0,32,2006,Wing Yau Venise Chan
204970,2227,2,2,0,0,33,2006,Karina Ildor Jacobsgaard
202365,2227,4,3,0,1,50,2011,Lavinia Tananta
203489,2227,4,3,0,1,50,2011,Hao Chen Tang
210046,2227,4,3,0,1,50,2011,Anna Clarice Patrimonio
210953,2227,2,2,0,0,50,2011,Tamitha Nguyen
201600,2227,4,3,0,1,51,2014,Jamie Hampton
206424,2227,2,2,0,0,27,2015,Katharina Lehnert
203575,2226.999319,4,3,0,1,30,2011,Danka Kovinic
206954,2226.981176,2,2,0,0,29,2001,Egle Petrauskaite
212083,2226.980389,4,3,0,1,53,1998,Lynn Yin Tan
206917,2226.97966,2,2,0,0,47,1995,Alexandra Guzman
202789,2226.97966,4,3,0,1,52,2000,Salome Devidze
203451,2226.97966,2,2,0,0,25,2011,Marina Giral Lores
201628,2226.968394,4,3,0,1,52,1998,Li Li
202626,2226.962339,4,3,0,1,26,2014,Stephanie Vogt
207518,2226.960104,4,3,0,1,57,1997,Marisue Jacutin
206304,2226.958933,4,3,0,1,24,2011,Yolimar Ogando
200100,2226.952442,4,3,0,1,35,2003,Amanda Hopmans
200029,2226.941685,6,4,0,2,10,1999,Lisa Mcshea
204840,2226.921779,4,3,0,1,27,2009,Liudmila Nikoyan
202305,2226.918771,4,3,0,1,37,2003,Manisha Malhotra
203235,2226.861512,4,3,0,1,44,2001,Po Kuen Lam
201600,2226.822282,24,12,0,12,5,2012,Jamie Hampton
201524,2226.803155,50,24,0,26,4,2013,Urszula Radwanska
200040,2226.794387,36,17,0,19,10,2006,Anna Smashnova
201589,2226.764663,9,6,0,3,37,2010,Sharon Fichman
201326,2226.683312,4,3,0,1,30,1999,Bahia Mouhtassine
201466,2226.611078,39,20,0,19,4,2014,Kaia Kanepi
200107,2226.592762,50,27,0,23,9,2000,Paola Suarez
202961,2226.577945,4,3,0,1,30,1999,Adriana Basaric
200055,2226.572042,28,16,0,12,6,1999,Mariana Diaz Oliva
209580,2226.53121,2,2,0,0,37,2013,Abigail Guthrie
201678,2226.520296,4,3,0,1,31,2007,Sacha Jones
201380,2226.516877,2,2,0,0,36,2013,Claudine Schaul
204542,2226.516332,4,3,0,1,40,1992,Ninfa Marra
209117,2226.514811,2,2,0,0,25,2008,Lorena Aviles
200472,2226.512982,35,19,0,16,3,1990,Helen Kelesi
205787,2226.496838,4,3,0,1,26,2009,Francesca Segarelli
212144,2226.496775,2,2,0,0,52,2002,Alissa Velts
201591,2226.496773,4,3,0,1,32,2007,Margalita Chakhnashvili
206583,2226.49623,4,3,0,1,28,1996,Monica Poveda
202331,2226.496078,2,2,0,0,48,1995,Vilmarie Castellvi
208260,2226.496078,2,2,0,0,27,2005,Dijana Stojic
203388,2226.496078,2,2,0,0,46,2010,Poojashree Venkatesha
202583,2226.496049,4,3,0,1,35,2004,Megan Moulton Levy
212272,2226.48153,4,3,0,1,24,2011,Breana Stampfli
201356,2226.481392,12,7,0,5,7,2011,Eva Birnerova
201680,2226.478715,4,3,0,1,26,2009,Anna Gerasimou
203910,2226.478009,4,3,0,1,52,1998,Paiao Asinata Short
212382,2226.477285,2,2,0,0,30,1999,Goda Kuliesyte
202357,2226.477109,4,3,0,1,31,2007,Madalina Gojnea
200106,2226.476362,17,9,0,8,10,1999,Angeles Montolio
200124,2226.475706,2,2,0,0,24,1991,Anne Kremer
212425,2226.475706,2,2,0,0,49,1995,Sasha Hanna
204509,2226.475706,2,2,0,0,26,1997,Ana Valeria Rolon
212422,2226.475706,2,2,0,0,33,1997,Alexandra Scholer
202270,2226.475706,2,2,0,0,31,1999,Habiba Ifrakh
207535,2226.475706,2,2,0,0,53,1999,Lorena Rodriguez Di Laura
202071,2226.475706,2,2,0,0,39,2001,Dragana Zaric
207421,2226.475706,2,2,0,0,32,2001,Ruta Deduraite
212201,2226.475706,2,2,0,0,31,2006,Tatyana Ignatchenko
210130,2226.475706,2,2,0,0,26,2008,Maria Paula Deheza
202596,2226.475706,2,2,0,0,41,2012,Mihaela Buzarnescu
201609,2226.475706,4,3,0,1,40,2013,Yi Miao Zhou
200015,2226.474975,4,3,0,1,35,1995,Petra Mandula
201638,2226.4687,14,8,0,6,15,2012,Estrella Cabeza Candela
201698,2226.458453,8,5,0,3,45,2003,Liana Gabriela Ungur
201708,2226.457048,4,3,0,1,43,2002,Natalie Grandin
203469,2226.456156,2,2,0,0,31,2007,Albina Khabibulina
206374,2226.450659,4,3,0,1,7,2014,Yafan Wang
202370,2226.433725,4,3,0,1,30,2006,Jenifer Widjaja
202626,2226.421551,4,3,0,1,27,2007,Stephanie Vogt
212224,2226.418839,2,2,0,0,26,2006,Sidonia Wolfinger
206587,2226.417811,4,3,0,1,36,2000,Daniela Alvarez
201420,2226.399469,4,3,0,1,37,2003,Sania Mirza
200052,2226.334285,25,13,0,12,0,1997,Olga Barabanschikova
207947,2226.312411,6,4,0,2,25,1997,Yamile Fors Guerra
200557,2226.305796,14,7,0,7,3,1991,Katrina Adams
200416,2226.296129,30,15,0,15,3,1990,Robin White
201523,2226.282285,6,4,0,2,31,2005,Marina Erakovic
200122,2226.257426,23,13,0,10,0,1999,Tina Pisnik
200612,2226.217115,36,20,0,16,1,1992,Natalia Medvedeva
201621,2226.205497,53,29,0,24,4,2012,Mona Barthel
201664,2226.203073,4,3,0,1,14,2010,Pemra Ozgen
201526,2226.148564,3,2,0,1,10,2008,Julie Coin
202818,2226.094612,4,3,0,1,30,2004,Samia Medjahdi
204123,2226.071335,2,2,0,0,44,1999,Maria Dolores Campana
200751,2226.06704,4,3,0,1,57,1998,Conchita Martinez Granados
202753,2226.066891,10,6,0,4,54,1996,Esme De Villiers
201479,2226.023215,10,6,0,4,5,2012,Olga Puchkova
208093,2226.016021,4,3,0,1,23,2011,Chandra Capozzi
208207,2226.014046,4,3,0,1,30,2004,Ina Sartz
210046,2226.00935,4,3,0,1,43,2014,Anna Clarice Patrimonio
212396,2225.996937,2,2,0,0,47,1996,Helene Holter
202626,2225.984108,4,3,0,1,26,2006,Stephanie Vogt
200695,2225.977024,4,3,0,1,47,1997,Tina Krizan
204516,2225.975806,4,3,0,1,45,2000,Melody Falco
209776,2225.973243,4,3,0,1,27,2007,Marina Novak
212755,2225.971755,2,2,0,0,54,1999,Mariam Rahim
209174,2225.971755,2,2,0,0,33,2007,Adriana Pereira
205462,2225.971755,2,2,0,0,26,2008,Melisa Morales
201517,2225.963441,21,11,0,10,5,2008,Magdalena Rybarikova
204772,2225.954592,4,3,0,1,34,1997,Liina Suurvarik
204899,2225.953055,4,3,0,1,30,1999,Evghenia Ablovatchi
204536,2225.952992,2,2,0,0,44,1997,Barbara Castro
202399,2225.952992,2,2,0,0,32,1999,Margit Ruutel
206902,2225.952992,2,2,0,0,54,1999,Yamile Cordova
202545,2225.952992,4,3,0,1,26,2005,Irina Kuzmina
208797,2225.952992,2,2,0,0,33,2005,Denise Dy
202415,2225.952992,2,2,0,0,27,2009,Ximena Hermoso
202493,2225.952992,2,2,0,0,27,2014,Ekaterine Gorgodze
214139,2225.952992,2,2,0,0,31,2014,Magdalena Boado
206106,2225.952992,2,2,0,0,27,2015,Prarthana G Thombare
201680,2225.950688,4,3,0,1,26,2006,Anna Gerasimou
212545,2225.946028,2,2,0,0,27,1996,Gabriela Calderon
202303,2225.940146,2,2,0,0,45,2000,Carla Tiene
212087,2225.937616,2,2,0,0,53,2002,Valeria Khazova
205010,2225.935732,4,3,0,1,28,2012,Magy Aziz
203915,2225.932744,2,2,0,0,58,1997,Yuan Wen
212411,2225.932317,4,3,0,1,40,1992,Rita Pichardo
200075,2225.930348,2,2,0,0,40,1993,Jing Qian Yi
202946,2225.912795,4,3,0,1,47,1992,Christina Zachariadou
201591,2225.912795,4,3,0,1,26,2005,Margalita Chakhnashvili
210951,2225.912614,4,3,0,1,43,2014,Marian Jade Capadocia
203217,2225.912431,4,3,0,1,30,2004,Karoline Borgersen
200124,2225.905791,4,3,0,1,25,2010,Anne Kremer
208983,2225.895911,4,3,0,1,28,2001,Larikah Russell
212165,2225.894431,4,3,0,1,27,2012,Anneliese Rose
212165,2225.891448,6,4,0,2,25,1997,Anneliese Rose
202788,2225.854373,10,6,0,4,8,1996,Kildine Chevalier
200104,2225.839465,36,19,0,17,4,2002,Emilie Loit
201452,2225.822279,13,8,0,5,48,2002,Lourdes Dominguez Lino
202418,2225.768781,15,8,0,7,6,2012,Lara Arruabarrena
200127,2225.724954,44,22,0,22,2,1998,Sarah Pitkowski Malcor
212425,2225.685468,6,4,0,2,25,1997,Sasha Hanna
200125,2225.668861,23,12,0,11,0,1997,Corina Morariu
200602,2225.627063,36,17,0,19,1,1994,Shaun Stafford
200743,2225.604925,4,3,0,1,44,2001,Nirupama Sanjeev
200739,2225.585022,11,6,0,5,3,1996,Stephanie De Ville
201599,2225.564906,23,10,0,13,7,2012,Andrea Hlavackova
203191,2225.545478,4,3,0,1,26,2007,Danica Krstajic
201531,2225.531865,6,4,0,2,31,2007,Mariana Duque Marino
203064,2225.489752,4,3,0,1,57,1996,Hsueh Li Hsu
205079,2225.482018,2,2,0,0,31,2005,Paula Marama
200082,2225.475093,32,16,0,16,3,1996,Kristie Boogert
204420,2225.473565,2,2,0,0,38,2013,Marcela Zacarias
201427,2225.473077,43,22,0,21,4,2012,Alize Cornet
209433,2225.472845,2,2,0,0,36,2004,Madina Rakhim
202275,2225.471976,4,3,0,1,52,1998,Tagifano Soonalole
207933,2225.469324,4,3,0,1,30,2004,Sana Ben Salah
202864,2225.468533,4,3,0,1,39,2008,Amina Rakhim
202694,2225.449738,4,3,0,1,39,2008,Teliana Pereira
200452,2225.448979,4,3,0,1,25,1995,Tine Scheuer Larsen
212346,2225.44895,4,3,0,1,46,1993,Sandra Kellemberger
202711,2225.44895,2,2,0,0,42,1998,Antoaneta Pandjerova
207166,2225.443093,4,3,0,1,25,1998,Ismet Duygu Aksit Oal
201375,2225.437979,31,16,0,15,1,2006,Shenay Perry
201947,2225.433416,2,2,0,0,41,1992,Stephanie Mayorkis
204969,2225.433416,2,2,0,0,25,1998,Edita Liachoviciute
206937,2225.429602,2,2,0,0,29,2001,Nermien Abaza
202302,2225.42948,4,3,0,1,45,2010,Maria Fernanda Alves
204790,2225.418941,4,3,0,1,38,2001,Lourdes Lopez
206529,2225.415986,4,3,0,1,25,1998,Hanna Katri Aalto
202984,2225.414103,2,2,0,0,54,1999,Yang Jin Chung
201304,2225.410804,4,3,0,1,30,2006,Elena Baltacha
202828,2225.410484,4,3,0,1,31,2005,Larissa Carvalho
207914,2225.409294,2,2,0,0,34,2003,Paola Iovino
212082,2225.391811,6,4,0,2,32,1997,Lisa Camenzuli
201514,2225.377963,48,22,0,26,3,2009,Sorana Cirstea
208531,2225.160515,4,3,0,1,31,2010,Kirsten Andrea Weedon
200713,2225.136936,4,3,0,1,7,2002,Yuka Yoshida
200743,2225.118983,4,3,0,1,53,1999,Nirupama Sanjeev
201674,2225.111205,6,4,0,2,8,2011,Sabina Sharipova
201547,2225.05102,4,3,0,1,19,2015,Michelle Larcher De Brito
201624,2225.011198,6,4,0,2,7,1995,Eun Ha Kim
203217,2225.010027,4,3,0,1,25,1998,Karoline Borgersen
210539,2225.008567,4,3,0,1,30,2004,Tapiwa Marobela
202273,2224.999598,4,3,0,1,27,2012,Liga Dekmeijere
203084,2224.989368,2,2,0,0,25,1997,Daniela Olivera
202786,2224.985378,4,3,0,1,26,2005,Aurelija Miseviciute
202245,2224.980073,4,3,0,1,37,1999,Desislava Topalova
206598,2224.977378,2,2,0,0,28,1997,Maria Alejandra Claure
201676,2224.97222,4,3,0,1,31,2005,Ye Ra Lee
204282,2224.970267,4,3,0,1,39,2008,Anastasiya Prenko
212144,2224.969308,4,3,0,1,52,1998,Alissa Velts
205003,2224.966045,4,3,0,1,34,2003,Estefania Balda Alvarez
204590,2224.965353,4,3,0,1,30,1999,Gina Niland
204123,2224.964223,4,3,0,1,46,1993,Maria Dolores Campana
202583,2224.957447,4,3,0,1,33,2003,Megan Moulton Levy
202545,2224.95082,4,3,0,1,26,2007,Irina Kuzmina
206836,2224.949332,2,2,0,0,47,1992,Tina Vukasovic
209205,2224.949332,2,2,0,0,44,2014,Emma Hayman
212410,2224.945974,4,3,0,1,40,1992,Belkis Rodriguez
210303,2224.9457,4,3,0,1,26,2014,Kathinka Von Deichmann
212110,2224.939109,4,3,0,1,29,2001,Niki Williams
201701,2224.934713,2,2,0,0,37,2013,Basak Eraydin
202585,2224.929224,4,3,0,1,25,2008,Marinne Giraud
201641,2224.929224,4,3,0,1,29,2010,Nadia Lalami
206376,2224.926174,4,3,0,1,25,2013,Nour Abbes
211326,2224.924098,4,3,0,1,37,2013,Katherine Ip
201862,2224.923043,4,3,0,1,40,1998,Vanessa Menga
206904,2224.91534,4,3,0,1,52,1999,Yoannis Montesino
201386,2224.913587,8,5,0,3,11,2002,Jie Zheng
202997,2224.910725,4,3,0,1,52,2000,Yvonne Doyle
202869,2224.909519,2,2,0,0,31,2007,Nicole Thyssen
202352,2224.903882,4,3,0,1,35,2004,Daniela Munoz Gallegos
202981,2224.88089,10,6,0,4,33,1997,Melissa Beadman
202813,2224.875977,4,3,0,1,29,2004,Sofia Melikishvili
202302,2224.850886,8,5,0,3,21,2004,Maria Fernanda Alves
202984,2224.84739,2,2,0,0,46,2000,Yang Jin Chung
200109,2224.814567,30,14,0,16,1,2008,Nathalie Dechy
201084,2224.7575,15,8,0,7,4,2000,Nadejda Ostrovskaya
200025,2224.63685,4,3,0,1,41,2006,Ludmila Cervanova
201606,2224.58614,5,3,0,2,8,2010,Rebecca Marino
200014,2224.574821,8,5,0,3,20,2002,Tzipi Obziler
201455,2224.55702,31,14,0,17,4,2012,Elena Vesnina
203234,2224.541057,10,6,0,4,10,1997,Keiko Taguchi
202585,2224.496101,4,3,0,1,26,2007,Marinne Giraud
208230,2224.485996,2,2,0,0,34,1997,Samira Takourabet
203265,2224.482268,4,3,0,1,27,2007,Emma Murphy
203007,2224.475684,2,2,0,0,45,2000,Irawati Iskandar
202743,2224.467648,4,3,0,1,45,2000,Sai Jayalakshmy Jayaram
206091,2224.465504,4,3,0,1,27,2012,Yolande Leacock
201664,2224.463431,4,3,0,1,23,2005,Pemra Ozgen
202498,2224.462685,4,3,0,1,46,2011,Julia Glushko
206106,2224.461193,4,3,0,1,44,2014,Prarthana G Thombare
200584,2224.460029,34,17,0,17,3,1993,Laura Golarsa
201667,2224.450726,4,3,0,1,45,2010,Ling Zhang
206587,2224.447912,4,3,0,1,52,1999,Daniela Alvarez
206567,2224.446032,4,3,0,1,26,1995,Odeta Naujokaite
205615,2224.44589,4,3,0,1,31,2010,Julia Moriarty
202410,2224.443151,4,3,0,1,0,2012,Sofia Shapatava
212685,2224.442601,4,3,0,1,53,1999,Youliya Dimitrova
206824,2224.433308,4,3,0,1,53,2000,Azra Resic
201328,2224.415495,6,4,0,2,16,1998,Milagros Sequera
201890,2224.407991,4,3,0,1,45,1993,Xochitl Escobedo
207000,2224.406338,6,4,0,2,31,1998,Melissa Mendieta
201708,2224.396493,4,3,0,1,27,2012,Natalie Grandin
201585,2224.395444,41,21,0,20,7,2014,Sloane Stephens
201441,2224.38248,4,3,0,1,26,2009,Emma Laine
202397,2224.356599,4,3,0,1,24,2008,Lamia Essaadi
201728,2224.341514,4,3,0,1,40,1998,Jessica Steck
201602,2224.3299,3,2,0,1,9,2010,Beatrice Capra
201405,2224.237894,4,3,0,1,11,2002,Nan Nan Liu
201645,2224.237157,4,3,0,1,25,2007,Frederica Piedade
200357,2224.18298,32,16,0,16,1,1992,Rosalyn Nideffer
200009,2224.121543,6,4,0,2,32,1994,Tamarine Tanasugarn
202745,2224.04426,2,2,0,0,57,1997,Uzma Khan
201670,2224.036072,4,3,0,1,45,2010,Amra Sadikovic
206121,2224.020733,4,3,0,1,34,1993,Agnes Gee
200060,2224.002674,39,22,0,17,10,2007,Tathiana Garbin
206598,2223.999041,4,3,0,1,27,1996,Maria Alejandra Claure
212294,2223.995068,4,3,0,1,41,2012,Thisuri Molligoda
201328,2223.99214,4,3,0,1,45,2000,Milagros Sequera
212687,2223.989266,4,3,0,1,46,2000,Nida Waseem
200661,2223.98868,12,7,0,5,11,1997,Samantha Smith
204969,2223.968652,4,3,0,1,53,2000,Edita Liachoviciute
200357,2223.96564,38,17,0,21,6,1993,Rosalyn Nideffer
200702,2223.954392,12,6,0,6,1,1995,Naoko Kijimuta
205591,2223.954248,4,3,0,1,33,2013,Paula Cristina Goncalves
206910,2223.946255,4,3,0,1,37,2000,Mari Toro
207699,2223.941852,4,3,0,1,30,2001,Merve Asimgil
209836,2223.941852,4,3,0,1,25,2008,Nikkita Fountain
206213,2223.921802,4,3,0,1,31,2011,Amy Bowtell
202499,2223.90431,28,15,0,13,2,2013,Donna Vekic
202389,2223.9028,4,3,0,1,30,1999,Sandra Martinovic
200039,2223.774838,45,24,0,21,1,1997,Chanda Rubin
201401,2223.752632,13,7,0,6,3,2004,Abigail Spears
201397,2223.729471,9,5,0,4,8,2004,Shuai Peng
201729,2223.71151,8,5,0,3,17,1995,Larissa Schaerer
202245,2223.647888,2,2,0,0,48,1997,Desislava Topalova
212547,2223.614206,6,4,0,2,28,1996,Melissa Golfin
201616,2223.60961,41,21,0,20,4,2014,Lauren Davis
201454,2223.599831,8,5,0,3,33,2013,Akgul Amanmuradova
201365,2223.582781,18,9,0,9,8,2010,Edina Gallovits Hall
202187,2223.574012,8,5,0,3,8,1991,Ilana Berger
200091,2223.522481,21,12,0,9,9,2001,Janet Lee
200738,2223.484575,8,5,0,3,0,1996,Lenka Cenkova
200067,2223.448134,23,12,0,11,3,1996,Patty Schnyder
200068,2223.442103,48,23,0,25,7,2001,Lilia Osterloh
212684,2223.430771,4,3,0,1,53,1999,Eugenia Silantieva
210629,2223.408119,4,3,0,1,27,2012,Ilze Hattingh
201304,2223.351527,32,16,0,16,7,2010,Elena Baltacha
202218,2223.273741,4,3,0,1,41,1998,Anna Zaporozhanova
202135,2223.23818,5,3,0,2,1,2005,Vanessa Henke
200113,2223.211033,12,6,0,6,1,1996,Anna Kournikova
201322,2223.186536,4,3,0,1,26,2000,Eva Dyrberg
201380,2223.140557,16,8,0,8,5,2003,Claudine Schaul
201666,2223.130083,6,4,0,2,0,2012,Cagla Buyukakcay
212447,2223.092435,4,3,0,1,25,1993,Laura Olave
200011,2223.080659,53,27,0,26,5,2003,Katarina Srebotnik
200658,2223.069632,47,23,0,24,0,1998,Fang Li
201638,2223.028162,8,5,0,3,18,2011,Estrella Cabeza Candela
206904,2222.998572,6,4,0,2,27,1996,Yoannis Montesino
201637,2222.97907,6,4,0,2,31,2007,Melissa Torres Sandoval
202787,2222.969921,4,3,0,1,21,2004,Tatsiana Uvarova
200740,2222.96264,6,4,0,2,17,2004,Elena Tatarkova
201402,2222.950487,18,10,0,8,4,2010,Sesil Karatantcheva
201515,2222.933024,8,4,0,4,2,2013,Alisa Kleybanova
200640,2222.877715,44,20,0,24,0,1991,Mercedes Paz
200021,2222.846662,25,12,0,13,2,1994,Alexia Dechaume Balleret
201381,2222.661669,14,8,0,6,6,2005,Tian Tian Sun
201666,2222.617559,4,3,0,1,14,2010,Cagla Buyukakcay
200080,2222.555438,32,17,0,15,4,1996,Dominique Monami
201281,2222.534865,44,22,0,22,4,2003,Laura Granville
200104,2222.464942,51,30,0,21,5,2004,Emilie Loit
203570,2222.436377,6,4,0,2,37,2013,Bermet Duvanaeva
200663,2222.422262,26,13,0,13,7,1992,Nanne Dahlman
201492,2222.404947,57,32,0,25,1,2015,Andrea Petkovic
200002,2222.403138,24,11,0,13,10,1999,Mirjana Lucic
200027,2222.33496,37,18,0,19,8,1997,Magui Serna
201531,2222.329788,20,11,0,9,5,2015,Mariana Duque Marino
201397,2222.293929,47,23,0,24,2,2012,Shuai Peng
201344,2222.29285,52,27,0,25,2,2013,Klara Koukalova
200124,2222.278303,4,3,0,1,35,1993,Anne Kremer
201596,2222.264808,6,4,0,2,13,2008,Johanna Larsson
200732,2222.199858,38,20,0,18,3,1998,Magdalena Grzybowska
202503,2222.196258,12,7,0,5,3,2013,Luksika Kumkhum
201054,2222.175431,20,10,0,10,12,1991,Katia Piccolini
201209,2222.171323,4,3,0,1,30,1999,Selima Sfar
201521,2222.163671,56,29,0,27,3,2009,Carla Suarez Navarro
201709,2222.159957,13,7,0,6,4,2014,Yulia Putintseva
202289,2222.082032,4,3,0,1,8,2004,Jin Hee Kim
202194,2222.076364,13,7,0,6,52,1997,Anna Klim
201596,2222.048,41,20,0,21,9,2011,Johanna Larsson
200569,2222.046659,13,7,0,6,9,1996,Petra Pichalova Langrova
200559,2222.030838,38,19,0,19,4,1994,Kristine Kunce
200705,2222.011922,25,13,0,12,13,1993,Linda Ferrando
201593,2221.91395,30,15,0,15,3,2014,Irina Camelia Begu
201297,2221.812924,41,19,0,22,5,2003,Maja Matevzic
200660,2221.804959,9,5,0,4,4,1991,Kimberly Po Messerli
200111,2221.775616,38,20,0,18,8,2001,Lina Krasnoroutskaya
202663,2221.727573,6,4,0,2,13,2013,Magda Linette
201641,2221.705106,4,3,0,1,24,2008,Nadia Lalami
202494,2221.695692,10,5,0,5,0,2012,Elina Svitolina
200576,2221.691351,38,19,0,19,4,1990,Nathalie Herreman
200048,2221.686278,53,26,0,27,4,2003,Elena Likhovtseva
200063,2221.68128,52,22,0,30,5,2001,Tatiana Panova
200651,2221.59585,34,19,0,15,9,1996,Sabine Hack
200709,2221.583592,10,5,0,5,15,2000,Rosana De Los Rios
200006,2221.555625,31,17,0,14,4,1995,Karina Habsudova
200573,2221.543428,35,16,0,19,2,1990,Cecilia Dahlman
200122,2221.505453,37,19,0,18,7,2001,Tina Pisnik
200096,2221.317056,27,14,0,13,12,2002,Mary Pierce
201528,2221.306937,19,10,0,9,9,2012,Melanie Oudin
201067,2221.288331,3,2,0,1,23,1997,Caroline Dhenin
200106,2221.265101,42,22,0,20,11,2000,Angeles Montolio
200118,2221.157859,40,19,0,21,7,2002,Virginia Ruano Pascual
200043,2221.12677,18,9,0,9,5,2013,Virginie Razzano
201506,2221.095776,53,26,0,27,3,2009,Sara Errani
200056,2221.085282,36,16,0,20,3,2003,Jelena Kostanic Tosic
202123,2221.076616,4,3,0,1,23,1991,Suvimol Duangchan
201477,2221.064647,12,7,0,5,1,2006,Stephanie Dubois
201465,2221.028169,20,9,0,11,3,2009,Kirsten Flipkens
201302,2220.942201,6,4,0,2,22,2005,Clarisa Fernandez
200035,2220.881917,40,19,0,21,3,1999,Maria Sanchez Lorenzo
201481,2220.871575,36,16,0,20,2,2008,Tamira Paszek
200749,2220.861304,7,4,0,3,12,2001,Samantha Reeves
201291,2220.731511,43,21,0,22,2,2005,Nuria Llagostera Vives
200649,2220.712524,15,8,0,7,46,1995,Ginger Helgeson Nielsen
201533,2220.700872,4,2,0,2,5,2009,Shuai Zhang
200054,2220.681798,35,17,0,18,0,1998,Sylvia Plischke
201556,2220.673419,7,4,0,3,15,2008,Lucie Hradecka
200691,2220.608046,19,10,0,9,9,1996,Flora Perfetti
200682,2220.594274,47,23,0,24,9,2001,Joannette Kruger
201489,2220.582774,39,20,0,19,2,2008,Mariya Koryttseva
201466,2220.499958,5,3,0,2,2,2005,Kaia Kanepi
200125,2220.460435,39,20,0,19,4,2000,Corina Morariu
202486,2220.392152,7,4,0,3,5,2012,Mallory Burdette
201376,2220.351033,7,4,0,3,1,2008,Angela Haynes
200548,2220.307048,43,23,0,20,1,1994,Patty Fendick
200706,2220.233613,9,5,0,4,7,1993,Catalina Cristea
201498,2220.19879,44,20,0,24,3,2014,Karin Knapp
200346,2220.175318,40,19,0,21,11,1991,Anne Minter
201206,2220.132239,3,2,0,1,16,2000,Allison Bradshaw
200013,2220.121482,23,11,0,12,1,1992,Angelica Gavaldon
202072,2219.9408,4,3,0,1,5,2000,Tina Hergold
200048,2219.928871,51,24,0,27,4,2002,Elena Likhovtseva
202305,2219.903641,16,9,0,7,44,2001,Manisha Malhotra
200397,2219.898896,12,6,0,6,1,1993,Tracy Austin
201521,2219.88425,51,25,0,26,4,2012,Carla Suarez Navarro
200127,2219.875386,24,12,0,12,3,1996,Sarah Pitkowski Malcor
200737,2219.78061,15,8,0,7,3,1996,Aleksandra Olsza
201371,2219.774044,9,5,0,4,8,2003,Vera Dushevina
201367,2219.770377,21,10,0,11,7,2003,Arantxa Parra Santonja
200070,2219.70484,43,17,0,26,2,1999,Anne Gaelle Sidot
200111,2219.702202,14,7,0,7,1,2002,Lina Krasnoroutskaya
200717,2219.702033,21,9,0,12,1,1996,Anne Miller
201371,2219.680782,29,12,0,17,3,2011,Vera Dushevina
201516,2219.631788,9,5,0,4,7,2010,Evgeniya Rodina
200602,2219.594046,21,9,0,12,1,1992,Shaun Stafford
201572,2219.561426,5,3,0,2,8,2009,Regina Kulikova
200481,2219.516493,31,14,0,17,2,1994,Elna Reinach
201520,2219.466383,29,14,0,15,2,2008,Petra Kvitova
201303,2219.463629,9,5,0,4,22,2004,Anne Keothavong
200046,2219.439385,42,20,0,22,3,2004,Meghann Shaughnessy
200671,2219.40068,32,17,0,15,5,1993,Meike Babel
202421,2219.326062,5,3,0,2,22,2012,Alison Van Uytvanck
200009,2219.288272,50,25,0,25,3,2004,Tamarine Tanasugarn
201403,2219.228252,34,15,0,19,3,2009,Anna Chakvetadze
201549,2219.226466,30,16,0,14,3,2011,Petra Martic
200669,2219.153777,18,8,0,10,2,1994,Debbie Graham
201430,2219.132271,3,2,0,1,7,2004,Yulia Fedossova
200715,2219.069539,30,14,0,16,10,1999,Mariaan De Swardt
201495,2219.033493,6,4,0,2,5,2006,Dominika Cibulkova
211951,2219.002116,21,11,0,10,7,2015,Ana Konjuh
201809,2218.986193,6,4,0,2,6,1999,Hila Rosen
200693,2218.977777,11,6,0,5,5,1993,Elena Makarova
200718,2218.858043,33,17,0,16,1,1995,Ludmila Richterova
202286,2218.856305,7,4,0,3,6,2006,Elise Tamaela
201089,2218.805339,16,9,0,7,19,1997,Lucie Ahl
201490,2218.770579,4,3,0,1,18,2005,Timea Bacsinszky
200501,2218.765664,30,13,0,17,3,1992,Marianne Werdel Witmeyer
200655,2218.738316,9,5,0,4,22,1999,Nicole Arendt
201331,2218.662175,18,8,0,10,5,2002,Iveta Benesova
201450,2218.658053,37,18,0,19,2,2008,Tsvetana Pironkova
201591,2218.648214,3,2,0,1,16,2008,Margalita Chakhnashvili
207956,2218.572797,3,2,0,1,35,2003,Yanet Nunez Mojarena
201295,2218.544909,8,5,0,3,8,1997,Wynne Prakusya
201444,2218.399906,12,7,0,5,7,2015,Su Wei Hsieh
200006,2218.339324,3,2,0,1,8,1990,Karina Habsudova
201668,2218.32507,7,4,0,3,4,2009,Alexandra Panova
204294,2218.323915,3,2,0,1,6,2013,Su Jeong Jang
201286,2218.307474,61,33,0,28,1,2009,Anabel Medina Garrigues
201450,2218.270414,34,17,0,17,3,2010,Tsvetana Pironkova
202117,2218.246775,3,2,0,1,17,1998,Maria Paola Zavagli
200624,2218.223181,36,17,0,19,2,1991,Tami Whitlinger Jones
201441,2218.084452,14,8,0,6,1,2005,Emma Laine
200548,2218.068783,31,16,0,15,2,1990,Patty Fendick
200678,2217.987122,19,11,0,8,7,1996,Gloria Pizzichini
200043,2217.966135,29,14,0,15,3,2011,Virginie Razzano
201088,2217.962102,3,2,0,1,19,1997,Karen Cross
201072,2217.957491,12,7,0,5,14,2001,Eva Bes Ostariz
200107,2217.954442,25,13,0,12,2,1996,Paola Suarez
202128,2217.929143,3,2,0,1,9,1999,Riei Kawamata
201452,2217.901966,34,16,0,18,4,2012,Lourdes Dominguez Lino
200678,2217.891052,5,3,0,2,16,2000,Gloria Pizzichini
200664,2217.882199,5,3,0,2,56,1993,Stephanie Rehe
202231,2217.755521,5,3,0,2,9,1998,Shiho Hisamatsu
201294,2217.728758,51,26,0,25,1,2005,Marion Bartoli
200682,2217.698476,33,16,0,17,4,2000,Joannette Kruger
200641,2217.653585,24,12,0,12,6,1993,Patricia Tarabini
200070,2217.582142,46,22,0,24,4,1997,Anne Gaelle Sidot
200124,2217.580919,32,17,0,15,3,2004,Anne Kremer
201454,2217.492477,23,12,0,11,7,2009,Akgul Amanmuradova
200615,2217.489298,18,10,0,8,1,1995,Kristin Godridge
200653,2217.466925,35,18,0,17,9,1992,Yayuk Basuki
200682,2217.437926,47,25,0,22,3,1998,Joannette Kruger
200660,2217.42179,30,14,0,16,2,1992,Kimberly Po Messerli
201515,2217.352906,16,8,0,8,17,2014,Alisa Kleybanova
200699,2217.341994,26,11,0,15,2,1995,Meredith Mcgrath
201086,2217.315397,34,18,0,16,6,2011,Greta Arn
212119,2217.30906,5,3,0,2,31,1998,Luisa Elfride Lopez
201754,2217.286125,15,8,0,7,47,2001,Leanne Baker
200692,2217.254157,14,7,0,7,5,1993,Marzia Grossi
201089,2217.227138,5,3,0,2,22,2002,Lucie Ahl
200086,2217.168846,42,21,0,21,3,2005,Magdalena Maleeva
201386,2217.162306,25,12,0,13,4,2014,Jie Zheng
201587,2217.161122,36,18,0,18,4,2012,Bojana Jovanovski
201660,2217.125078,3,2,0,1,15,2008,Tereza Hladikova
200700,2217.070536,18,9,0,9,12,1991,Silvia Farina Elia
201597,2217.045216,46,24,0,22,5,2014,Kurumi Nara
200731,2217.036286,23,12,0,11,33,1997,Gail Biggs
200622,2217.030827,27,13,0,14,3,1991,Maya Kidowaki
201047,2217.013686,5,3,0,2,15,1992,Andrea Vieira
212542,2217.013402,7,4,0,3,31,1998,Lorena Porras
200648,2217.007454,16,7,0,9,8,1991,Marketa Kochta
201398,2216.999282,5,3,0,2,22,2004,Amanda Keen
201535,2216.983466,13,6,0,7,10,2012,Coco Vandeweghe
201652,2216.938023,3,2,0,1,5,2007,Ksenia Palkina
200732,2216.902108,29,14,0,15,2,1997,Magdalena Grzybowska
200010,2216.890715,21,10,0,11,1,1995,Rita Grande
201496,2216.870894,11,6,0,5,5,2006,Caroline Wozniacki
201312,2216.80963,5,3,0,2,1,1997,Sarah Taylor
201468,2216.801351,48,24,0,24,5,2010,Yaroslava Shvedova
201445,2216.771953,3,2,0,1,15,2003,Viktoria Kutuzova
200417,2216.75684,24,11,0,13,2,1995,Gigi Fernandez
201506,2216.721981,58,30,0,28,3,2011,Sara Errani
200046,2216.696801,40,18,0,22,6,2007,Meghann Shaughnessy
201620,2216.634299,37,19,0,18,4,2014,Monica Puig
201517,2216.496724,46,20,0,26,4,2014,Magdalena Rybarikova
201515,2216.483131,33,17,0,16,10,2008,Alisa Kleybanova
201662,2216.463891,3,2,0,1,24,2008,Karolina Pliskova
200736,2216.448011,8,4,0,4,0,1996,Li Ling Chen
200018,2216.413839,5,3,0,2,37,1998,Julia Abe
202418,2216.405074,5,3,0,2,17,2011,Lara Arruabarrena
200740,2216.399401,19,9,0,10,2,1998,Elena Tatarkova
200035,2216.38222,42,22,0,20,5,2003,Maria Sanchez Lorenzo
203002,2216.381215,5,3,0,2,43,1994,Karin Palme
201391,2216.312547,12,6,0,6,6,2004,Sanda Mamic
201336,2216.258525,29,13,0,16,5,2010,Dinara Safina
201346,2216.248022,17,8,0,9,3,2003,Lubomira Kurhajcova
201394,2216.22577,45,20,0,25,3,2009,Anna Lena Groenefeld
206587,2216.21251,5,3,0,2,31,1998,Daniela Alvarez
202556,2216.203971,1,1,0,0,26,2009,Ana Jovanovic
212464,2216.201426,3,2,0,1,21,1992,Yeon Sook Kim
201394,2216.191465,14,7,0,7,1,2008,Anna Lena Groenefeld
201457,2216.187135,3,2,0,1,40,2003,Jarmila Gajdosova
200088,2216.171712,7,4,0,3,0,1996,Adriana Gersi
201204,2216.103325,5,3,0,2,25,2008,Iroda Tulyaganova
200485,2216.07557,28,14,0,14,7,1991,Manon Bollegraf
200015,2216.069646,22,12,0,10,5,2001,Petra Mandula
200026,2216.023548,22,12,0,10,15,2000,Florencia Labat
202266,2215.985641,5,3,0,2,27,2007,Kelly Liggan
200648,2215.959798,16,7,0,9,2,1993,Marketa Kochta
201574,2215.936291,3,2,0,1,26,2005,Neuza Silva
201310,2215.885401,30,14,0,16,1,2006,Martina Muller
200009,2215.850349,25,12,0,13,4,2009,Tamarine Tanasugarn
200602,2215.826014,33,16,0,17,2,1993,Shaun Stafford
200764,2215.805351,3,2,0,1,14,2008,Elena Bovina
201298,2215.789632,15,8,0,7,5,2001,Zsofia Gubacsi
200094,2215.788333,6,3,0,3,6,1990,Barbara Rittner
204655,2215.763297,5,3,0,2,46,1996,Gulberk Gultekin
201539,2215.750642,46,25,0,21,5,2012,Christina Mchale
201708,2215.720107,5,3,0,2,13,2011,Natalie Grandin
200022,2215.616061,3,2,0,1,10,1996,Emmanuelle Gagliardi
201331,2215.576282,56,29,0,27,3,2009,Iveta Benesova
201366,2215.565194,1,1,0,0,20,2002,Barbora Zahlavova Strycova
201293,2215.555136,10,6,0,4,33,2013,Catalina Castano
202428,2215.546578,31,17,0,14,3,2014,Kiki Bertens
204419,2215.51389,5,3,0,2,27,2012,Ana Sofia Sanchez
202509,2215.491083,3,2,0,1,37,2000,Joelle Schad
201084,2215.479717,3,2,0,1,34,2003,Nadejda Ostrovskaya
202415,2215.474784,3,2,0,1,31,2010,Ximena Hermoso
201408,2215.457681,41,21,0,20,1,2006,Jamea Jackson
202344,2215.454628,3,2,0,1,37,2002,Magda Mihalache
201617,2215.449146,3,2,0,1,17,2010,Ana Vrljic
201452,2215.384906,10,6,0,4,15,2005,Lourdes Dominguez Lino
201920,2215.374909,3,2,0,1,12,1999,Renata Kolbovic
202123,2215.350836,5,3,0,2,1,1995,Suvimol Duangchan
200522,2215.329836,24,12,0,12,17,1990,Nicole Krijger Jagerman
201085,2215.286571,43,21,0,22,4,2004,Shinobu Asagoe
200041,2215.281847,38,19,0,19,13,2001,Amy Frazier
200570,2215.264234,25,12,0,13,5,1992,Veronika Martinek
201672,2215.202711,9,5,0,4,8,2014,Nigina Abduraimova
200743,2215.153873,3,2,0,1,33,1994,Nirupama Sanjeev
200638,2215.13523,3,2,0,1,6,1990,Stephanie Rottier
201483,2215.112849,8,4,0,4,4,2014,Madison Brengle
201363,2215.076475,42,21,0,21,3,2010,Gisela Dulko
204516,2215.025628,1,1,0,0,31,1998,Melody Falco
201667,2215.017784,10,6,0,4,4,2014,Ling Zhang
202291,2215.011022,9,5,0,4,9,1999,Seiko Okamoto
208983,2215.009811,3,2,0,1,24,2011,Larikah Russell
206606,2215.007097,1,1,0,0,25,2008,Claudia Herbas
201456,2214.976057,3,2,0,1,6,2004,Olga Savchuk
212352,2214.95847,5,3,0,2,34,1997,Line Ullring
212104,2214.952674,3,2,0,1,28,2001,Tinesta Rowe
204874,2214.950171,5,3,0,2,44,2001,Tracey Oconnor
201209,2214.937812,5,3,0,2,15,1996,Selima Sfar
202507,2214.894559,5,3,0,2,37,2013,Wing Yau Venise Chan
201523,2214.871456,3,2,0,1,35,2004,Marina Erakovic
202218,2214.859522,5,3,0,2,26,2000,Anna Zaporozhanova
201686,2214.85475,5,3,0,2,31,2010,Alejandra Granillo
212045,2214.816652,5,3,0,2,27,2012,Sinead Lohan
204588,2214.79957,3,2,0,1,25,1995,Karen Nugent
200472,2214.797222,46,26,0,20,3,1991,Helen Kelesi
200089,2214.78172,38,19,0,19,4,1996,Miriam Oremans
202326,2214.753546,5,3,0,2,36,2004,Ankita Bhambri
201681,2214.681512,3,2,0,1,40,2009,Suchanun Viratprasert
202341,2214.670532,3,2,0,1,3,2004,Melanie Gloria
201524,2214.652175,7,4,0,3,4,2007,Urszula Radwanska
201578,2214.601401,10,5,0,5,4,2009,Kai Chen Chang
201747,2214.593595,5,3,0,2,32,1992,Lihini Weerasuriya
202309,2214.587729,13,7,0,6,35,2003,Ana Lucia Migliarini De Leon
206456,2214.547008,1,1,0,0,54,1999,Virginia Sadi
206563,2214.546276,3,2,0,1,47,1996,Helen Laupa
201485,2214.546164,40,18,0,22,3,2010,Alla Kudryavtseva
202659,2214.545791,1,1,0,0,41,2012,Tereza Mrdeza
201348,2214.543165,38,20,0,18,10,2008,Casey Dellacqua
200659,2214.54134,16,8,0,8,6,1991,Rika Hiraki
202717,2214.528245,3,2,0,1,53,2000,Katarina Misic
212102,2214.526757,1,1,0,0,53,1999,Viviana Rivero
201862,2214.506561,1,1,0,0,42,1995,Vanessa Menga
212171,2214.506326,3,2,0,1,33,1992,Francesca La&#39;O
204731,2214.488539,5,3,0,2,9,1999,Etsuko Yamada
209507,2214.488406,3,2,0,1,25,2008,Trina Slapeka
212589,2214.48333,3,2,0,1,53,1999,Tatiana Babina
201669,2214.471295,3,2,0,1,6,2006,Yan Chong Chen
209712,2214.468329,5,3,0,2,27,2012,Elaine Genovese
200120,2214.461234,3,2,0,1,0,1998,Jelena Dokic
200716,2214.454494,13,7,0,6,1,1994,Sung Hee Park
200070,2214.412847,52,25,0,27,6,2000,Anne Gaelle Sidot
201061,2214.399194,3,2,0,1,54,2001,Eva Martincova
201554,2214.374,3,2,0,1,3,2014,Vitalia Diatchenko
200127,2214.338766,38,19,0,19,16,2000,Sarah Pitkowski Malcor
202309,2214.302556,5,3,0,2,36,2002,Ana Lucia Migliarini De Leon
200769,2214.302337,3,2,0,1,20,1999,Giulia Casoni
201311,2214.29476,33,15,0,18,2,2005,Roberta Vinci
200062,2214.294491,50,25,0,25,5,2000,Kristina Brandi
202426,2214.273986,3,2,0,1,36,2014,Julia Boserup
202449,2214.241141,3,2,0,1,8,2011,Victoria Larriere
201571,2214.201943,5,3,0,2,7,2007,Masa Zec Peskiric
201407,2214.176675,7,4,0,3,6,2004,Evgenia Linetskaya
200630,2214.155334,28,15,0,13,11,1993,Laura Gildemeister
202458,2214.132437,10,5,0,5,8,2013,Ashleigh Barty
200765,2214.113657,3,2,0,1,16,2008,Katalin Marosi
200671,2214.098774,25,13,0,12,3,1994,Meike Babel
214624,2214.062547,3,2,0,1,43,2014,Anastasia Detiuc
208686,2214.044634,1,1,0,0,26,2005,Sanja Racic
212424,2214.024294,1,1,0,0,41,1992,Marlene Zuleta
200736,2214.024294,1,1,0,0,41,1993,Li Ling Chen
204017,2214.024294,1,1,0,0,36,1997,Dragana Ilic
206583,2214.024294,1,1,0,0,39,2000,Monica Poveda
206911,2214.024294,1,1,0,0,38,2000,Carla Prieto
208060,2214.024294,1,1,0,0,53,2000,Sihem Ben Youcef
212128,2214.024294,1,1,0,0,32,2001,Y FARID
202071,2214.024294,1,1,0,0,36,2003,Dragana Zaric
205467,2214.024294,1,1,0,0,32,2005,Maria Eugenia Roca Recarey
208549,2214.024294,1,1,0,0,28,2006,Aliaa Fakhry
212201,2214.024294,1,1,0,0,41,2008,Tatyana Ignatchenko
202393,2214.024294,3,2,0,1,26,2009,Andrea Koch Benvenuto
200003,2214.024294,3,2,0,1,51,2011,Justine Henin
201505,2214.017443,4,2,0,2,10,2007,Ekaterina Makarova
202943,2214.013596,3,2,0,1,32,2000,Evagelia Roussi
202453,2214.006242,12,6,0,6,4,2014,Saisai Zheng
212778,2214.004741,1,1,0,0,34,1998,Maria Elena Del Valle
208549,2214.004712,3,2,0,1,26,2005,Aliaa Fakhry
207700,2214.003951,1,1,0,0,48,1996,Seden Ozlu
206038,2214.003951,1,1,0,0,33,2010,Mariana Demichelli Vergara
202331,2214.003922,3,2,0,1,30,2006,Vilmarie Castellvi
201326,2214.00323,3,2,0,1,26,1995,Bahia Mouhtassine
209534,2214.003163,1,1,0,0,45,2010,Isaura Enrique Aguilar
212094,2214.003162,5,3,0,2,44,2001,Shareen Rena Lai
202349,2213.983668,1,1,0,0,45,2010,Rushmi Chakravarthi
204327,2213.982098,3,2,0,1,28,2012,Mai Grage
201441,2213.965286,3,2,0,1,30,2011,Emma Laine
205908,2213.964874,3,2,0,1,27,2012,Menna El Nagdy
202694,2213.964112,1,1,0,0,46,2011,Teliana Pereira
201527,2213.96097,21,10,0,11,7,2009,Stefanie Voegele
206989,2213.94853,3,2,0,1,32,1998,Karla Lehnoff
201747,2213.945901,3,2,0,1,21,1991,Lihini Weerasuriya
210303,2213.945891,5,3,0,2,26,2009,Kathinka Von Deichmann
206924,2213.94518,3,2,0,1,23,2011,Ana Maria Zuleta
205465,2213.923452,3,2,0,1,25,2008,Daniela Trigo
201481,2213.922919,18,9,0,9,8,2010,Tamira Paszek
210173,2213.905522,5,3,0,2,41,2012,Ushna Suhail
201304,2213.901068,11,6,0,5,11,2009,Elena Baltacha
200681,2213.888341,17,8,0,9,12,1994,Natalia Baudone Furlan
201360,2213.860556,11,6,0,5,18,2006,Julia Vakulenko
204633,2213.855898,1,1,0,0,31,1998,Paola Palencia
200076,2213.776984,7,4,0,3,5,1993,Laurence Courtois
200042,2213.76883,7,4,0,3,9,1994,Els Callens
202487,2213.765383,5,3,0,2,22,2014,Nastassja Burnett
212165,2213.730161,7,4,0,3,31,1998,Anneliese Rose
212738,2213.729278,5,3,0,2,44,2000,Zihaida Shantalova
200700,2213.714803,37,18,0,19,4,2000,Silvia Farina Elia
201296,2213.686753,5,3,0,2,23,2000,Bianka Lamade
203058,2213.617,3,2,0,1,9,1999,Yoshiko Sasano
201722,2213.6012,7,4,0,3,0,1991,Luanne Spadea
204306,2213.560556,5,3,0,2,37,2013,Trang Huynh Phuong Dai
206039,2213.559412,3,2,0,1,25,2008,Marie Elise Casares
202471,2213.551678,3,2,0,1,43,2014,Karen Barbat
202344,2213.544083,3,2,0,1,35,2003,Magda Mihalache
204969,2213.541827,3,2,0,1,27,2003,Edita Liachoviciute
212508,2213.539954,1,1,0,0,26,1998,Naira Santrosian
201598,2213.539954,1,1,0,0,37,2013,Noppawan Lertcheewakarn
201596,2213.523266,3,2,0,1,31,2007,Johanna Larsson
201204,2213.520949,3,2,0,1,57,1996,Iroda Tulyaganova
206771,2213.520372,1,1,0,0,28,2001,Suheil Lizana
202462,2213.520372,1,1,0,0,31,2005,Karen Castiblanco
209805,2213.520372,1,1,0,0,32,2007,Maria Eugenia Torres
202303,2213.51958,1,1,0,0,42,1999,Carla Tiene
204290,2213.51958,1,1,0,0,39,2009,Min Hwa Yu
212117,2213.519493,3,2,0,1,29,2001,Lucia Henkle Gomez
212095,2213.518821,5,3,0,2,44,2001,Chen Yee Liaw
212801,2213.5,1,1,0,0,26,1991,Loredana Bujor
200620,2213.5,3,2,0,1,63,1992,Kirrily Sharpe
212397,2213.5,1,1,0,0,50,1992,Raminta Mackeviciute
203929,2213.5,1,1,0,0,46,1993,Giana Gutierrez
204588,2213.5,1,1,0,0,37,1993,Karen Nugent
206836,2213.5,1,1,0,0,36,1993,Tina Vukasovic
206917,2213.5,1,1,0,0,49,1993,Alexandra Guzman
202166,2213.5,3,2,0,1,47,1994,Emilie Viqueira
212346,2213.5,1,1,0,0,48,1994,Sandra Kellemberger
200545,2213.5,3,2,0,1,66,1995,Ei Iida
201811,2213.5,1,1,0,0,38,1995,Young Ja Choi
206891,2213.5,1,1,0,0,30,1995,Sandra Olsen
200775,2213.5,1,1,0,0,47,1996,Tatiana Kovaltchouk
201625,2213.5,1,1,0,0,59,1996,Ju Yeon Choi
201847,2213.5,5,3,0,2,8,1996,Mareze Joubert
202218,2213.5,1,1,0,0,48,1996,Anna Zaporozhanova
202993,2213.5,9,5,0,4,8,1996,Sachie Umehara
204593,2213.5,3,2,0,1,48,1996,Claire Curran
201807,2213.5,3,2,0,1,62,1997,Li Yao Tang
204605,2213.5,1,1,0,0,38,1997,Joana Pedroso
204756,2213.5,1,1,0,0,42,1997,Maria Alejandra Quezada
206563,2213.5,1,1,0,0,38,1997,Helen Laupa
206898,2213.5,1,1,0,0,31,1997,Carolina Molins
207625,2213.5,1,1,0,0,32,1997,Aina Rafolomanantsiatosika
202984,2213.5,1,1,0,0,56,1998,Yang Jin Chung
206871,2213.5,1,1,0,0,26,1998,Maria Rasmussen
212752,2213.5,1,1,0,0,52,1998,Sandrella Droubi
200014,2213.5,1,1,0,0,33,1999,Tzipi Obziler
201811,2213.5,1,1,0,0,56,1999,Young Ja Choi
202997,2213.5,1,1,0,0,34,1999,Yvonne Doyle
203125,2213.5,9,5,0,4,52,1999,Rochelle Rosenfield
203183,2213.5,5,3,0,2,52,1999,Christina Horiatopoulos
202128,2213.5,9,5,0,4,59,2000,Riei Kawamata
203996,2213.5,1,1,0,0,56,2000,Cristina Correia
204970,2213.5,1,1,0,0,55,2000,Karina Ildor Jacobsgaard
212572,2213.5,1,1,0,0,52,2000,Hermine Sukiasyan
201381,2213.5,1,1,0,0,48,2001,Tian Tian Sun
203140,2213.5,1,1,0,0,40,2001,Bruna Colosio
203143,2213.5,7,4,0,3,52,2001,Nicole Sewell
206543,2213.5,9,5,0,4,52,2001,Marina Petrovic
200100,2213.5,1,1,0,0,39,2002,Amanda Hopmans
202374,2213.5,9,5,0,4,56,2002,Nicole Kriz
203125,2213.5,9,5,0,4,56,2002,Rochelle Rosenfield
203290,2213.5,1,1,0,0,45,2002,Piia Suomalainen
203404,2213.5,9,5,0,4,56,2002,Svenja Weidemann
204575,2213.5,5,3,0,2,63,2002,Helga Vieira
204942,2213.5,9,5,0,4,56,2002,Madita Suer
202303,2213.5,9,5,0,4,45,2003,Carla Tiene
205012,2213.5,1,1,0,0,30,2003,Amani Khalifa
206954,2213.5,1,1,0,0,32,2003,Egle Petrauskaite
205003,2213.5,3,2,0,1,37,2004,Estefania Balda Alvarez
205155,2213.5,1,1,0,0,34,2004,Gabriela Niculescu
200697,2213.5,3,2,0,1,48,2005,Janette Husarova
201663,2213.5,1,1,0,0,32,2005,Ekaterina Dzehalevich
202281,2213.5,1,1,0,0,35,2005,Ivanna Israilova
202556,2213.5,1,1,0,0,34,2005,Ana Jovanovic
204809,2213.5,1,1,0,0,32,2005,Maria Penkova
205155,2213.5,1,1,0,0,29,2005,Gabriela Niculescu
209569,2213.5,1,1,0,0,28,2005,Sara Meghoufel
212196,2213.5,1,1,0,0,26,2005,Alet Boonzaaier
201666,2213.5,1,1,0,0,29,2006,Cagla Buyukakcay
203191,2213.5,1,1,0,0,33,2006,Danica Krstajic
205348,2213.5,3,2,0,1,31,2006,Wei Ping Lee
205532,2213.5,1,1,0,0,28,2006,Karoline Steiro
208979,2213.5,1,1,0,0,28,2006,Idunn Hertzberg
201689,2213.5,1,1,0,0,33,2007,Magali De Lattre
202471,2213.5,1,1,0,0,31,2007,Karen Barbat
204220,2213.5,1,1,0,0,36,2007,Dianne Hollands
202382,2213.5,1,1,0,0,39,2008,Ekaterina Shulaeva
202545,2213.5,1,1,0,0,29,2008,Irina Kuzmina
203469,2213.5,1,1,0,0,40,2008,Albina Khabibulina
205700,2213.5,1,1,0,0,28,2008,Emma Flood
205773,2213.5,1,1,0,0,42,2008,Valentina Starkova
209984,2213.5,1,1,0,0,39,2008,Kim Sadi
212246,2213.5,1,1,0,0,40,2008,Jithmie Jayawickrema
201679,2213.5,1,1,0,0,39,2009,Varatchaya Wongteanchai
202869,2213.5,1,1,0,0,40,2009,Nicole Thyssen
202390,2213.5,1,1,0,0,45,2010,Ellen Barry
202467,2213.5,1,1,0,0,46,2010,Elitsa Kostova
203235,2213.5,1,1,0,0,45,2010,Po Kuen Lam
202359,2213.5,3,2,0,1,50,2011,Chin Wei Chan
203352,2213.5,1,1,0,0,31,2011,Jasmina Kajtazovic
211208,2213.5,1,1,0,0,50,2011,Ho Ching Wu
211326,2213.5,3,2,0,1,50,2011,Katherine Ip
212184,2213.5,1,1,0,0,50,2011,Jenneta Halliyeva
202325,2213.5,1,1,0,0,45,2012,Isha Lakhani
204391,2213.5,1,1,0,0,30,2012,Sofia Kvatsabaia
210951,2213.5,1,1,0,0,45,2012,Marian Jade Capadocia
201494,2213.5,1,1,0,0,37,2013,Raluca Olaru
202467,2213.5,1,1,0,0,38,2013,Elitsa Kostova
211208,2213.5,1,1,0,0,42,2013,Ho Ching Wu
201677,2213.5,1,1,0,0,46,2014,Mi Yoo
201707,2213.5,3,2,0,1,51,2014,Sachie Ishizu
203433,2213.5,1,1,0,0,47,2014,Rishika Sunkara
206245,2213.5,1,1,0,0,42,2014,Ofri Lankri
214129,2213.5,1,1,0,0,34,2014,Camila Vargas Gomez
201380,2213.5,1,1,0,0,37,2015,Claudine Schaul
201503,2213.5,1,1,0,0,27,2015,Ayumi Morita
201646,2213.5,1,1,0,0,37,2015,Maria Joao Koehler
202365,2213.5,1,1,0,0,28,2015,Lavinia Tananta
202471,2213.5,1,1,0,0,27,2015,Karen Barbat
202475,2213.5,1,1,0,0,37,2015,Jasmina Tinjic
202581,2213.5,1,1,0,0,37,2015,Chanel Simmonds
202900,2213.5,1,1,0,0,37,2015,Maria Fernanda Alvarez Teran
204362,2213.5,1,1,0,0,28,2015,Theiviya Selvarajoo
206063,2213.5,1,1,0,0,28,2015,Caroline Rohde Moe
208603,2213.5,1,1,0,0,28,2015,Amira Benaissa
210138,2213.5,1,1,0,0,37,2015,Noelia Zeballos
210173,2213.5,1,1,0,0,27,2015,Ushna Suhail
210640,2213.5,1,1,0,0,28,2015,Liniques Theron
210871,2213.5,1,1,0,0,28,2015,Steffi Carruthers
211105,2213.5,1,1,0,0,27,2015,Akvile Parazinskaite
211227,2213.5,1,1,0,0,27,2015,Lina Gjorcheska
211267,2213.5,1,1,0,0,27,2015,Daniela Ciobanu
211529,2213.5,1,1,0,0,37,2015,Sandra Samir
212302,2213.5,1,1,0,0,28,2015,Lesedi Sheya Jacobs
212304,2213.5,1,1,0,0,27,2015,Maria Siopacha
213023,2213.5,1,1,0,0,27,2015,Iman Qureshi
213628,2213.5,1,1,0,0,28,2015,Melanie Stokke
213734,2213.5,1,1,0,0,37,2015,Mariam Bolkvadze
213972,2213.5,1,1,0,0,28,2015,Ines Ibbou
214905,2213.5,1,1,0,0,28,2015,Abigail Tere Apisah
215017,2213.5,1,1,0,0,37,2015,Lauren Deegan
215123,2213.5,1,1,0,0,28,2015,Yus Syazlin Nabila Binti Yusri
208797,2213.4993,3,2,0,1,39,2008,Denise Dy
212688,2213.499211,3,2,0,1,53,1999,Joanna Phang
204564,2213.499208,1,1,0,0,54,1999,Ya Ming Lin
201610,2213.498464,3,2,0,1,16,2009,Zarina Diyas
200058,2213.49794,11,6,0,5,21,1999,Anna Foldenyi Dicker
201300,2213.484739,14,8,0,6,4,2007,Maria Emilia Salerni
206329,2213.480507,3,2,0,1,37,2013,Montserrat Gonzalez
206240,2213.48042,3,2,0,1,31,2014,Patricia Ku Flores
205487,2213.479691,3,2,0,1,33,2005,Anja Vanessa Peter
203148,2213.47966,3,2,0,1,35,2004,Shu Jing Yang
206666,2213.479628,1,1,0,0,37,2000,Paula Umana
204282,2213.479384,5,3,0,2,41,2012,Anastasiya Prenko
213795,2213.478903,1,1,0,0,31,2014,Ariana Rodriguez
202509,2213.464504,3,2,0,1,24,1991,Joelle Schad
207497,2213.46016,3,2,0,1,25,1998,Biljana Trpeska
206579,2213.460104,3,2,0,1,35,2004,Sarah Tami Masi
212314,2213.460048,3,2,0,1,44,2014,Jahana Bayramova
200710,2213.459317,1,1,0,0,48,1996,Magdalena Feistel
202828,2213.459317,1,1,0,0,38,2004,Larissa Carvalho
202619,2213.459317,1,1,0,0,31,2011,Ema Burgic
209154,2213.458533,3,2,0,1,43,2014,Nantenaina Ramalalaharivololona
203217,2213.447873,3,2,0,1,26,2006,Karoline Borgersen
201667,2213.443608,5,3,0,2,31,2007,Ling Zhang
202983,2213.441441,9,5,0,4,9,1999,Chisayo Ito
205787,2213.440466,3,2,0,1,31,2014,Francesca Segarelli
202078,2213.432867,5,3,0,2,25,1995,Rosabel Moyen
204426,2213.425772,3,2,0,1,41,2012,Anett Kontaveit
210920,2213.424323,5,3,0,2,31,2010,Kerrie Cartwright
201293,2213.423449,5,3,0,2,42,1999,Catalina Castano
204288,2213.42191,1,1,0,0,37,2015,Ji Hee Choi
212446,2213.420215,5,3,0,2,45,1993,Elizabeth Gibson
202123,2213.419484,3,2,0,1,32,1994,Suvimol Duangchan
200748,2213.413638,2,1,0,1,2,1994,Venus Williams
201061,2213.412201,3,2,0,1,40,1999,Eva Martincova
201963,2213.372607,3,2,0,1,36,1993,Sofia Prazeres
212446,2213.370277,5,3,0,2,26,1997,Elizabeth Gibson
205143,2213.367378,3,2,0,1,31,2005,Valentina Castro
200059,2213.354266,3,2,0,1,21,1991,Ruxandra Dragomir Ilie
201482,2213.33334,5,3,0,2,7,2006,Andreja Klepac
212125,2213.294097,3,2,0,1,36,1993,Carol Cassar Torreggiani
201623,2213.293259,5,3,0,2,5,1996,Jing Jing Chen
200047,2213.272133,25,11,0,14,5,2000,Pavlina Nola
200530,2213.267028,32,15,0,17,2,1990,Radomira Zrubakova
201477,2213.266173,5,3,0,2,1,2005,Stephanie Dubois
202470,2213.250341,42,20,0,22,3,2014,Annika Beck
201334,2213.149797,5,3,0,2,9,2010,Zuzana Ondraskova
200530,2213.149553,25,13,0,12,6,1994,Radomira Zrubakova
206583,2213.141308,5,3,0,2,25,1997,Monica Poveda
201617,2213.140557,3,2,0,1,21,2008,Ana Vrljic
201503,2213.135426,3,2,0,1,20,2006,Ayumi Morita
202292,2213.11047,9,5,0,4,8,1996,Ayami Takase
200019,2213.093186,36,18,0,18,4,1997,Alexandra Fusai
201729,2213.07506,3,2,0,1,37,2002,Larissa Schaerer
205925,2213.073243,13,6,0,7,3,2015,Aliaksandra Sasnovich
202511,2213.056091,7,4,0,3,15,1992,Paulina Sepulveda
212249,2213.050844,1,1,0,0,25,2008,Mia Radulovic
202705,2213.037319,3,2,0,1,39,2009,Veronica Cepede Royg
206285,2213.036031,3,2,0,1,44,2014,Inna Volkovich
210539,2213.035128,3,2,0,1,29,2001,Tapiwa Marobela
212764,2213.033379,1,1,0,0,56,1997,Sheau Shan Liew
200032,2213.019984,36,18,0,18,4,2004,Barbara Schett
212178,2213.019022,3,2,0,1,33,2003,Ashley Brooks
204540,2213.017902,3,2,0,1,42,1995,Maria Virginia Francesca
204690,2213.017186,3,2,0,1,36,2003,Czarina Mae Arevalo
204898,2213.0166,3,2,0,1,29,2001,Noha Mohsen
211394,2213.015659,3,2,0,1,31,2014,Daniela Ruiz
206600,2213.015604,1,1,0,0,34,1998,Monica Ribero
206903,2213.012538,3,2,0,1,36,2000,Glenny Cepeda
212102,2213.012537,3,2,0,1,36,2000,Viviana Rivero
202694,2213.010889,1,1,0,0,33,2007,Teliana Pereira
207543,2212.997476,3,2,0,1,33,1992,Jennifer Saret
202325,2212.996078,3,2,0,1,32,2006,Isha Lakhani
212315,2212.996078,3,2,0,1,44,2014,Thi Tam Hao Tran
203002,2212.99605,3,2,0,1,37,1996,Karin Palme
212125,2212.996049,1,1,0,0,54,2000,Carol Cassar Torreggiani
212212,2212.996049,1,1,0,0,53,2000,Olga Cosic
206086,2212.996049,1,1,0,0,32,2011,Mai El Kamash
203216,2212.996018,3,2,0,1,35,2004,Marcela Arroyo Vergara
212171,2212.995376,3,2,0,1,36,2003,Francesca La&#39;O
202545,2212.983441,3,2,0,1,26,2009,Irina Kuzmina
212300,2212.97891,5,3,0,2,27,2012,Mara Argyriou
202246,2212.97841,5,3,0,2,52,2001,Ines Heise
202757,2212.97841,9,5,0,4,52,2001,Alyssa Cohen
212316,2212.978006,3,2,0,1,44,2014,Rheeya Doshi
203362,2212.976519,3,2,0,1,39,2009,Vivian Segnini
209807,2212.976497,3,2,0,1,31,2007,Maria Jose Arechavaleta
212511,2212.975707,3,2,0,1,34,1997,Zara Wolseley
212767,2212.975706,1,1,0,0,26,1991,Robyn Farrington
202257,2212.975706,1,1,0,0,41,1992,Carmina Giraldo
212467,2212.975706,1,1,0,0,49,1992,Siri Mittet
202349,2212.975706,1,1,0,0,33,1994,Rushmi Chakravarthi
206902,2212.975706,1,1,0,0,48,1994,Yamile Cordova
206626,2212.975706,1,1,0,0,48,1995,Nuria Niemes
212586,2212.975706,1,1,0,0,28,1995,Yasmin Kaya
201418,2212.975706,1,1,0,0,58,1996,Ting Li
202999,2212.975706,1,1,0,0,38,1996,Eugenia Maia
204590,2212.975706,3,2,0,1,48,1996,Gina Niland
212696,2212.975706,1,1,0,0,58,1996,Olesya Artemeva
201204,2212.975706,1,1,0,0,59,1997,Iroda Tulyaganova
204888,2212.975706,1,1,0,0,37,1997,Ljiljana Nanusevic
206699,2212.975706,1,1,0,0,37,1997,Elena Manevska
212485,2212.975706,1,1,0,0,35,1997,Harisa Delic
207429,2212.975706,1,1,0,0,27,1998,Ana Buraku
212383,2212.975706,1,1,0,0,28,1998,Elena Arabadji
204772,2212.975706,1,1,0,0,55,2000,Liina Suurvarik
204781,2212.975706,1,1,0,0,55,2000,Rikke Faurfelt
212084,2212.975706,1,1,0,0,48,2000,Nicole Angat
212576,2212.975706,1,1,0,0,55,2000,Renata Ljukovcan
201605,2212.975706,1,1,0,0,39,2001,Mandy Minella
206551,2212.975706,1,1,0,0,31,2001,Maja Mesanovic
200078,2212.975706,3,2,0,1,51,2003,Barbara Schwartz
201390,2212.975706,3,2,0,1,29,2003,Mervana Jugic Salkic
204898,2212.975706,1,1,0,0,30,2003,Noha Mohsen
201637,2212.975706,1,1,0,0,37,2004,Melissa Torres Sandoval
201589,2212.975706,1,1,0,0,32,2005,Sharon Fichman
201689,2212.975706,1,1,0,0,27,2005,Magali De Lattre
204584,2212.975706,1,1,0,0,27,2005,Carlota Plantier Santos
203457,2212.975706,3,2,0,1,32,2006,Polona Rebersak
205883,2212.975706,1,1,0,0,40,2008,Anett Schutting
209033,2212.975706,1,1,0,0,24,2011,Paulina Schippers
212280,2212.975706,1,1,0,0,31,2012,Ana Sofia Cordero
205925,2212.975706,3,2,0,1,38,2013,Aliaksandra Sasnovich
211269,2212.975706,1,1,0,0,41,2013,Eudice Wong Chong
211267,2212.975706,1,1,0,0,45,2014,Daniela Ciobanu
214633,2212.975706,1,1,0,0,43,2014,Andria Tsaggaridou
214642,2212.975706,1,1,0,0,31,2014,Cayla Cross
214388,2212.975706,1,1,0,0,37,2015,Anna Bondar
206458,2212.974981,3,2,0,1,47,1995,Maria Eugenia Fernandez
201879,2212.969437,1,1,0,0,49,1997,Reka Vidats
202293,2212.964928,3,2,0,1,35,2004,Jie Hao
203087,2212.958453,9,5,0,4,45,2003,Sabrina Eisenberg
201297,2212.95813,1,1,0,0,31,2000,Maja Matevzic
204520,2212.957131,3,2,0,1,52,1999,Ariana Rojas
204123,2212.957038,3,2,0,1,47,1995,Maria Dolores Campana
209191,2212.955518,1,1,0,0,27,2008,Yenisleydis Calana Rodriguez
207944,2212.955396,3,2,0,1,41,1992,Cecilia Ampuero
202309,2212.955396,3,2,0,1,29,2012,Ana Lucia Migliarini De Leon
207702,2212.955366,1,1,0,0,36,1997,Stela Penciu
204772,2212.955366,1,1,0,0,32,1999,Liina Suurvarik
202266,2212.955336,3,2,0,1,30,1999,Kelly Liggan
206289,2212.954609,3,2,0,1,43,2014,Maria Sakkari
202231,2212.954577,9,5,0,4,10,1997,Shiho Hisamatsu
202930,2212.950429,1,1,0,0,32,2007,Jessica Roland Rosario
204590,2212.94927,5,3,0,2,25,1998,Gina Niland
200753,2212.947084,5,3,0,2,21,2002,Cindy Watson
212315,2212.941864,5,3,0,2,37,2013,Thi Tam Hao Tran
209118,2212.937664,3,2,0,1,31,2007,Claudia Hidalgo
204580,2212.937452,5,3,0,2,52,2000,Biljana Dimovska
205195,2212.936598,3,2,0,1,33,2003,Alanna Broderick
202753,2212.935338,1,1,0,0,33,2000,Esme De Villiers
206037,2212.934729,3,2,0,1,31,2014,Daniela Seguel
212396,2212.93387,1,1,0,0,40,1994,Helene Holter
201568,2212.933496,1,1,0,0,25,2008,Kristina Kucova
204275,2212.92004,3,2,0,1,40,2009,Zi Jun Yang
202460,2212.917452,5,3,0,2,30,2011,Ons Jabeur
204036,2212.893047,5,3,0,2,32,1997,Fabienne Thill
201640,2212.891338,33,16,0,17,5,2013,Maria Teresa Torro Flor
200107,2212.87713,5,3,0,2,42,2007,Paola Suarez
200360,2212.786669,3,2,0,1,63,1997,Pam Shriver
202399,2212.78378,3,2,0,1,19,2008,Margit Ruutel
202789,2212.763799,3,2,0,1,37,2002,Salome Devidze
201462,2212.751788,19,9,0,10,7,2009,Alberta Brianti
200021,2212.696922,21,11,0,10,10,1990,Alexia Dechaume Balleret
200593,2212.692581,21,10,0,11,6,1993,Karine Quentrec
201478,2212.678815,3,2,0,1,13,2005,Varvara Lepchenko
203002,2212.639395,3,2,0,1,41,1997,Karin Palme
200630,2212.621849,39,20,0,19,1,1992,Laura Gildemeister
200725,2212.619454,20,10,0,10,10,1996,Sandra Cecchini
201384,2212.614607,5,3,0,2,43,2001,Chia Jung Chuang
200040,2212.613544,47,24,0,23,1,1999,Anna Smashnova
203911,2212.603364,5,3,0,2,56,1997,Gaye Mcmanus
202450,2212.601483,10,5,0,5,9,2012,Jana Cepelova
206903,2212.571787,3,2,0,1,31,1998,Glenny Cepeda
207001,2212.571726,5,3,0,2,28,2001,Claudia Argumedo
203053,2212.55309,1,1,0,0,45,2001,Jin Young Choi
203046,2212.550688,5,3,0,2,43,1994,Graciela Velez
202270,2212.537826,3,2,0,1,26,1995,Habiba Ifrakh
207812,2212.532545,5,3,0,2,39,1992,Eleonora Vegliante
201605,2212.530664,3,2,0,1,32,2007,Mandy Minella
206125,2212.530155,1,1,0,0,26,2009,Mateja Kraljevic
202615,2212.513518,1,1,0,0,26,2014,Natasha Fourouclas
207508,2212.512322,5,3,0,2,56,1997,Jil Lin Leong
205276,2212.511708,3,2,0,1,26,2005,Alise Vaidere
212135,2212.509039,3,2,0,1,26,2005,Ina Sireteanu
210130,2212.493674,3,2,0,1,26,2009,Maria Paula Deheza
207262,2212.493439,1,1,0,0,53,1995,Janaki Krishnamoorthy
208378,2212.493439,3,2,0,1,47,2000,Sobhini De Silva
206998,2212.493439,1,1,0,0,34,2003,Kadija Richards
207803,2212.492798,3,2,0,1,33,2003,Avel Romaly Coronado
207001,2212.492714,1,1,0,0,34,1998,Claudia Argumedo
204161,2212.492714,1,1,0,0,45,2000,Anna Shchupak
201209,2212.491366,3,2,0,1,26,1998,Selima Sfar
202291,2212.488228,9,5,0,4,10,1997,Seiko Okamoto
202467,2212.477272,3,2,0,1,46,2011,Elitsa Kostova
201380,2212.474002,3,2,0,1,39,2009,Claudine Schaul
210434,2212.473965,1,1,0,0,43,2014,Gabriela Porubin
205892,2212.473302,3,2,0,1,32,2010,Giuliana Olmos
202705,2212.473302,3,2,0,1,38,2013,Veronica Cepede Royg
201293,2212.473302,3,2,0,1,44,2014,Catalina Castano
212350,2212.473243,1,1,0,0,34,1997,Marianne Bakken
212119,2212.473243,3,2,0,1,54,1999,Luisa Elfride Lopez
212124,2212.473243,1,1,0,0,45,2002,Ilona Giberte
209033,2212.473243,1,1,0,0,33,2007,Paulina Schippers
203116,2212.473243,1,1,0,0,39,2008,Dianne Kenneth Matias
212753,2212.472456,1,1,0,0,54,1998,Yee Hong Tan
208287,2212.471755,3,2,0,1,26,2007,Nihal Tarek Saleh
201303,2212.468062,27,13,0,14,3,2010,Anne Keothavong
201890,2212.452992,1,1,0,0,41,1992,Xochitl Escobedo
212420,2212.452992,3,2,0,1,53,1995,Saranga Sangakkara
207681,2212.452992,3,2,0,1,58,1996,Busrin Boontemleaw
212431,2212.452992,1,1,0,0,28,1996,Chris Anne Aston
206900,2212.452992,1,1,0,0,54,1999,Daysi Espinal
212157,2212.452992,3,2,0,1,54,1999,Anabelle Espinosa Rodriguez
212547,2212.452992,3,2,0,1,54,1999,Melissa Golfin
206543,2212.452992,1,1,0,0,54,2000,Marina Petrovic
202997,2212.452992,3,2,0,1,30,2001,Yvonne Doyle
212216,2212.452992,1,1,0,0,31,2006,Geraldine Leong
201441,2212.452992,1,1,0,0,27,2012,Emma Laine
204590,2212.452205,3,2,0,1,25,1995,Gina Niland
202573,2212.452205,1,1,0,0,34,2007,Wen Hsin Hsu
201653,2212.450905,1,1,0,0,42,2012,Ellen Allgurin
212401,2212.437304,5,3,0,2,52,2000,Angelika Schadler
208800,2212.434291,1,1,0,0,26,2007,Vanja Radunovic
209712,2212.433531,3,2,0,1,43,2014,Elaine Genovese
212272,2212.432744,1,1,0,0,31,2010,Breana Stampfli
204282,2212.432744,3,2,0,1,44,2014,Anastasiya Prenko
202475,2212.429625,3,2,0,1,30,2011,Jasmina Tinjic
212241,2212.414856,1,1,0,0,26,2007,Diana Bukajeva
212095,2212.411582,3,2,0,1,52,2002,Chen Yee Liaw
201565,2212.396283,7,4,0,3,2,2013,Katarzyna Piter
203290,2212.394756,3,2,0,1,30,2011,Piia Suomalainen
201856,2212.378767,3,2,0,1,21,2002,Ekaterina Sysoeva
202688,2212.377443,3,2,0,1,42,2014,Isabella Shinikova
202381,2212.37044,3,2,0,1,14,2007,Ksenia Milevskaya
212088,2212.356557,1,1,0,0,37,2001,D ESPINAL
202272,2212.355693,3,2,0,1,30,2006,Ana Timotic
200422,2212.352219,27,14,0,13,15,1992,Raffaella Reggi Concato
201677,2212.336232,3,2,0,1,30,2006,Mi Yoo
201387,2212.304177,3,2,0,1,32,2000,Sofia Arvidsson
200067,2212.261049,2,1,0,1,6,1995,Patty Schnyder
204695,2212.187839,9,5,0,4,10,1997,Cornelia Grunes
201497,2212.185723,55,29,0,26,2,2008,Agnes Szavay
200031,2212.180745,48,25,0,23,7,2001,Meilen Tu
202359,2212.175355,3,2,0,1,52,2002,Chin Wei Chan
203816,2212.166117,3,2,0,1,47,1992,Siobhan Nicholson
200775,2212.147468,3,2,0,1,38,2001,Tatiana Kovaltchouk
200672,2212.135136,3,2,0,1,37,1993,Barbara Mulej
202499,2212.112038,21,10,0,11,6,2015,Donna Vekic
212230,2212.099812,5,3,0,2,31,2007,Olivia Bennett
207000,2212.084487,5,3,0,2,28,2001,Melissa Mendieta
201579,2212.079227,3,2,0,1,43,2007,Yurika Sema
200042,2212.070724,22,10,0,12,10,2002,Els Callens
206060,2212.063648,3,2,0,1,43,2014,Ani Amiraghyan
202348,2212.055064,3,2,0,1,25,2013,Lina Stanciute
201481,2212.053123,42,18,0,24,4,2012,Tamira Paszek
201328,2212.050482,14,6,0,8,4,2003,Milagros Sequera
212127,2212.048331,3,2,0,1,29,2001,Ana Gasparyan
202718,2212.031861,1,1,0,0,53,2000,Nino Esebua
204770,2212.031293,1,1,0,0,31,1999,Natalia Volcova
204590,2212.029903,5,3,0,2,34,1997,Gina Niland
206917,2212.029557,5,3,0,2,44,1994,Alexandra Guzman
201665,2212.029495,3,2,0,1,22,2007,Ipek Senoglu
201406,2212.027789,3,2,0,1,34,2008,Shikha Uberoi
212119,2212.026464,5,3,0,2,28,2001,Luisa Elfride Lopez
209026,2212.025161,3,2,0,1,26,2005,Selma Babic
206998,2212.011337,1,1,0,0,29,1996,Kadija Richards
201503,2212.009664,14,7,0,7,5,2007,Ayumi Morita
202545,2212.001514,1,1,0,0,45,2010,Irina Kuzmina
212579,2211.99427,1,1,0,0,26,1995,Alison Vaughan
200672,2211.993575,7,4,0,3,30,1995,Barbara Mulej
212097,2211.992151,1,1,0,0,52,1998,Shaza Tinawi
213628,2211.991687,3,2,0,1,43,2014,Melanie Stokke
207700,2211.99134,1,1,0,0,26,1998,Seden Ozlu
202300,2211.987359,3,2,0,1,30,1999,Meryem El Haddad
206389,2211.987053,3,2,0,1,31,2010,Domenica Gonzalez
203004,2211.973535,1,1,0,0,45,2000,Wukirasih Sawondari
201959,2211.96942,3,2,0,1,27,2003,Ana Catarina Nogueira
204327,2211.969419,3,2,0,1,43,2014,Mai Grage
212420,2211.969324,3,2,0,1,33,1994,Saranga Sangakkara
202786,2211.969206,3,2,0,1,26,2006,Aurelija Miseviciute
204784,2211.966185,9,5,0,4,10,1997,Saori Honda
202315,2211.960911,5,3,0,2,31,2007,Beier Ko
202127,2211.955536,3,2,0,1,54,1999,Ding Ding
202347,2211.949276,3,2,0,1,37,2004,Karolina Kosinska
202717,2211.94895,3,2,0,1,27,1995,Katarina Misic
206997,2211.94895,5,3,0,2,28,1996,Annette Falkenberg
212103,2211.94895,3,2,0,1,53,1999,Alexandra Chong
202556,2211.947171,1,1,0,0,25,2008,Ana Jovanovic
200554,2211.941557,35,18,0,17,3,1990,Brenda Schultz Mccarthy
206690,2211.929914,5,3,0,2,25,1995,Ivona Mihailova
201950,2211.921576,3,2,0,1,41,1995,Miriam Dagostini
204674,2211.915474,3,2,0,1,30,1999,Ilona Poljakova
203584,2211.913857,3,2,0,1,43,2014,Adriana Perez
209753,2211.913812,5,3,0,2,25,2008,Ecaterina Vasenina
202446,2211.905048,9,5,0,4,9,2012,Eugenie Bouchard
201642,2211.856084,5,3,0,2,24,2008,Fatima El Allami
200712,2211.837858,12,6,0,6,6,1992,Katerina Kroupova
201311,2211.819293,11,5,0,6,10,2008,Roberta Vinci
202457,2211.817924,3,2,0,1,3,2011,Bibiane Schoofs
201454,2211.800274,5,3,0,2,24,2002,Akgul Amanmuradova
202709,2211.732034,3,2,0,1,25,2008,Jessica Lehnhoff
201480,2211.700447,3,2,0,1,24,2002,Lioudmila Skavronskaia
201370,2211.67735,8,5,0,3,1,2002,Anastasia Rodionova
204840,2211.631752,3,2,0,1,25,2008,Liudmila Nikoyan
203567,2211.630827,3,2,0,1,15,2015,Ipek Soylu
201368,2211.625774,14,7,0,7,14,2008,Karolina Sprem
210740,2211.58934,3,2,0,1,45,2010,Stefanie Tan
201681,2211.567009,13,7,0,6,44,2001,Suchanun Viratprasert
200709,2211.563332,7,4,0,3,1,2007,Rosana De Los Rios
201729,2211.558859,3,2,0,1,19,1992,Larissa Schaerer
212550,2211.554272,1,1,0,0,26,1997,Paola Almeida
212558,2211.552232,1,1,0,0,28,1996,Tiffini Huggins
212510,2211.551977,1,1,0,0,25,1998,Yvonne Flynn
201424,2211.54289,50,26,0,24,5,2008,Shahar Peer
203310,2211.536217,1,1,0,0,26,2009,Ofelya Poghosyan
202328,2211.534024,3,2,0,1,46,2004,Lana Popadic
200056,2211.532544,52,24,0,28,3,2004,Jelena Kostanic Tosic
211768,2211.528037,4,2,0,2,4,2014,Naomi Osaka
200657,2211.521629,28,13,0,15,0,1994,Radka Bobkova
200720,2211.498992,3,2,0,1,22,2000,Dally Randriantefy
202635,2211.488777,3,2,0,1,46,2010,Jin A Lee
201182,2211.477687,9,5,0,4,54,1996,Jane Wood
212473,2211.469176,5,3,0,2,36,2000,Karla Hall Gonzalez
202309,2211.465023,3,2,0,1,38,2001,Ana Lucia Migliarini De Leon
202266,2211.449122,10,6,0,4,7,2002,Kelly Liggan
200419,2211.446017,25,12,0,13,13,1993,Kathy Rinaldi Stunkel
200417,2211.434705,6,3,0,3,11,1997,Gigi Fernandez
206447,2211.43086,5,3,0,2,28,1996,Ingrid Gonzalez
200119,2211.415099,43,25,0,18,10,2000,Rita Kuti Kis
202774,2211.388533,5,3,0,2,52,2002,Ka Po Tong
201617,2211.354532,3,2,0,1,7,2007,Ana Vrljic
204676,2211.342303,7,4,0,3,45,1998,Katja Kovac
202299,2211.336104,3,2,0,1,37,1999,Maria Wolfbrandt
201080,2211.327211,5,3,0,2,19,1998,Louise Latimer
202290,2211.305256,3,2,0,1,30,2006,Kyung Mi Chang
201446,2211.294783,44,21,0,23,4,2009,Sybille Bammer
201363,2211.228868,7,4,0,3,21,2002,Gisela Dulko
201742,2211.192863,5,3,0,2,3,1993,Susi Fortun Lohrmann
200076,2211.179487,35,19,0,16,3,1995,Laurence Courtois
202316,2211.13373,11,6,0,5,8,2003,Maika Ozaki
212726,2211.132048,1,1,0,0,31,1998,Emmanuelle Duval
206124,2211.119377,3,2,0,1,14,2015,Tereza Martincova
206902,2211.114959,1,1,0,0,27,1996,Yamile Cordova
202507,2211.111215,5,3,0,2,31,2007,Wing Yau Venise Chan
202286,2211.057625,3,2,0,1,31,2005,Elise Tamaela
202170,2211.054879,7,4,0,3,17,1996,Paula Cabezas
201284,2211.046243,3,2,0,1,29,2010,Tatiana Poutchek
200010,2211.037991,33,15,0,18,4,1997,Rita Grande
201201,2211.031585,3,2,0,1,32,2000,Surina De Beer
201949,2211.021808,3,2,0,1,3,1993,Eva Jimenez Sanz
202170,2211.006676,3,2,0,1,42,1997,Paula Cabezas
200522,2211.005053,23,11,0,12,5,1991,Nicole Krijger Jagerman
206447,2210.979887,5,3,0,2,28,2001,Ingrid Gonzalez
206285,2210.949973,5,3,0,2,41,2012,Inna Volkovich
202392,2210.933348,3,2,0,1,31,2007,Melisa Miranda Otarola
200672,2210.91644,5,3,0,2,47,1997,Barbara Mulej
201531,2210.910439,3,2,0,1,30,2006,Mariana Duque Marino
200662,2210.898223,11,6,0,5,33,1997,Joanne Limmer
201625,2210.894916,3,2,0,1,7,1995,Ju Yeon Choi
201317,2210.893034,18,10,0,8,13,2001,Aniko Kapros
201081,2210.889379,11,6,0,5,18,1996,Joanne Ward
202492,2210.881486,7,4,0,3,5,2013,Qiang Wang
201648,2210.870289,10,5,0,5,8,2015,Naomi Broady
202479,2210.852286,12,6,0,6,8,2014,Grace Min
201676,2210.765177,5,3,0,2,6,2008,Ye Ra Lee
201352,2210.746629,11,6,0,5,1,2002,Akiko Morigami
200099,2210.745007,6,3,0,3,4,1997,Sonya Jeyaseelan
200107,2210.63696,3,2,0,1,3,1993,Paola Suarez
201628,2210.625195,3,2,0,1,7,1995,Li Li
202481,2210.541742,3,2,0,1,20,2012,Chi Chi Scholl
200031,2210.489031,5,2,0,3,1,1994,Meilen Tu
200042,2210.488461,3,2,0,1,6,1993,Els Callens
202997,2210.461458,5,3,0,2,29,2004,Yvonne Doyle
201471,2210.417791,3,2,0,1,20,2009,Naomi Cavaday
204444,2210.3972,3,2,0,1,48,1997,Alina Tecsor
202348,2210.397092,5,3,0,2,23,2005,Lina Stanciute
200501,2210.391701,9,5,0,4,63,1997,Marianne Werdel Witmeyer
201591,2210.387707,5,3,0,2,7,2006,Margalita Chakhnashvili
204388,2210.345337,3,2,0,1,14,2013,Lisa Maria Moser
200015,2210.331522,9,5,0,4,1,1999,Petra Mandula
201549,2210.317312,3,2,0,1,14,2008,Petra Martic
201327,2210.286584,16,8,0,8,10,2004,Angelique Widjaja
201339,2210.277388,3,2,0,1,15,2013,Renata Voracova
201498,2210.263928,28,14,0,14,2,2007,Karin Knapp
202266,2210.234343,5,3,0,2,29,2004,Kelly Liggan
200734,2210.210518,12,6,0,6,9,1995,Tatjana Jecmenica
200064,2210.186215,34,15,0,19,2,1991,Amanda Coetzer
200772,2210.186119,34,16,0,18,4,2000,Anastasia Myskina
202415,2210.166688,3,2,0,1,36,2014,Ximena Hermoso
200646,2210.161824,11,6,0,5,11,1990,Francesca Romano
201590,2210.081929,8,4,0,4,8,2010,Alison Riske
212160,2210.067102,5,3,0,2,27,2002,Karla Golfin
201675,2210.062793,3,2,0,1,7,2011,So Jung Kim
202309,2210.058806,5,3,0,2,35,2004,Ana Lucia Migliarini De Leon
201683,2210.057263,5,3,0,2,44,2011,Bianca Botto
206717,2210.051161,5,3,0,2,25,1998,Asja Tankic
211246,2210.016878,5,3,0,2,23,2011,Daniela Schippers
200119,2209.945267,5,3,0,2,0,1996,Rita Kuti Kis
200627,2209.887825,18,9,0,9,4,1991,Petra Schwarz
201358,2209.843572,7,4,0,3,25,2006,Natalia Gussoni
201447,2209.832255,23,11,0,12,4,2009,Vania King
203071,2209.826391,14,7,0,7,8,1996,Jenny Ann Fetch
200682,2209.795052,33,15,0,18,1,1994,Joannette Kruger
212157,2209.7201,7,4,0,3,31,1998,Anabelle Espinosa Rodriguez
201291,2209.712561,11,6,0,5,38,2006,Nuria Llagostera Vives
201450,2209.691402,46,22,0,24,2,2012,Tsvetana Pironkova
201457,2209.613275,4,2,0,2,6,2005,Jarmila Gajdosova
201083,2209.612936,2,1,0,1,1,1999,Daja Bedanova
201541,2209.526057,7,4,0,3,18,2003,Chanelle Scheepers
203501,2209.487634,11,5,0,6,9,2014,Taylor Townsend
200124,2209.487528,46,22,0,24,0,1999,Anne Kremer
201390,2209.484079,5,3,0,2,34,1997,Mervana Jugic Salkic
203567,2209.4713,3,2,0,1,15,2014,Ipek Soylu
202192,2209.46537,7,4,0,3,0,1994,Tzu Ting Weng
201343,2209.454588,7,4,0,3,21,2004,Maret Ani
200532,2209.444968,8,4,0,4,10,1990,Maider Laval
206194,2209.402438,5,3,0,2,14,2015,Gabriela Ce
201360,2209.362439,6,3,0,3,19,2005,Julia Vakulenko
204764,2209.342142,12,6,0,6,45,1998,Lui Li Shen
200665,2209.293747,23,11,0,12,0,1994,Yone Kamio
201556,2209.293594,6,3,0,3,3,2014,Lucie Hradecka
201442,2209.250422,8,4,0,4,8,2012,Yung Jan Chan
200661,2209.245098,11,6,0,5,10,1998,Samantha Smith
200022,2209.214206,52,28,0,24,5,2003,Emmanuelle Gagliardi
206998,2209.141751,5,3,0,2,27,2002,Kadija Richards
201691,2209.140857,5,3,0,2,17,2011,Dia Evtimova
201568,2209.132434,4,2,0,2,15,2011,Kristina Kucova
201190,2209.131866,2,1,0,1,4,1990,Kaye Marfini Hand
201464,2209.110144,7,4,0,3,7,2007,Nathalie Vierin
200094,2209.075797,6,3,0,3,19,2004,Barbara Rittner
200690,2209.064368,26,13,0,13,0,1994,Kyoko Nagatsuka
200346,2209.058658,39,17,0,22,8,1990,Anne Minter
200082,2209.018693,25,12,0,13,0,1999,Kristie Boogert
201535,2209.012953,14,6,0,8,0,2010,Coco Vandeweghe
201481,2209.007292,6,3,0,3,2,2005,Tamira Paszek
201468,2208.967348,32,17,0,15,5,2014,Yaroslava Shvedova
202359,2208.956801,7,4,0,3,14,2007,Chin Wei Chan
200094,2208.949236,34,17,0,17,4,1995,Barbara Rittner
202281,2208.888482,5,3,0,2,7,2003,Ivanna Israilova
200072,2208.77517,4,2,0,2,19,2005,Cara Black
200020,2208.758268,3,2,0,1,23,1991,Lisa Raymond
200098,2208.724524,29,12,0,17,3,2003,Henrieta Nagyova
202470,2208.682261,44,20,0,24,2,2013,Annika Beck
201480,2208.641661,3,2,0,1,7,2003,Lioudmila Skavronskaia
202153,2208.627313,5,3,0,2,9,2002,Melanie Marois
200059,2208.609986,37,19,0,18,4,1995,Ruxandra Dragomir Ilie
204756,2208.605179,2,1,0,1,21,1994,Maria Alejandra Quezada
200579,2208.576242,29,15,0,14,7,1996,Karin Kschwendt
202705,2208.555189,9,5,0,4,14,2015,Veronica Cepede Royg
201387,2208.542832,7,4,0,3,20,2001,Sofia Arvidsson
200655,2208.53643,8,4,0,4,3,1992,Nicole Arendt
201513,2208.535504,37,17,0,20,1,2008,Sabine Lisicki
201596,2208.527228,37,17,0,20,3,2013,Johanna Larsson
201417,2208.51327,12,6,0,6,6,2007,Marta Domachowska
201209,2208.444705,3,2,0,1,16,2000,Selima Sfar
201516,2208.419322,3,2,0,1,5,2005,Evgeniya Rodina
201506,2208.417251,6,3,0,3,15,2006,Sara Errani
201385,2208.341056,5,3,0,2,3,2003,Yuliana Fedak
212599,2208.288592,7,4,0,3,17,1995,Magali Benitez
200655,2208.133028,20,9,0,11,4,1996,Nicole Arendt
201597,2208.123422,11,5,0,6,3,2013,Kurumi Nara
200055,2208.092648,8,4,0,4,46,2003,Mariana Diaz Oliva
201596,2208.077098,38,17,0,21,7,2012,Johanna Larsson
201516,2208.020934,31,14,0,17,4,2015,Evgeniya Rodina
200737,2208.002958,8,4,0,4,1,1995,Aleksandra Olsza
201652,2207.974482,5,3,0,2,7,2010,Ksenia Palkina
200683,2207.953742,5,3,0,2,1,1992,Monique Kiene
201446,2207.949686,38,18,0,20,4,2010,Sybille Bammer
201482,2207.939146,19,9,0,10,5,2008,Andreja Klepac
201335,2207.898391,15,7,0,8,11,2004,Myriam Casanova
200642,2207.88222,5,3,0,2,11,1995,Denisa Szabova
200548,2207.880878,34,16,0,18,2,1991,Patty Fendick
201308,2207.863332,45,22,0,23,3,2006,Maria Elena Camerin
200091,2207.844752,18,9,0,9,7,2000,Janet Lee
201315,2207.78243,28,14,0,14,4,2003,Ashley Harkleroad
202434,2207.774731,11,5,0,6,3,2014,Aleksandra Krunic
200497,2207.719608,14,7,0,7,5,1990,Patricia Hy Boulais
202270,2207.709147,5,3,0,2,19,2001,Habiba Ifrakh
200071,2207.690275,14,7,0,7,6,1999,Lenka Nemeckova
200062,2207.668468,5,3,0,2,4,2003,Kristina Brandi
200036,2207.64194,23,11,0,12,1,2006,Nicole Pratt
201352,2207.570702,30,13,0,17,5,2006,Akiko Morigami
200028,2207.561901,15,8,0,7,9,2002,Maureen Drake
200497,2207.53152,29,13,0,16,3,1995,Patricia Hy Boulais
201618,2207.493128,7,4,0,3,38,2012,Fatma Al Nabhani
202085,2207.49053,2,1,0,1,10,2001,Galina Fokina
200423,2207.470627,6,3,0,3,23,1990,Carling Bassett Seguso
201375,2207.462243,14,7,0,7,1,2005,Shenay Perry
201305,2207.452735,8,4,0,4,4,2010,Eleni Daniilidou
201363,2207.354115,41,20,0,21,2,2008,Gisela Dulko
201477,2207.350991,8,4,0,4,8,2011,Stephanie Dubois
200065,2207.307056,4,2,0,2,20,1996,Amelie Mauresmo
200686,2207.301856,20,10,0,10,3,1996,Sandra Dopfer
201586,2207.293825,24,12,0,12,8,2011,Heather Watson
201511,2207.275765,4,2,0,2,3,2011,Ekaterina Ivanova
201396,2207.26852,7,4,0,3,5,2007,Katie Obrien
200773,2207.202524,21,11,0,10,10,2012,Stephanie Foretz Gacon
202091,2207.201433,3,2,0,1,9,1995,Olga Ivanova
201386,2207.173298,20,10,0,10,3,2003,Jie Zheng
201468,2207.169045,2,1,0,1,1,2005,Yaroslava Shvedova
201493,2207.160435,2,1,0,1,1,2006,Angelique Kerber
200059,2207.142406,29,14,0,15,7,1994,Ruxandra Dragomir Ilie
201292,2207.132667,36,17,0,19,1,2006,Martina Sucha
201435,2207.075052,34,14,0,20,3,2007,Kateryna Bondarenko
200586,2207.021347,25,11,0,14,10,1992,Federica Bonsignori
201325,2207.017647,38,18,0,20,3,2004,Samantha Stosur
200117,2206.999582,6,3,0,3,4,2004,Kveta Peschke
200735,2206.983514,2,1,0,1,8,2004,Miho Saeki
202492,2206.971749,7,4,0,3,4,2014,Qiang Wang
201447,2206.943996,2,1,0,1,10,2005,Vania King
200062,2206.901001,44,23,0,21,3,2004,Kristina Brandi
201459,2206.892195,24,11,0,13,4,2007,Zi Yan
202331,2206.889312,7,4,0,3,16,2004,Vilmarie Castellvi
201343,2206.887336,4,2,0,2,31,2010,Maret Ani
201489,2206.883912,10,5,0,5,5,2007,Mariya Koryttseva
201607,2206.882089,2,1,0,1,9,2010,Sally Peers
202497,2206.869122,6,3,0,3,8,2013,Victoria Duval
200624,2206.860062,23,10,0,13,4,1996,Tami Whitlinger Jones
200069,2206.84128,4,2,0,2,4,1998,Nadia Petrova
201309,2206.77603,4,2,0,2,25,2006,Tatiana Perebiynis
201585,2206.768678,16,7,0,9,9,2011,Sloane Stephens
201592,2206.761102,4,2,0,2,23,2010,Beatriz Garcia Vidagany
200027,2206.760858,50,25,0,25,2,2002,Magui Serna
203475,2206.73387,2,1,0,1,13,2014,Carol Zhao
200679,2206.72426,2,1,0,1,13,1990,Caroline Kuhlman
201452,2206.719845,43,22,0,21,6,2006,Lourdes Dominguez Lino
201476,2206.708164,2,1,0,1,10,2006,Lauren Albanese
201426,2206.704869,33,15,0,18,5,2012,Pauline Parmentier
201551,2206.696929,5,3,0,2,16,2015,Arantxa Rus
200094,2206.688901,22,10,0,12,6,2000,Barbara Rittner
201307,2206.624199,3,1,0,2,12,2003,Amber Liu
201460,2206.622197,4,2,0,2,4,2005,Meng Yuan
201520,2206.599952,40,18,0,22,3,2010,Petra Kvitova
200491,2206.573986,23,10,0,13,3,1993,Christina Singer
200392,2206.540505,26,13,0,13,4,1990,Jo Durie
200120,2206.521763,19,10,0,9,9,2009,Jelena Dokic
201271,2206.438494,2,1,0,1,16,1990,Lisa Green
201806,2206.400904,2,1,0,1,23,1993,Ying Bi
202694,2206.394533,16,9,0,7,14,2013,Teliana Pereira
200068,2206.383136,9,4,0,5,7,2004,Lilia Osterloh
201545,2206.356268,17,8,0,9,7,2009,Anastasija Sevastova
201611,2206.284038,2,1,0,1,7,2014,Daria Gavrilova
206255,2206.190686,9,5,0,4,4,2015,Patricia Maria Tig
200481,2206.176845,26,10,0,16,2,1990,Elna Reinach
201676,2206.151579,4,2,0,2,6,2007,Ye Ra Lee
207956,2206.104695,10,5,0,5,27,2002,Yanet Nunez Mojarena
201587,2206.101605,38,17,0,21,4,2015,Bojana Jovanovski
212066,2206.058022,4,2,0,2,33,1997,Karen Black
200421,2206.051168,32,16,0,16,6,1993,Pascale Paradis Mangon
200658,2206.024566,15,7,0,8,11,1992,Fang Li
200113,2206.012119,20,10,0,10,7,2001,Anna Kournikova
200085,2206.011603,20,9,0,11,1,1994,Ai Sugiyama
205925,2206.005269,9,5,0,4,3,2014,Aliaksandra Sasnovich
200419,2205.950821,3,1,0,2,12,1995,Kathy Rinaldi Stunkel
201318,2205.924724,6,3,0,3,10,2005,Bethanie Mattek Sands
200450,2205.888986,18,8,0,10,10,1998,Larisa Savchenko
200104,2205.882578,48,26,0,22,4,2007,Emilie Loit
200121,2205.876606,38,16,0,22,3,2004,Alina Jidkova
200031,2205.851348,15,6,0,9,7,2000,Meilen Tu
201548,2205.812243,14,7,0,7,7,2013,Ajla Tomljanovic
200422,2205.785857,25,13,0,12,5,1991,Raffaella Reggi Concato
201594,2205.690335,19,10,0,9,7,2010,Simona Halep
202135,2205.679155,2,1,0,1,8,2004,Vanessa Henke
200606,2205.658585,8,4,0,4,8,1992,Nana Smith
200068,2205.646578,4,2,0,2,2,1997,Lilia Osterloh
202068,2205.60298,2,1,0,1,16,1992,Petra Raclavska
200086,2205.555545,43,21,0,22,3,1997,Magdalena Maleeva
200624,2205.551156,37,19,0,18,3,1995,Tami Whitlinger Jones
212416,2205.490683,4,2,0,2,47,1992,Ljudmila Pavlov
201421,2205.478267,7,3,0,4,4,2004,Ana Ivanovic
201203,2205.472495,4,2,0,2,12,2003,Alena Nesticka
200042,2205.461586,35,15,0,20,1,2003,Els Callens
201044,2205.388253,2,1,0,1,22,1995,Catherine Mothes Jobkel
201344,2205.3837,24,12,0,12,4,2007,Klara Koukalova
200667,2205.351738,18,9,0,9,1,1992,Ines Gorrochategui
201463,2205.339546,2,1,0,1,16,2007,Anda Perianu
200123,2205.329411,8,4,0,4,0,1998,Marlene Weingartner
201597,2205.31464,2,1,0,1,4,2009,Kurumi Nara
201297,2205.302219,7,3,0,4,9,2001,Maja Matevzic
201312,2205.299821,2,1,0,1,14,2001,Sarah Taylor
200542,2205.26703,4,2,0,2,19,1997,Clare Wood
201409,2205.259388,2,1,0,1,18,1998,Michaela Pastikova
200293,2205.24562,2,1,0,1,23,2002,Martina Navratilova
200116,2205.226126,24,11,0,13,15,2000,Natalia Zvereva
201299,2205.224332,6,3,0,3,8,2001,Celine Beigbeder
202301,2205.194741,2,1,0,1,11,2002,Sunitha Rao
214263,2205.166303,4,2,0,2,13,2015,Catherine Cartan Bellis
204426,2205.153712,12,6,0,6,6,2015,Anett Kontaveit
201837,2205.149707,2,1,0,1,24,1995,Sandra Waechtershauser
201297,2205.101343,2,1,0,1,15,2004,Maja Matevzic
200036,2205.097422,9,5,0,4,0,1997,Nicole Pratt
201576,2205.090993,8,4,0,4,8,2010,Valerie Tetreault
201322,2205.073503,4,2,0,2,35,2003,Eva Dyrberg
200083,2205.068197,2,1,0,1,30,2008,Alexandra Stevenson
201021,2205.034316,4,2,0,2,15,1997,Laura Garrone
200777,2205.023109,42,20,0,22,7,2001,Marta Marrero
201556,2205.02207,34,17,0,17,4,2015,Lucie Hradecka
201286,2204.972279,25,13,0,12,5,2003,Anabel Medina Garrigues
201338,2204.959145,4,2,0,2,10,2002,Bea Bielik
201414,2204.948972,49,22,0,27,2,2007,Michaella Krajicek
200089,2204.942007,2,1,0,1,13,1990,Miriam Oremans
200568,2204.890868,2,1,0,1,23,1991,Andrea Farley
201199,2204.889707,2,1,0,1,18,1996,Rachel Viollet
201344,2204.859421,9,5,0,4,12,2001,Klara Koukalova
201447,2204.828499,28,13,0,15,9,2014,Vania King
204384,2204.782646,2,1,0,1,15,2013,Agnes Bukta
201632,2204.757386,2,1,0,1,4,2010,Ryoko Fuda
201435,2204.742619,15,7,0,8,5,2005,Kateryna Bondarenko
200117,2204.730154,32,14,0,18,2,2001,Kveta Peschke
200039,2204.694637,32,15,0,17,1,1993,Chanda Rubin
200733,2204.690409,15,7,0,8,33,1997,Trudi Musgrave
200748,2204.68677,5,2,0,3,3,1995,Venus Williams
201605,2204.651084,2,1,0,1,2,2008,Mandy Minella
201467,2204.644176,2,1,0,1,23,2005,Ivana Abramovic
200048,2204.630813,36,16,0,20,4,2006,Elena Likhovtseva
201455,2204.629894,44,20,0,24,1,2006,Elena Vesnina
200119,2204.615757,31,16,0,15,4,1999,Rita Kuti Kis
200693,2204.610741,2,1,0,1,21,1992,Elena Makarova
201423,2204.586436,4,2,0,2,20,2012,Yvonne Meusburger
201924,2204.536684,2,1,0,1,2,1993,Caroline Delisle
201438,2204.527148,2,1,0,1,35,2013,Ekaterina Bychkova
201373,2204.468193,10,5,0,5,7,2003,Maria Kirilenko
200581,2204.442465,6,3,0,3,9,1990,Tamaka Takagi
200017,2204.40638,52,26,0,26,2,2002,Arantxa Sanchez Vicario
200002,2204.366311,2,1,0,1,40,2007,Mirjana Lucic
201438,2204.323707,19,9,0,10,2,2005,Ekaterina Bychkova
200055,2204.314593,48,24,0,24,1,2005,Mariana Diaz Oliva
202622,2204.286408,2,1,0,1,4,2015,Lyudmyla Kichenok
201465,2204.277115,32,14,0,18,3,2015,Kirsten Flipkens
200019,2204.245157,33,16,0,17,7,1993,Alexandra Fusai
200598,2204.238951,4,2,0,2,13,1993,Jeri Ingram
201332,2204.231204,2,1,0,1,19,2005,Jane Odonoghue
200669,2204.22909,41,20,0,21,1,1993,Debbie Graham
207002,2204.222742,4,2,0,2,34,2003,Marcela Ivon Rodezno Hernandez
201281,2204.212115,36,17,0,19,3,2004,Laura Granville
200068,2204.206799,6,3,0,3,8,2009,Lilia Osterloh
200098,2204.193985,49,27,0,22,1,1999,Henrieta Nagyova
201454,2204.183157,30,14,0,16,7,2010,Akgul Amanmuradova
201401,2204.084958,2,1,0,1,28,2011,Abigail Spears
201427,2204.074989,2,1,0,1,22,2005,Alize Cornet
200570,2204.051395,28,13,0,15,0,1991,Veronika Martinek
202291,2204.04133,8,4,0,4,9,1998,Seiko Okamoto
201667,2204.004591,7,4,0,3,2,2012,Ling Zhang
201021,2203.994939,28,14,0,14,4,1990,Laura Garrone
200115,2203.98267,5,2,0,3,1,1998,Brie Rippner
201440,2203.977483,12,6,0,6,15,2010,Laura Pous Tio
214263,2203.9632,2,1,0,1,9,2014,Catherine Cartan Bellis
201612,2203.937167,4,2,0,2,5,2006,Junri Namigata
201447,2203.918501,19,8,0,11,3,2013,Vania King
201638,2203.904563,2,1,0,1,38,2010,Estrella Cabeza Candela
200061,2203.84813,24,11,0,13,11,1997,Gala Leon Garcia
201472,2203.829686,14,7,0,7,1,2006,Romina Oprandi
200559,2203.809957,16,8,0,8,7,1993,Kristine Kunce
201312,2203.793284,20,9,0,11,7,2002,Sarah Taylor
201455,2203.75202,34,17,0,17,3,2014,Elena Vesnina
201201,2203.735537,4,2,0,2,19,1998,Surina De Beer
200483,2203.732789,4,2,0,2,41,1991,Kumiko Okamoto
201280,2203.682931,2,1,0,1,10,1998,Jacqueline Trail
201588,2203.669862,15,7,0,8,3,2015,Anna Tatishvili
201488,2203.667176,10,5,0,5,1,2007,Jorgelina Cravero
200693,2203.638328,6,3,0,3,24,1999,Elena Makarova
200649,2203.635209,34,17,0,17,2,1991,Ginger Helgeson Nielsen
201445,2203.605143,11,5,0,6,6,2005,Viktoria Kutuzova
201443,2203.599017,6,3,0,3,10,2005,Alexa Glatch
200124,2203.589234,12,6,0,6,15,1996,Anne Kremer
204770,2203.517069,4,2,0,2,25,1998,Natalia Volcova
200069,2203.463601,27,12,0,15,14,2000,Nadia Petrova
201969,2203.410832,2,1,0,1,21,1992,Karin Ptaszek
201571,2203.389769,2,1,0,1,7,2005,Masa Zec Peskiric
200028,2203.38504,2,1,0,1,25,2005,Maureen Drake
200118,2203.286911,4,2,0,2,0,1991,Virginia Ruano Pascual
200419,2203.277191,33,15,0,18,6,1990,Kathy Rinaldi Stunkel
200117,2203.271125,2,1,0,1,21,2007,Kveta Peschke
201494,2203.261718,27,12,0,15,3,2009,Raluca Olaru
201308,2203.259809,13,6,0,7,14,2001,Maria Elena Camerin
201516,2203.223785,2,1,0,1,5,2007,Evgeniya Rodina
200442,2203.176113,26,12,0,14,5,1992,Andrea Temesvari
201078,2203.158865,6,3,0,3,3,1998,Eugenia Kulikovskaya
200723,2203.147817,49,24,0,25,4,2002,Iva Majoli
200059,2203.139878,31,14,0,17,2,1993,Ruxandra Dragomir Ilie
201329,2203.139061,2,1,0,1,9,2000,Vera Zvonareva
200709,2203.138403,18,8,0,10,9,2009,Rosana De Los Rios
200685,2203.130069,16,7,0,9,3,1992,Christelle Fauche
201505,2203.128022,37,17,0,20,2,2008,Ekaterina Makarova
201840,2203.119149,4,2,0,2,23,2000,Germana Di Natale
200109,2203.110975,29,12,0,17,3,1998,Nathalie Dechy
201065,2203.103404,2,1,0,1,22,1995,Virginie Buisson
202201,2203.091537,8,4,0,4,9,1998,Kiyoko Yazawa
201050,2203.054133,2,1,0,1,27,1990,Immaculada Varas Caro
201860,2203.042818,2,1,0,1,32,1995,Mariam Ramon Climent
212464,2203.018026,2,1,0,1,24,1993,Yeon Sook Kim
200417,2202.992676,32,16,0,16,1,1993,Gigi Fernandez
201645,2202.97728,4,2,0,2,31,2001,Frederica Piedade
204590,2202.951678,4,2,0,2,47,1992,Gina Niland
201527,2202.941127,2,1,0,1,18,2011,Stefanie Voegele
200023,2202.928763,4,2,0,2,64,2002,Bryanne Stewart
212519,2202.900273,2,1,0,1,41,1993,Evangeline Olivarez
201834,2202.898729,6,3,0,3,26,1993,Heike Rusch
201086,2202.898073,2,1,0,1,1,2006,Greta Arn
202364,2202.872471,4,2,0,2,9,2008,Sandy Gumulya
201290,2202.86552,15,7,0,8,5,2000,Daniela Hantuchova
212165,2202.824249,6,3,0,3,27,1996,Anneliese Rose
200660,2202.811301,26,11,0,15,1,1998,Kimberly Po Messerli
202480,2202.809337,2,1,0,1,20,2012,Richel Hogenkamp
200559,2202.809157,4,2,0,2,27,1992,Kristine Kunce
202774,2202.777175,6,3,0,3,9,1999,Ka Po Tong
201437,2202.753796,2,1,0,1,24,2003,Ivana Lisjak
201541,2202.750045,32,15,0,17,7,2014,Chanelle Scheepers
200124,2202.720454,61,32,0,29,4,2002,Anne Kremer
201547,2202.686036,2,1,0,1,39,2007,Michelle Larcher De Brito
200733,2202.673966,12,6,0,6,21,1996,Trudi Musgrave
200028,2202.661299,4,2,0,2,45,1995,Maureen Drake
200715,2202.660557,7,3,0,4,1,1994,Mariaan De Swardt
201483,2202.658548,51,25,0,26,3,2015,Madison Brengle
200105,2202.654664,39,21,0,18,10,1994,Rachel Mcquillan
201416,2202.64654,2,1,0,1,46,2004,Alona Bondarenko
201563,2202.627054,2,1,0,1,38,2011,Darya Kustova
201566,2202.622711,2,1,0,1,34,2008,Agnes Szatmari
202071,2202.619974,4,2,0,2,36,2002,Dragana Zaric
200113,2202.608707,2,1,0,1,9,1995,Anna Kournikova
201061,2202.590916,2,1,0,1,17,1998,Eva Martincova
200719,2202.59028,2,1,0,1,63,1996,Siobhan Drake Brockman
200646,2202.564047,2,1,0,1,53,1994,Francesca Romano
201664,2202.545027,4,2,0,2,27,2012,Pemra Ozgen
207421,2202.533479,4,2,0,2,25,1998,Ruta Deduraite
200645,2202.489598,2,1,0,1,14,1996,Maja Zivec Skulj
201685,2202.487988,2,1,0,1,43,2010,Kristina Antoniychuk
201455,2202.480333,12,6,0,6,1,2005,Elena Vesnina
202484,2202.470067,11,5,0,6,7,2014,Nicole Gibbs
201632,2202.465503,2,1,0,1,5,2008,Ryoko Fuda
201341,2202.459417,4,2,0,2,5,1996,Mi Ra Jeon
200709,2202.442845,16,8,0,8,2,1993,Rosana De Los Rios
201475,2202.42509,13,6,0,7,5,2007,Ahsha Rolle
201531,2202.424638,12,6,0,6,10,2008,Mariana Duque Marino
206567,2202.398415,4,2,0,2,46,1996,Odeta Naujokaite
200612,2202.3938,19,9,0,10,2,1991,Natalia Medvedeva
202124,2202.378509,2,1,0,1,34,1994,Pimpisamai Kansuthi
201290,2202.373412,51,27,0,24,2,2012,Daniela Hantuchova
201863,2202.354379,2,1,0,1,18,1995,Alice Canepa
201676,2202.346817,2,1,0,1,6,2013,Ye Ra Lee
201629,2202.333496,6,3,0,3,15,1991,Yael Segal
200679,2202.329853,33,16,0,17,2,1993,Caroline Kuhlman
201835,2202.32195,2,1,0,1,22,1993,Maja Muric
201433,2202.319602,4,2,0,2,18,2006,Sarah Borwell
201653,2202.31678,2,1,0,1,17,2009,Ellen Allgurin
200636,2202.295192,2,1,0,1,27,1990,Danielle Jones
200709,2202.285891,43,19,0,24,5,2001,Rosana De Los Rios
201517,2202.269788,28,14,0,14,4,2011,Magdalena Rybarikova
201465,2202.25417,6,3,0,3,15,2008,Kirsten Flipkens
201352,2202.229059,36,16,0,20,5,2007,Akiko Morigami
201402,2202.227671,6,3,0,3,8,2014,Sesil Karatantcheva
201352,2202.17574,25,11,0,14,8,2003,Akiko Morigami
200012,2202.172836,17,8,0,9,3,1998,Jana Nejedly
202399,2202.141933,4,2,0,2,21,2004,Margit Ruutel
202081,2202.140234,2,1,0,1,14,1996,Katalin Miskolczi
200118,2202.139575,16,8,0,8,16,2000,Virginia Ruano Pascual
202445,2202.118845,4,2,0,2,4,2012,Valeria Solovieva
201491,2202.084698,2,1,0,1,5,2006,Olivia Sanchez
201349,2202.077658,21,10,0,11,1,2008,Melinda Czink
201199,2202.06469,2,1,0,1,22,2002,Rachel Viollet
204431,2202.063283,25,11,0,14,3,2015,Anna Lena Friedsam
201068,2202.060548,2,1,0,1,23,1997,Magali Lamarre
201637,2202.054864,6,3,0,3,31,2005,Melissa Torres Sandoval
202156,2202.032958,2,1,0,1,30,1995,Gabriella Boschiero
201311,2202.024916,4,2,0,2,19,2003,Roberta Vinci
202249,2202.02037,2,1,0,1,23,1991,Terri Oreilly
201545,2202.002176,2,1,0,1,22,2007,Anastasija Sevastova
201551,2201.998208,2,1,0,1,26,2014,Arantxa Rus
209026,2201.973777,4,2,0,2,30,2004,Selma Babic
209776,2201.97209,4,2,0,2,26,2006,Marina Novak
212737,2201.971623,2,1,0,1,45,2000,Manisha Abeywardene
202368,2201.946141,2,1,0,1,1,2006,Tanja Ostertag
201292,2201.94239,8,4,0,4,5,2000,Martina Sucha
201850,2201.931531,8,4,0,4,21,1995,Nino Louarsabishvili
205296,2201.895724,4,2,0,2,43,2002,Maarit Nieminen
201389,2201.860983,2,1,0,1,16,2008,Zuzana Kucova
200066,2201.85127,8,4,0,4,9,1996,Cristina Torrens Valero
201528,2201.836723,44,21,0,23,0,2010,Melanie Oudin
200685,2201.818109,4,2,0,2,8,1991,Christelle Fauche
202504,2201.785755,2,1,0,1,8,2012,Ying Ying Duan
200728,2201.783644,2,1,0,1,0,1994,Melanie Schnell
202080,2201.770592,2,1,0,1,16,1993,Danielle Scott
212432,2201.767636,6,3,0,3,26,1997,Kim Cartwright
200073,2201.767572,6,3,0,3,22,2002,Julie Pullin
201858,2201.72842,6,3,0,3,17,1998,Kristina Triska
200639,2201.709087,6,3,0,3,31,1994,Claudine Toleafoa
200068,2201.702864,2,1,0,1,11,1996,Lilia Osterloh
201088,2201.699252,2,1,0,1,23,2001,Karen Cross
201664,2201.689182,4,2,0,2,22,2007,Pemra Ozgen
200014,2201.659589,14,7,0,7,5,2005,Tzipi Obziler
201397,2201.628314,36,18,0,18,2,2013,Shuai Peng
200679,2201.624584,16,7,0,9,1,1992,Caroline Kuhlman
200639,2201.599877,18,9,0,9,14,1990,Claudine Toleafoa
200664,2201.589898,22,9,0,13,2,1992,Stephanie Rehe
202604,2201.582333,4,2,0,2,41,2012,Despina Papamichail
200522,2201.582201,2,1,0,1,51,1995,Nicole Krijger Jagerman
201399,2201.568271,2,1,0,1,22,2004,Emily Webley Smith
201515,2201.563965,2,1,0,1,35,2012,Alisa Kleybanova
201209,2201.556989,2,1,0,1,32,2009,Selima Sfar
207702,2201.548541,4,2,0,2,26,1995,Stela Penciu
207625,2201.547735,4,2,0,2,31,1999,Aina Rafolomanantsiatosika
201958,2201.546483,2,1,0,1,30,2001,Angela Cardoso
201613,2201.540508,4,2,0,2,21,2011,Arina Rodionova
203105,2201.538054,2,1,0,1,9,1998,I Ting Wang
211529,2201.53158,4,2,0,2,26,2014,Sandra Samir
208297,2201.531465,4,2,0,2,33,2003,Natalia Baez
208810,2201.530676,4,2,0,2,45,2010,Michelle Pang
201351,2201.52996,4,2,0,2,5,2002,Eva Fislova
201665,2201.513432,4,2,0,2,46,1996,Ipek Senoglu
212425,2201.512641,4,2,0,2,46,1993,Sasha Hanna
204839,2201.510594,2,1,0,1,52,1995,Oksana Yarikova
212291,2201.492294,4,2,0,2,37,2013,Geraldine Ang
202298,2201.491799,2,1,0,1,25,1998,Feriel Esseghir
204655,2201.485987,4,2,0,2,25,1998,Gulberk Gultekin
212081,2201.474238,4,2,0,2,25,1998,Helen Asciak
200614,2201.471122,24,11,0,13,2,1990,Elena Pampoulova
207004,2201.466127,4,2,0,2,35,2004,Miriam Cruz
202268,2201.462965,4,2,0,2,32,2007,Montinee Tangphong
201549,2201.462395,16,8,0,8,4,2009,Petra Martic
202428,2201.433878,2,1,0,1,20,2011,Kiki Bertens
201554,2201.433858,2,1,0,1,9,2012,Vitalia Diatchenko
204840,2201.431555,4,2,0,2,29,2001,Liudmila Nikoyan
202040,2201.431102,4,2,0,2,44,1993,Linda Niemantsverdriet
212090,2201.428902,2,1,0,1,44,2001,Su Chen Lin
201801,2201.41446,2,1,0,1,18,1990,Ana Maria Segura Perez
202450,2201.408594,39,18,0,21,3,2014,Jana Cepelova
200599,2201.397952,23,10,0,13,1,1992,Carrie Cunningham
201435,2201.382794,37,16,0,21,2,2008,Kateryna Bondarenko
201401,2201.376,6,3,0,3,1,2006,Abigail Spears
200009,2201.361282,38,18,0,20,0,1997,Tamarine Tanasugarn
201664,2201.360906,4,2,0,2,30,2011,Pemra Ozgen
200047,2201.356726,2,1,0,1,17,1996,Pavlina Nola
201293,2201.340462,6,3,0,3,45,2000,Catalina Castano
201611,2201.336828,2,1,0,1,19,2012,Daria Gavrilova
201464,2201.297891,4,2,0,2,16,2005,Nathalie Vierin
200124,2201.26838,2,1,0,1,14,1995,Anne Kremer
201411,2201.260217,2,1,0,1,4,2010,Aiko Nakamura
200696,2201.242334,4,2,0,2,41,1998,Christina Papadaki
202428,2201.232011,24,12,0,12,4,2012,Kiki Bertens
200063,2201.218331,4,2,0,2,0,1996,Tatiana Panova
202402,2201.189271,2,1,0,1,19,2008,Eloisa Maria Compostizo De Andres
202348,2201.163744,4,2,0,2,26,2006,Lina Stanciute
202128,2201.138191,10,5,0,5,0,1998,Riei Kawamata
201442,2201.137958,8,4,0,4,5,2006,Yung Jan Chan
201204,2201.132792,40,19,0,21,5,2002,Iroda Tulyaganova
202013,2201.115382,2,1,0,1,12,1993,Emanuela Brusati
200027,2201.11003,58,29,0,29,7,2001,Magui Serna
204502,2201.107541,4,2,0,2,31,2000,Raluca Ciochina
201450,2201.087655,2,1,0,1,36,2003,Tsvetana Pironkova
201574,2201.087378,8,4,0,4,7,2009,Neuza Silva
206999,2201.08693,2,1,0,1,36,2000,Erika Villalobos Morsink
202121,2201.085743,4,2,0,2,33,1992,Benjamas Sangaram
202021,2201.077612,2,1,0,1,39,1991,Estefania Bottini
201194,2201.072471,4,2,0,2,3,1991,Tammy Whittington
200743,2201.059807,4,2,0,2,45,2000,Nirupama Sanjeev
201369,2201.05948,2,1,0,1,1,2008,Carly Gullickson
206121,2201.054058,2,1,0,1,20,1991,Agnes Gee
212547,2201.048903,6,3,0,3,26,1997,Melissa Golfin
212286,2201.047796,2,1,0,1,23,2011,Gabriela Gonzalez
202100,2201.047008,2,1,0,1,26,1991,Iwalani Mccalla
207427,2201.047008,2,1,0,1,26,1998,Ilona Jarkova
201377,2201.047008,2,1,0,1,33,2000,Yuliya Beygelzimer
212115,2201.047008,2,1,0,1,31,2001,Tara Lambert
202611,2201.047008,2,1,0,1,26,2010,Oksana Kalashnikova
212165,2201.047008,2,1,0,1,32,2014,Anneliese Rose
206606,2201.04695,4,2,0,2,25,1997,Claudia Herbas
206329,2201.045525,4,2,0,2,41,2012,Montserrat Gonzalez
200102,2201.04229,2,1,0,1,58,2001,Melissa Dowse
200025,2201.02995,2,1,0,1,17,1998,Ludmila Cervanova
207698,2201.028245,2,1,0,1,49,1996,Aicha Ferjani
212081,2201.028245,2,1,0,1,53,2000,Helen Asciak
206756,2201.028245,2,1,0,1,30,2001,Carolina Aravena
210451,2201.028245,2,1,0,1,31,2010,Olga Terteac
212561,2201.026146,4,2,0,2,53,1999,Amira Samara
212432,2201.025971,4,2,0,2,53,1999,Kim Cartwright
212082,2201.025815,4,2,0,2,53,2000,Lisa Camenzuli
201410,2201.015094,2,1,0,1,37,2010,Monique Adamczak
201358,2201.011097,4,2,0,2,18,2003,Natalia Gussoni
209205,2201.008692,2,1,0,1,39,2013,Emma Hayman
206911,2201.008664,4,2,0,2,27,2002,Carla Prieto
200060,2201.008167,46,25,0,21,11,2000,Tathiana Garbin
206626,2201.0079,2,1,0,1,41,1992,Nuria Niemes
212228,2201.007872,4,2,0,2,31,2007,Ana Lilyan Guzman
212086,2201.007111,2,1,0,1,52,2002,Olga Dzuba
202900,2201.00658,4,2,0,2,46,2011,Maria Fernanda Alvarez Teran
202393,2201.00635,4,2,0,2,45,2010,Andrea Koch Benvenuto
200773,2201.002336,11,5,0,6,9,2001,Stephanie Foretz Gacon
202385,2200.996681,2,1,0,1,6,2007,Shan Shan Song
212171,2200.992474,4,2,0,2,21,1991,Francesca La&#39;O
212589,2200.989845,4,2,0,2,52,1998,Tatiana Babina
201683,2200.989138,2,1,0,1,31,2014,Bianca Botto
212269,2200.988343,2,1,0,1,32,2010,Isabella Escobar
212083,2200.987083,4,2,0,2,57,1997,Lynn Yin Tan
201512,2200.984044,4,2,0,2,31,2006,Monica Niculescu
202340,2200.977379,2,1,0,1,1,2006,Caroline Maes
204539,2200.973233,4,2,0,2,41,1998,Laura Bernal
201589,2200.96984,2,1,0,1,44,2011,Sharon Fichman
202502,2200.968043,4,2,0,2,37,2013,So Ra Lee
201570,2200.967475,6,3,0,3,5,2008,Vesna Dolonc
212396,2200.965116,4,2,0,2,25,1998,Helene Holter
202611,2200.949731,2,1,0,1,0,2012,Oksana Kalashnikova
201810,2200.948396,2,1,0,1,5,1996,Yuko Hosoki
202393,2200.94694,4,2,0,2,46,2011,Andrea Koch Benvenuto
202085,2200.946008,2,1,0,1,47,2004,Galina Fokina
205195,2200.934747,4,2,0,2,27,1996,Alanna Broderick
201284,2200.93035,14,7,0,7,7,2000,Tatiana Poutchek
206240,2200.929621,4,2,0,2,41,2012,Patricia Ku Flores
204770,2200.926674,4,2,0,2,52,2000,Natalia Volcova
202435,2200.90815,2,1,0,1,25,2012,Vanda Lukacs
206447,2200.907644,6,3,0,3,25,1997,Ingrid Gonzalez
201576,2200.887082,2,1,0,1,1,2008,Valerie Tetreault
202417,2200.878299,4,2,0,2,7,2011,Tetiana Luzhanska
200663,2200.865286,15,8,0,7,11,1996,Nanne Dahlman
201525,2200.861215,2,1,0,1,16,2010,Eva Hrdinova
201394,2200.820531,58,31,0,27,1,2006,Anna Lena Groenefeld
201308,2200.817663,4,2,0,2,16,2013,Maria Elena Camerin
200687,2200.813623,11,5,0,6,9,1991,Katarzyna Nowak
202573,2200.811998,2,1,0,1,2,2012,Wen Hsin Hsu
201414,2200.8111,2,1,0,1,18,2014,Michaella Krajicek
202350,2200.809975,4,2,0,2,30,2006,Olena Antypina
201993,2200.804758,2,1,0,1,27,1993,Pavlina Rajzlova
200672,2200.797215,10,5,0,5,16,1992,Barbara Mulej
200122,2200.766449,4,2,0,2,20,1998,Tina Pisnik
200118,2200.730016,25,11,0,14,6,2007,Virginia Ruano Pascual
200071,2200.728808,13,6,0,7,8,1997,Lenka Nemeckova
212146,2200.706141,2,1,0,1,31,2004,Sarah Wetz
201416,2200.696037,4,2,0,2,36,2002,Alona Bondarenko
203500,2200.685242,2,1,0,1,8,2013,Sachia Vickery
204590,2200.679208,4,2,0,2,34,1993,Gina Niland
200048,2200.674683,30,13,0,17,7,2007,Elena Likhovtseva
204220,2200.665935,4,2,0,2,39,2009,Dianne Hollands
201315,2200.655096,23,12,0,11,14,2008,Ashley Harkleroad
201353,2200.629162,2,1,0,1,8,2001,Stanislava Hrozenska
201377,2200.628564,4,2,0,2,20,2012,Yuliya Beygelzimer
201070,2200.621663,2,1,0,1,25,1999,Emmanuelle Curutchet
211856,2200.618117,2,1,0,1,4,2015,Anastasiya Komardina
201387,2200.611316,9,4,0,5,4,2003,Sofia Arvidsson
202219,2200.61002,2,1,0,1,24,1999,Keiko Nagatomi
201681,2200.605401,2,1,0,1,39,2008,Suchanun Viratprasert
201204,2200.599709,2,1,0,1,6,2004,Iroda Tulyaganova
201563,2200.597033,6,3,0,3,7,2009,Darya Kustova
200062,2200.59377,2,1,0,1,11,1996,Kristina Brandi
201513,2200.593551,38,17,0,21,4,2012,Sabine Lisicki
212157,2200.593262,6,3,0,3,25,1997,Anabelle Espinosa Rodriguez
210953,2200.592233,4,2,0,2,41,2012,Tamitha Nguyen
201856,2200.588505,2,1,0,1,26,2000,Ekaterina Sysoeva
202173,2200.588155,4,2,0,2,37,2002,Joana Cortez
204427,2200.574889,6,3,0,3,16,2015,Sara Sorribes Tormo
201400,2200.566425,2,1,0,1,43,2010,Nicole Vaidisova
202581,2200.55638,4,2,0,2,26,2014,Chanel Simmonds
204282,2200.551785,4,2,0,2,37,2013,Anastasiya Prenko
201598,2200.549499,2,1,0,1,38,2009,Noppawan Lertcheewakarn
207956,2200.547489,2,1,0,1,25,2008,Yanet Nunez Mojarena
203967,2200.544634,2,1,0,1,30,1999,Sara Abaza
201287,2200.544395,2,1,0,1,33,2013,Maria Jose Martinez Sanchez
212085,2200.543845,4,2,0,2,52,2002,Davilyn Godinet
212145,2200.543845,4,2,0,2,52,2002,Gurianna Korinihona
203290,2200.543168,4,2,0,2,25,2013,Piia Suomalainen
207508,2200.542962,2,1,0,1,53,1999,Jil Lin Leong
201862,2200.542419,2,1,0,1,62,2000,Vanessa Menga
212119,2200.542271,4,2,0,2,36,2004,Luisa Elfride Lopez
204553,2200.540313,4,2,0,2,30,1999,Ines Zouabi
203068,2200.539968,2,1,0,1,58,1996,Natalia Nikitina
202919,2200.538625,2,1,0,1,0,2012,Chang Liu
212159,2200.524323,4,2,0,2,33,2010,Laura Viquez
202121,2200.524294,2,1,0,1,25,1991,Benjamas Sangaram
212431,2200.524294,2,1,0,1,46,1994,Chris Anne Aston
204772,2200.524294,2,1,0,1,48,1996,Liina Suurvarik
208261,2200.524294,2,1,0,1,25,1997,Richele Le Saldo
212541,2200.524294,2,1,0,1,27,1997,Camille Walter
203969,2200.524294,2,1,0,1,31,2001,Yomna Farid
212121,2200.524294,2,1,0,1,28,2001,Mariola Prado
202545,2200.524294,2,1,0,1,30,2003,Irina Kuzmina
203217,2200.524294,2,1,0,1,30,2003,Karoline Borgersen
207947,2200.524294,2,1,0,1,36,2003,Yamile Fors Guerra
212221,2200.524294,2,1,0,1,27,2006,Stanislava Cozirscaia
208260,2200.524294,4,2,0,2,32,2007,Dijana Stojic
205010,2200.524294,2,1,0,1,31,2010,Magy Aziz
201708,2200.524294,2,1,0,1,26,2013,Natalie Grandin
211562,2200.524294,2,1,0,1,26,2013,Vladica Babic
212748,2200.522023,4,2,0,2,53,1999,Tricia Ann Greaves
201331,2200.513596,42,18,0,24,3,2010,Iveta Benesova
201568,2200.509713,8,4,0,4,8,2014,Kristina Kucova
202302,2200.505617,2,1,0,1,39,2009,Maria Fernanda Alves
212082,2200.504743,4,2,0,2,31,1999,Lisa Camenzuli
208067,2200.504742,2,1,0,1,26,2005,Assia Halo
202611,2200.504742,4,2,0,2,32,2007,Oksana Kalashnikova
202997,2200.504742,4,2,0,2,26,2005,Yvonne Doyle
212448,2200.504086,4,2,0,2,43,1994,Carla Jimenez
204588,2200.503951,2,1,0,1,35,1997,Karen Nugent
212185,2200.503951,4,2,0,2,36,2004,Irene George
208067,2200.503951,4,2,0,2,31,2010,Assia Halo
206447,2200.503922,2,1,0,1,48,1995,Ingrid Gonzalez
206997,2200.503922,2,1,0,1,48,1995,Annette Falkenberg
212583,2200.503922,2,1,0,1,52,1995,Svetlana Sinitsyna
204595,2200.503922,2,1,0,1,49,1996,Charlotte Aagaard
209117,2200.503922,2,1,0,1,32,2007,Lorena Aviles
204551,2200.503069,2,1,0,1,30,1999,Siham Soumeya Ben Nacer
209174,2200.502436,4,2,0,2,39,2008,Adriana Pereira
200072,2200.502351,4,2,0,2,35,1993,Cara Black
212502,2200.502192,4,2,0,2,34,1997,Eldina Fazlic
204474,2200.501552,12,6,0,6,45,1998,Susan Cowan
202321,2200.486529,2,1,0,1,31,2007,Napaporn Tongsalee
202520,2200.484369,4,2,0,2,26,1995,Julia Muir
206329,2200.483979,4,2,0,2,46,2011,Montserrat Gonzalez
204220,2200.483668,2,1,0,1,45,2014,Dianne Hollands
212445,2200.483071,4,2,0,2,40,1992,Claudia Brause
203290,2200.481791,4,2,0,2,27,2012,Piia Suomalainen
201906,2200.464107,2,1,0,1,26,1998,Marwa El Wany
201666,2200.464063,4,2,0,2,21,2008,Cagla Buyukakcay
202257,2200.463366,4,2,0,2,41,1995,Carmina Giraldo
212147,2200.46324,2,1,0,1,30,2004,Rosanne Dimech
209776,2200.46324,2,1,0,1,25,2010,Marina Novak
201341,2200.459888,4,2,0,2,36,2004,Mi Ra Jeon
203521,2200.454442,4,2,0,2,41,2012,Andrea Gamiz
201667,2200.451781,4,2,0,2,39,2008,Ling Zhang
205143,2200.449831,4,2,0,2,30,2006,Valentina Castro
212505,2200.444446,4,2,0,2,26,1998,Lesley O&#39;Halloran
205787,2200.442994,4,2,0,2,25,2008,Francesca Segarelli
201425,2200.433635,38,17,0,21,5,2008,Lucie Safarova
202274,2200.428402,2,1,0,1,13,2001,Adrienn Hegedus
212723,2200.42766,6,3,0,3,32,1998,Jennifer Adrien
212800,2200.425826,2,1,0,1,23,1991,Krisna Summa
208531,2200.423209,4,2,0,2,27,2012,Kirsten Andrea Weedon
204969,2200.417413,4,2,0,2,43,2002,Edita Liachoviciute
202579,2200.411196,2,1,0,1,30,2014,Giulia Gatto Monticone
200614,2200.368188,2,1,0,1,50,2000,Elena Pampoulova
201623,2200.336446,2,1,0,1,7,1995,Jing Jing Chen
201621,2200.329023,11,5,0,6,9,2011,Mona Barthel
201717,2200.328088,8,4,0,4,2,1994,Michelle Jackson Nobrega
200040,2200.326939,4,2,0,2,47,1997,Anna Smashnova
200084,2200.32142,38,17,0,21,3,1996,Asa Svensson
200697,2200.321075,26,12,0,14,0,1996,Janette Husarova
200727,2200.319376,2,1,0,1,0,1991,Adriana Serra Zanetti
201588,2200.317536,14,7,0,7,8,2010,Anna Tatishvili
201212,2200.30055,47,22,0,25,4,2012,Francesca Schiavone
201565,2200.296246,2,1,0,1,22,2010,Katarzyna Piter
201504,2200.291801,20,9,0,11,4,2009,Julia Goerges
202313,2200.28981,2,1,0,1,19,2004,Darija Jurak
201313,2200.281093,4,2,0,2,47,1999,Yoon Jeong Cho
201208,2200.247835,2,1,0,1,16,2000,Dawn Buth
202395,2200.246403,2,1,0,1,25,2013,Maria Irigoyen
200690,2200.246125,31,16,0,15,3,1995,Kyoko Nagatsuka
201204,2200.23879,4,2,0,2,52,1998,Iroda Tulyaganova
200059,2200.180133,2,1,0,1,20,1992,Ruxandra Dragomir Ilie
202465,2200.176378,2,1,0,1,38,2012,Maria Abramovic
201323,2200.175382,4,2,0,2,10,2000,Saori Obata
200101,2200.174416,2,1,0,1,47,2003,Jana Kandarr
201326,2200.167723,4,2,0,2,23,2003,Bahia Mouhtassine
201483,2200.145563,2,1,0,1,14,2011,Madison Brengle
202988,2200.143779,2,1,0,1,45,2000,Kyung Yee Chae
201726,2200.14252,2,1,0,1,0,1991,Rachel Ann Jensen
202999,2200.141818,4,2,0,2,40,1997,Eugenia Maia
200734,2200.135351,2,1,0,1,9,1994,Tatjana Jecmenica
201546,2200.133635,11,5,0,6,13,2010,Anna Lapushchenkova
201367,2200.133209,35,17,0,18,3,2010,Arantxa Parra Santonja
201341,2200.126844,8,4,0,4,11,2002,Mi Ra Jeon
201387,2200.125619,2,1,0,1,15,2014,Sofia Arvidsson
201526,2200.119525,2,1,0,1,8,2011,Julie Coin
201672,2200.115931,2,1,0,1,7,2009,Nigina Abduraimova
205789,2200.112597,2,1,0,1,50,2011,Na Ri Kim
201075,2200.107455,7,3,0,4,5,2001,Liezel Huber
202348,2200.092528,4,2,0,2,39,2008,Lina Stanciute
200027,2200.091012,45,21,0,24,6,2000,Magui Serna
211012,2200.085945,2,1,0,1,25,2013,Eva Paalma
200741,2200.085375,6,3,0,3,45,1998,Renee Reid
201441,2200.083446,4,2,0,2,25,2010,Emma Laine
201739,2200.077451,2,1,0,1,20,1991,Petra Schmitt
201303,2200.073209,16,8,0,8,10,2008,Anne Keothavong
200062,2200.072055,34,16,0,18,0,1999,Kristina Brandi
212081,2200.070365,2,1,0,1,25,1991,Helen Asciak
202418,2200.066887,21,10,0,11,4,2014,Lara Arruabarrena
202410,2200.063891,2,1,0,1,25,2010,Sofia Shapatava
202012,2200.062915,4,2,0,2,35,1995,Lee Chan
200938,2200.060661,2,1,0,1,15,1990,Kathy May Teacher Paben
201620,2200.059751,4,2,0,2,45,2010,Monica Puig
211793,2200.059072,2,1,0,1,25,2013,Tanja Tuomi
201954,2200.045927,2,1,0,1,56,1992,Kirsten Dreyer
202216,2200.040683,2,1,0,1,57,1996,Lilia Biktyakova
202705,2200.040683,4,2,0,2,46,2011,Veronica Cepede Royg
212244,2200.040678,2,1,0,1,44,2014,Amreetha Muttiah
211246,2200.039922,4,2,0,2,31,2010,Daniela Schippers
212248,2200.039663,2,1,0,1,26,2008,Soumia Islami
202321,2200.039493,4,2,0,2,45,2000,Napaporn Tongsalee
207784,2200.039152,4,2,0,2,53,1998,Rui Jing Wong
200730,2200.039027,4,2,0,2,57,1997,Min Tang
212142,2200.03888,2,1,0,1,52,2000,Azza Abbou
208531,2200.038871,2,1,0,1,26,2009,Kirsten Andrea Weedon
200570,2200.02866,6,3,0,3,17,1997,Veronika Martinek
203451,2200.023193,2,1,0,1,25,2008,Marina Giral Lores
201634,2200.020372,2,1,0,1,31,2007,Viky Nunez Fuentes
207000,2200.02034,2,1,0,1,54,1999,Melissa Mendieta
212297,2200.02034,2,1,0,1,29,2012,Maria Giorgia Farrugia Sacco
201844,2200.020281,2,1,0,1,48,1997,Agnese Gustmane
204233,2200.020281,2,1,0,1,26,2009,Ingrid Esperanza Vargas Calvo
212431,2200.019779,2,1,0,1,48,1993,Chris Anne Aston
201958,2200.019703,4,2,0,2,51,2000,Angela Cardoso
208191,2200.01958,4,2,0,2,37,2000,Maria Paz Orero
212145,2200.019553,4,2,0,2,36,2004,Gurianna Korinihona
209433,2200.01955,2,1,0,1,39,2008,Madina Rakhim
201814,2200.019521,2,1,0,1,41,2009,Michelle Gerards
205600,2200.018801,2,1,0,1,25,2010,Anna Movsisyan
207427,2200.018242,2,1,0,1,31,1999,Ilona Jarkova
200023,2200.004907,4,2,0,2,10,2000,Bryanne Stewart
208531,2200.000742,4,2,0,2,23,2011,Kirsten Andrea Weedon
204327,2200.00064,4,2,0,2,45,2010,Mai Grage
202436,2200.000028,4,2,0,2,45,2010,Reka Luca Jani
200036,2200,2,1,0,1,41,1990,Nicole Pratt
202170,2200,2,1,0,1,25,1991,Paula Cabezas
207460,2200,2,1,0,1,25,1991,Isabela Petrov
212447,2200,2,1,0,1,24,1991,Laura Olave
212466,2200,2,1,0,1,25,1991,Ya Hui Lin
212457,2200,2,1,0,1,42,1992,Maria De Los Angeles Ycaza
203182,2200,2,1,0,1,8,1996,Shizu Katsumi
212505,2200,2,1,0,1,49,1996,Lesley O&#39;Halloran
200102,2200,2,1,0,1,33,1997,Melissa Dowse
202103,2200,2,1,0,1,9,1998,Keiko Ishida
202219,2200,2,1,0,1,9,1998,Keiko Nagatomi
202575,2200,2,1,0,1,9,1998,Kumiko Iijima
204177,2200,4,2,0,2,9,1998,Akiko Kinebuchi
202987,2200,2,1,0,1,9,1999,Maiko Inoue
203184,2200,2,1,0,1,52,1999,Beti Sekulovski
212125,2200,2,1,0,1,32,1999,Carol Cassar Torreggiani
200753,2200,8,4,0,4,59,2000,Cindy Watson
204475,2200,8,4,0,4,59,2000,Kylie Hunt
207152,2200,2,1,0,1,59,2000,Bree Calderwood
212127,2200,4,2,0,2,53,2000,Ana Gasparyan
212148,2200,2,1,0,1,55,2000,Nadia Kilani
200753,2200,2,1,0,1,52,2001,Cindy Watson
201410,2200,8,4,0,4,52,2001,Monique Adamczak
202349,2200,6,3,0,3,52,2001,Rushmi Chakravarthi
203125,2200,8,4,0,4,52,2001,Rochelle Rosenfield
203194,2200,4,2,0,2,52,2001,Leticia Sobral
203216,2200,2,1,0,1,52,2001,Marcela Arroyo Vergara
203404,2200,4,2,0,2,52,2001,Svenja Weidemann
204033,2200,6,3,0,3,52,2001,Bianca Kamper
204539,2200,2,1,0,1,38,2001,Laura Bernal
204942,2200,2,1,0,1,52,2001,Madita Suer
201411,2200,2,1,0,1,63,2002,Aiko Nakamura
201415,2200,6,3,0,3,56,2002,Tiffany Welford
202847,2200,2,1,0,1,63,2002,Sabina Mediano Alvarez
204971,2200,2,1,0,1,63,2002,Alexandria Liles
205127,2200,2,1,0,1,63,2002,Ana Cecilia Trevino
202330,2200,2,1,0,1,45,2003,Maria Vanina Garcia Sokol
202597,2200,4,2,0,2,45,2003,Veronica Spiegel
202716,2200,8,4,0,4,45,2003,Helen Crook
202783,2200,8,4,0,4,45,2003,Andrea Van Den Hurk
202812,2200,8,4,0,4,45,2003,Erica Biro
202818,2200,2,1,0,1,29,2003,Samia Medjahdi
203082,2200,8,4,0,4,45,2003,Nicole Melch
203187,2200,4,2,0,2,45,2003,Dubravka Cupac
204579,2200,2,1,0,1,45,2003,Giselle Swart
204870,2200,4,2,0,2,45,2003,Melissa Berry
208260,2200,2,1,0,1,29,2003,Dijana Stojic
200111,2200,2,1,0,1,48,2005,Lina Krasnoroutskaya
201531,2200,2,1,0,1,32,2005,Mariana Duque Marino
212183,2200,2,1,0,1,33,2005,Ummarahmat Hummetova
201545,2200,2,1,0,1,28,2006,Anastasija Sevastova
212218,2200,2,1,0,1,32,2006,Vanessa Boey
208093,2200,2,1,0,1,29,2009,Chandra Capozzi
201508,2200,2,1,0,1,43,2010,Petra Cetkovska
204282,2200,4,2,0,2,50,2011,Anastasiya Prenko
206063,2200,2,1,0,1,32,2011,Caroline Rohde Moe
206177,2200,2,1,0,1,31,2011,Joana Eidukonyte
210173,2200,4,2,0,2,50,2011,Ushna Suhail
210740,2200,4,2,0,2,50,2011,Stefanie Tan
212276,2200,4,2,0,2,50,2011,Clare Fong
212278,2200,2,1,0,1,50,2011,Sarah Al Balushi
203530,2200,2,1,0,1,51,2014,Viktorija Golubic
206102,2200,2,1,0,1,27,2015,Ankita Raina
201631,2199.999477,4,2,0,2,45,2011,Nicha Lertpitaksinchai
202192,2199.9994,2,1,0,1,57,1997,Tzu Ting Weng
212547,2199.999304,2,1,0,1,47,1994,Melissa Golfin
205465,2199.998418,4,2,0,2,26,2009,Daniela Trigo
201645,2199.985682,4,2,0,2,27,2003,Frederica Piedade
205763,2199.984329,2,1,0,1,30,2001,Essi Laine
200632,2199.981836,7,3,0,4,5,1990,Andrea Strnadova
212311,2199.980738,4,2,0,2,27,2012,Sara Quiroga
204551,2199.98042,2,1,0,1,25,1998,Siham Soumeya Ben Nacer
200009,2199.980357,2,1,0,1,36,2015,Tamarine Tanasugarn
207166,2199.980216,4,2,0,2,33,1997,Ismet Duygu Aksit Oal
202302,2199.979719,2,1,0,1,47,2011,Maria Fernanda Alves
201959,2199.97966,2,1,0,1,26,2005,Ana Catarina Nogueira
212697,2199.979628,2,1,0,1,24,1991,Marie Christine Goy
201942,2199.979628,2,1,0,1,36,1993,Andreea Ehritt Vanc
212613,2199.979628,2,1,0,1,48,1995,Beverly Corbie
212209,2199.979628,2,1,0,1,27,2005,Suzelle Davin
203323,2199.979628,2,1,0,1,33,2007,Anna Koumantou
202073,2199.979628,2,1,0,1,46,2010,Chin Bee Khoo
206304,2199.979628,2,1,0,1,32,2014,Yolimar Ogando
202786,2199.978933,4,2,0,2,39,2008,Aurelija Miseviciute
201952,2199.978143,8,4,0,4,23,1994,Elena Savoldi
212495,2199.977996,2,1,0,1,25,1991,Esra Bayburt
201557,2199.965319,2,1,0,1,15,2013,Corinna Dentoni
212285,2199.960903,2,1,0,1,24,2011,Mariella Calderon
207000,2199.960079,4,2,0,2,36,2000,Melissa Mendieta
201437,2199.958524,2,1,0,1,38,2009,Ivana Lisjak
202438,2199.949207,4,2,0,2,17,2011,Ani Mijacika
201679,2199.943663,2,1,0,1,43,2013,Varatchaya Wongteanchai
211736,2199.942748,2,1,0,1,27,2015,Ivana Jorovic
208297,2199.939102,4,2,0,2,25,2008,Natalia Baez
211246,2199.938946,4,2,0,2,27,2012,Daniela Schippers
212768,2199.938946,2,1,0,1,57,1996,Shieh Yen Leong
210952,2199.938769,4,2,0,2,37,2013,Marinel Rudas
201335,2199.933815,2,1,0,1,20,2001,Myriam Casanova
200639,2199.932828,6,3,0,3,24,1993,Claudine Toleafoa
201201,2199.932345,2,1,0,1,47,1999,Surina De Beer
202464,2199.928911,2,1,0,1,39,2012,Yuliana Lizarazo
201328,2199.925559,4,2,0,2,19,2005,Milagros Sequera
201572,2199.924982,2,1,0,1,14,2008,Regina Kulikova
201281,2199.922677,2,1,0,1,10,1998,Laura Granville
200051,2199.908725,45,20,0,25,1,1999,Irina Spirlea
203509,2199.907039,4,2,0,2,27,2012,Diana Marcinkevica
202396,2199.901411,2,1,0,1,31,2006,Nadja Roma
208287,2199.900012,4,2,0,2,26,2006,Nihal Tarek Saleh
202664,2199.899257,2,1,0,1,46,2011,Roxane Vaisemberg
201371,2199.898345,29,12,0,17,2,2008,Vera Dushevina
200076,2199.877324,6,3,0,3,33,2001,Laurence Courtois
202185,2199.872064,4,2,0,2,20,1999,Anna Bielen Zarska
201411,2199.859677,27,12,0,15,4,2005,Aiko Nakamura
202292,2199.8555,2,1,0,1,11,2002,Ayami Takase
200009,2199.849678,21,10,0,11,0,2012,Tamarine Tanasugarn
202245,2199.835975,2,1,0,1,21,2004,Desislava Topalova
212089,2199.829642,2,1,0,1,38,2001,Madeline Sanchez
206242,2199.828747,6,3,0,3,29,2015,Beatriz Haddad Maia
201402,2199.81929,2,1,0,1,24,2008,Sesil Karatantcheva
202364,2199.810716,2,1,0,1,9,2006,Sandy Gumulya
202436,2199.770244,4,2,0,2,42,2014,Reka Luca Jani
201582,2199.761464,2,1,0,1,7,2008,Jing Jing Lu
206252,2199.749174,2,1,0,1,8,2014,Barbora Krejcikova
202329,2199.718192,4,2,0,2,45,2000,Jessica Fernandez
201482,2199.683105,2,1,0,1,21,2004,Andreja Klepac
202422,2199.681165,2,1,0,1,4,2014,Shuko Aoyama
200634,2199.678204,4,2,0,2,6,1995,Elena Brioukhovets
201324,2199.677734,2,1,0,1,64,2000,Irina Selyutina
201403,2199.670196,5,2,0,3,6,2004,Anna Chakvetadze
200044,2199.66403,2,1,0,1,30,1995,Denisa Chladkova
202388,2199.663655,4,2,0,2,5,2007,Dilyara Saidkhodjaeva
200553,2199.622824,2,1,0,1,58,1994,Carin Bakkum
202464,2199.602335,2,1,0,1,29,2015,Yuliana Lizarazo
201858,2199.59761,2,1,0,1,53,1996,Kristina Triska
212562,2199.592998,2,1,0,1,32,1998,Donna Fields Gibbs
201882,2199.582818,2,1,0,1,9,1996,Katarzyna Straczy
201807,2199.582066,2,1,0,1,57,1994,Li Yao Tang
201298,2199.579751,2,1,0,1,31,1999,Zsofia Gubacsi
200746,2199.577383,5,2,0,3,2,1999,Sandra Kloesel
201306,2199.562072,36,17,0,19,5,2003,Marie Gaiane Mikaelian
206213,2199.558523,4,2,0,2,26,2009,Amy Bowtell
202280,2199.555284,2,1,0,1,47,2003,Olga Kalyuzhnaya
200743,2199.553199,4,2,0,2,57,1996,Nirupama Sanjeev
202074,2199.551101,2,1,0,1,59,1994,Katharina Buche
203998,2199.536731,8,4,0,4,62,1997,Athina Briegel
202393,2199.534994,4,2,0,2,30,2006,Andrea Koch Benvenuto
203509,2199.534458,4,2,0,2,25,2013,Diana Marcinkevica
212140,2199.53437,2,1,0,1,29,2001,Ludmila Stavila
204590,2199.533445,2,1,0,1,40,1994,Gina Niland
212080,2199.530716,4,2,0,2,47,1992,Branislava Ivanovic
202988,2199.525125,4,2,0,2,44,2001,Kyung Yee Chae
201846,2199.520051,2,1,0,1,48,1997,Katarzyna Teodorowicz Lisowska
204578,2199.519319,4,2,0,2,44,1994,Deborah Gaviria
202305,2199.517902,4,2,0,2,57,1996,Manisha Malhotra
201864,2199.517901,2,1,0,1,58,1999,Celeste Contin
212204,2199.517118,2,1,0,1,26,2005,Stephanie Sullivan
212538,2199.516949,2,1,0,1,26,1995,Shaila Ali
207078,2199.516662,2,1,0,1,35,1997,Helina Lill
212600,2199.516332,2,1,0,1,41,1992,Catalina Ramirez
212081,2199.516332,2,1,0,1,31,1999,Helen Asciak
201380,2199.516332,2,1,0,1,40,2008,Claudine Schaul
204536,2199.516179,4,2,0,2,42,1999,Barbara Castro
202438,2199.514205,2,1,0,1,42,2012,Ani Mijacika
200750,2199.506684,2,1,0,1,60,1995,Karin Miller
202279,2199.500995,2,1,0,1,32,2005,Virag Nemeth
202359,2199.499697,2,1,0,1,40,2008,Chin Wei Chan
202331,2199.498354,4,2,0,2,39,2008,Vilmarie Castellvi
202352,2199.497595,2,1,0,1,31,2005,Daniela Munoz Gallegos
202774,2199.497505,4,2,0,2,57,1997,Ka Po Tong
204897,2199.497476,2,1,0,1,53,2000,Dina Khalil
212229,2199.497394,2,1,0,1,32,2007,Raye Ann Sandy
206389,2199.496836,4,2,0,2,43,2014,Domenica Gonzalez
212462,2199.496078,2,1,0,1,32,1992,Vajira Premaratne
200032,2199.496078,2,1,0,1,46,2005,Barbara Schett
204690,2199.496078,2,1,0,1,40,2008,Czarina Mae Arevalo
212282,2199.496078,4,2,0,2,23,2011,Michelle Marie Valdez
212289,2199.496078,2,1,0,1,43,2012,Beatriz Maia
207944,2199.496049,2,1,0,1,25,1991,Cecilia Ampuero
207695,2199.496049,2,1,0,1,47,1996,Issem Essaies
207427,2199.496049,4,2,0,2,53,2000,Ilona Jarkova
212096,2199.496049,4,2,0,2,45,2001,Shalini Perera
201706,2199.496049,2,1,0,1,39,2008,Eirini Georgatou
210171,2199.496049,2,1,0,1,39,2013,Saba Aziz
212493,2199.496046,4,2,0,2,36,2000,Ariana Marshall
203968,2199.49594,4,2,0,2,25,1998,Dalia El Sheikh
209836,2199.495288,2,1,0,1,53,1999,Nikkita Fountain
210886,2199.494469,2,1,0,1,30,2011,Mayar Sherif
201469,2199.484452,2,1,0,1,20,2012,Melanie South
212427,2199.47885,2,1,0,1,25,1998,May Emara
204082,2199.478459,4,2,0,2,53,1999,Monthika Anuchan
202900,2199.477285,4,2,0,2,34,2003,Maria Fernanda Alvarez Teran
206690,2199.477227,2,1,0,1,47,1996,Ivona Mihailova
212684,2199.475799,4,2,0,2,52,1998,Eugenia Silantieva
212410,2199.475706,2,1,0,1,24,1991,Belkis Rodriguez
212425,2199.475706,2,1,0,1,41,1992,Sasha Hanna
202204,2199.475706,2,1,0,1,41,1993,Yu Hsien Liu
203886,2199.475706,2,1,0,1,48,1994,Joni Van Ryck De Groot
212349,2199.475706,2,1,0,1,48,1994,Lisa Yap Sam
203886,2199.475706,2,1,0,1,49,1995,Joni Van Ryck De Groot
206666,2199.475706,2,1,0,1,49,1995,Paula Umana
212432,2199.475706,2,1,0,1,49,1995,Kim Cartwright
212547,2199.475706,2,1,0,1,49,1995,Melissa Golfin
203091,2199.475706,8,4,0,4,8,1996,Yumiko Kitamura
204052,2199.475706,4,2,0,2,10,1997,Nao Akahori
207516,2199.475706,2,1,0,1,45,1998,Fleur Broughton
202714,2199.475706,2,1,0,1,33,1999,Marina Lazarovska
206867,2199.475706,2,1,0,1,31,1999,Eleni Pilava Papanikolaou
212709,2199.475706,2,1,0,1,55,1999,Jodi Saunders
200013,2199.475706,2,1,0,1,65,2000,Angelica Gavaldon
203079,2199.475706,6,3,0,3,59,2000,Diana Gherghi
204575,2199.475706,2,1,0,1,53,2000,Helga Vieira
200037,2199.475706,2,1,0,1,58,2001,Sabine Appelmans
203104,2199.475706,4,2,0,2,52,2001,Annica Cooper
203188,2199.475706,8,4,0,4,52,2001,Emily Hewson
201479,2199.475706,8,4,0,4,56,2002,Olga Puchkova
202779,2199.475706,2,1,0,1,36,2003,Tinatin Kavlashvili
204209,2199.475706,8,4,0,4,45,2003,Gabrielle Baker
201836,2199.475706,2,1,0,1,28,2005,Svetlana Komleva
203216,2199.475706,2,1,0,1,32,2005,Marcela Arroyo Vergara
212243,2199.475706,2,1,0,1,41,2008,Nilupul Goonasekera
201686,2199.475706,2,1,0,1,26,2009,Alejandra Granillo
202365,2199.475706,2,1,0,1,39,2009,Lavinia Tananta
210160,2199.475706,2,1,0,1,33,2014,Carolina De Los Santos
207536,2199.475646,2,1,0,1,42,1998,Carla Rodriguez
204329,2199.475577,2,1,0,1,26,2007,Kimberley Cassar
212240,2199.474921,4,2,0,2,25,2008,Astrid Tixier
212151,2199.474916,2,1,0,1,26,2005,Lesedi Ramocha
204605,2199.46964,2,1,0,1,39,1996,Joana Pedroso
201593,2199.465689,2,1,0,1,22,2010,Irina Camelia Begu
201631,2199.458527,2,1,0,1,48,2014,Nicha Lertpitaksinchai
212078,2199.458453,2,1,0,1,45,2003,Gabriela Duch
200094,2199.457607,28,12,0,16,4,1996,Barbara Rittner
204740,2199.457242,2,1,0,1,32,2000,Maria Pavlidou
202361,2199.456668,5,2,0,3,4,2006,Erika Takao
207947,2199.456303,4,2,0,2,36,2004,Yamile Fors Guerra
201961,2199.455669,2,1,0,1,24,1991,Patricia Miller
207956,2199.455334,4,2,0,2,31,2005,Yanet Nunez Mojarena
201751,2199.454062,2,1,0,1,24,1991,Melissa Mazzotta
202329,2199.447019,4,2,0,2,34,2003,Jessica Fernandez
202946,2199.439894,2,1,0,1,35,2004,Christina Zachariadou
212724,2199.438322,4,2,0,2,45,2000,Pei Yuin Keng
202071,2199.435038,2,1,0,1,31,2005,Dragana Zaric
201840,2199.42511,2,1,0,1,15,1998,Germana Di Natale
200040,2199.423908,24,11,0,13,4,1994,Anna Smashnova
201452,2199.422196,2,1,0,1,46,2004,Lourdes Dominguez Lino
201677,2199.42001,4,2,0,2,31,2007,Mi Yoo
201666,2199.419907,4,2,0,2,30,2011,Cagla Buyukakcay
201651,2199.415677,2,1,0,1,14,2007,Michaela Johansson
201681,2199.402089,6,3,0,3,34,2003,Suchanun Viratprasert
201534,2199.399076,2,1,0,1,8,2014,Asia Muhammed
204176,2199.395028,2,1,0,1,9,1999,Yumi Yokoi
202626,2199.394002,4,2,0,2,25,2010,Stephanie Vogt
202450,2199.381638,2,1,0,1,8,2011,Jana Cepelova
201472,2199.380227,9,4,0,5,3,2010,Romina Oprandi
204475,2199.377523,10,5,0,5,9,1999,Kylie Hunt
201491,2199.367662,2,1,0,1,21,2010,Olivia Sanchez
200505,2199.365019,2,1,0,1,27,1990,Michelle Bowrey
201938,2199.363884,2,1,0,1,21,2002,Ainhoa Goni Blanco
202365,2199.363365,2,1,0,1,9,2008,Lavinia Tananta
206818,2199.358315,2,1,0,1,35,1993,Gabriela Beleni
201697,2199.327902,6,3,0,3,10,2012,Kristyna Pliskova
200021,2199.304752,32,14,0,18,11,1991,Alexia Dechaume Balleret
200657,2199.303936,2,1,0,1,17,1997,Radka Bobkova
203070,2199.292561,2,1,0,1,38,1999,Elpis Alexandrou
203281,2199.290624,4,2,0,2,8,2015,Amandine Hesse
201946,2199.287447,2,1,0,1,3,1993,Jean Ceniza
201688,2199.285196,2,1,0,1,29,2010,Claire De Gubernatis
201074,2199.277518,2,1,0,1,45,1997,Ana Alcazar
201691,2199.274044,6,3,0,3,22,2010,Dia Evtimova
201988,2199.265879,4,2,0,2,20,1991,Sofie Albinus
200765,2199.263821,4,2,0,2,46,1997,Katalin Marosi
200625,2199.260492,2,1,0,1,16,1992,Jana Pospisilova
202188,2199.259726,2,1,0,1,23,1990,Valerie Batut
201504,2199.259111,9,4,0,5,5,2007,Julia Goerges
202075,2199.247716,2,1,0,1,29,1992,Julia Jehs
204655,2199.236129,4,2,0,2,34,1993,Gulberk Gultekin
202245,2199.227553,4,2,0,2,32,2000,Desislava Topalova
200696,2199.226809,6,3,0,3,15,1996,Christina Papadaki
201464,2199.224275,2,1,0,1,21,2008,Nathalie Vierin
202169,2199.19911,2,1,0,1,18,1993,Christine Neuman
202166,2199.192532,4,2,0,2,3,1992,Emilie Viqueira
202192,2199.182145,2,1,0,1,6,1996,Tzu Ting Weng
201637,2199.18174,4,2,0,2,31,2006,Melissa Torres Sandoval
202073,2199.164043,4,2,0,2,35,2003,Chin Bee Khoo
200666,2199.151635,2,1,0,1,27,2000,Marion Maruska
201637,2199.141782,2,1,0,1,35,2008,Melissa Torres Sandoval
201541,2199.140079,4,2,0,2,31,2005,Chanelle Scheepers
200481,2199.119117,37,15,0,22,2,1991,Elna Reinach
201017,2199.113335,13,6,0,7,19,1991,Angelika Kanellopoulou
204496,2199.113249,4,2,0,2,31,2000,Mihaela Moldovan
201557,2199.107184,4,2,0,2,16,2008,Corinna Dentoni
200710,2199.107183,2,1,0,1,22,1993,Magdalena Feistel
200119,2199.106615,4,2,0,2,3,1998,Rita Kuti Kis
201389,2199.10564,2,1,0,1,19,2013,Zuzana Kucova
201700,2199.090673,2,1,0,1,17,2011,Nikola Hofmanova
203007,2199.08994,2,1,0,1,53,1999,Irawati Iskandar
212125,2199.086305,2,1,0,1,25,1991,Carol Cassar Torreggiani
204978,2199.083146,2,1,0,1,31,2005,Hsiao Han Chao
202436,2199.080681,4,2,0,2,41,2012,Reka Luca Jani
209331,2199.069247,6,3,0,3,27,2012,Julia Helbet
202475,2199.068416,4,2,0,2,26,2014,Jasmina Tinjic
201751,2199.06704,2,1,0,1,57,1998,Melissa Mazzotta
201526,2199.065287,2,1,0,1,7,2013,Julie Coin
201680,2199.065095,4,2,0,2,39,2008,Anna Gerasimou
200614,2199.05309,2,1,0,1,54,2001,Elena Pampoulova
212197,2199.052922,2,1,0,1,30,2004,Elrien De Villiers
212150,2199.052921,4,2,0,2,53,2000,Sabrina Vogt
207002,2199.052911,4,2,0,2,36,2000,Marcela Ivon Rodezno Hernandez
204551,2199.052215,4,2,0,2,52,2000,Siham Soumeya Ben Nacer
208217,2199.05209,4,2,0,2,43,2002,Anete Bandere
205600,2199.051698,4,2,0,2,28,2012,Anna Movsisyan
212587,2199.051471,2,1,0,1,52,2000,Alice Lamport
206242,2199.051154,2,1,0,1,33,2013,Beatriz Haddad Maia
201409,2199.05043,2,1,0,1,36,2000,Michaela Pastikova
201610,2199.041313,2,1,0,1,33,2013,Zarina Diyas
201523,2199.037243,2,1,0,1,30,2006,Marina Erakovic
200008,2199.03404,4,2,0,2,51,2011,Alicia Molik
212689,2199.033904,2,1,0,1,53,1999,Pei Jyue Lo
201277,2199.03342,4,2,0,2,26,2005,Anne Mall
212157,2199.032784,4,2,0,2,28,2002,Anabelle Espinosa Rodriguez
202127,2199.032743,2,1,0,1,0,1998,Ding Ding
202562,2199.030516,4,2,0,2,39,2009,Hanne Skak Jensen
201717,2199.015105,2,1,0,1,18,1993,Michelle Jackson Nobrega
207933,2199.012163,4,2,0,2,43,2002,Sana Ben Salah
202074,2199.009125,2,1,0,1,58,1995,Katharina Buche
200777,2199.008759,4,2,0,2,14,1999,Marta Marrero
212589,2198.997724,4,2,0,2,57,1997,Tatiana Babina
207291,2198.992889,2,1,0,1,26,2008,Iris Staub
202874,2198.991369,4,2,0,2,45,2010,Chayenne Ewijk
202436,2198.98782,2,1,0,1,16,2015,Reka Luca Jani
201414,2198.985473,2,1,0,1,20,2015,Michaella Krajicek
200511,2198.979328,4,2,0,2,47,1992,Amy Jonsson Raaholt
202322,2198.973274,6,3,0,3,9,1999,Maki Arai
200452,2198.973243,2,1,0,1,49,1991,Tine Scheuer Larsen
202987,2198.972699,2,1,0,1,9,1998,Maiko Inoue
201831,2198.972458,2,1,0,1,49,1991,Sabine Gerke
206867,2198.971755,2,1,0,1,48,1996,Eleni Pilava Papanikolaou
204898,2198.971755,2,1,0,1,45,2002,Noha Mohsen
202270,2198.971755,2,1,0,1,29,2003,Habiba Ifrakh
201380,2198.971755,2,1,0,1,33,2006,Claudine Schaul
204815,2198.967346,2,1,0,1,36,1995,Yi Ching Wu
200031,2198.96574,43,20,0,23,1,2007,Meilen Tu
201459,2198.954666,2,1,0,1,42,2010,Zi Yan
212420,2198.954548,2,1,0,1,33,1992,Saranga Sangakkara
212095,2198.953172,4,2,0,2,45,2000,Chen Yee Liaw
201634,2198.95308,2,1,0,1,37,2009,Viky Nunez Fuentes
204542,2198.952992,2,1,0,1,24,1991,Ninfa Marra
208230,2198.952992,2,1,0,1,26,1998,Samira Takourabet
208245,2198.952992,2,1,0,1,35,2003,Maria Irene Squillaci Sandoval
212232,2198.952992,2,1,0,1,27,2008,Carlista Mohammed
212312,2198.952992,2,1,0,1,32,2014,Juli Raventos
202646,2198.952232,4,2,0,2,45,2010,Ana Clara Duarte
202957,2198.951412,8,4,0,4,54,1996,Madoka Kuki
204650,2198.951412,6,3,0,3,54,1996,Anita Kurimay
204579,2198.951412,8,4,0,4,52,2001,Giselle Swart
200058,2198.942979,6,3,0,3,28,1991,Anna Foldenyi Dicker
201450,2198.940562,6,3,0,3,21,2004,Tsvetana Pironkova
202393,2198.937557,4,2,0,2,25,2008,Andrea Koch Benvenuto
201209,2198.935121,4,2,0,2,26,1995,Selima Sfar
203064,2198.934153,8,4,0,4,9,1998,Hsueh Li Hsu
212390,2198.932753,2,1,0,1,47,1993,Florea De Maria Urrea
212686,2198.932744,4,2,0,2,53,1999,Haleema Rahim
202326,2198.931861,2,1,0,1,31,2007,Ankita Bhambri
200021,2198.931782,30,15,0,15,4,1997,Alexia Dechaume Balleret
201645,2198.926405,2,1,0,1,25,2006,Frederica Piedade
203575,2198.921009,4,2,0,2,27,2012,Danka Kovinic
201660,2198.920653,2,1,0,1,15,2009,Tereza Hladikova
201570,2198.919477,2,1,0,1,5,2007,Vesna Dolonc
202103,2198.912502,4,2,0,2,8,1996,Keiko Ishida
201485,2198.90683,8,4,0,4,5,2006,Alla Kudryavtseva
201347,2198.898509,4,2,0,2,38,2001,Jelena Jankovic
201423,2198.854376,22,10,0,12,2,2007,Yvonne Meusburger
201515,2198.845963,2,1,0,1,44,2004,Alisa Kleybanova
201750,2198.839432,2,1,0,1,18,1993,Ann Stephenson
201855,2198.825441,2,1,0,1,24,2002,Adriana Barna
200096,2198.810079,13,6,0,7,0,1990,Mary Pierce
212447,2198.800996,4,2,0,2,40,1992,Laura Olave
201596,2198.788625,6,3,0,3,17,2009,Johanna Larsson
200697,2198.752466,4,2,0,2,35,2004,Janette Husarova
204452,2198.749048,2,1,0,1,34,1993,Karin Lusnic
202817,2198.738303,4,2,0,2,29,2004,Simona Iulia Matei
201606,2198.724427,2,1,0,1,8,2009,Rebecca Marino
200060,2198.717522,35,18,0,17,5,2002,Tathiana Garbin
202693,2198.71135,2,1,0,1,4,2015,Ya Hsuan Lee
201838,2198.705732,2,1,0,1,35,1994,Federica Fortuni
200002,2198.705506,43,17,0,26,3,2015,Mirjana Lucic
202467,2198.692607,2,1,0,1,14,2015,Elitsa Kostova
201706,2198.687346,2,1,0,1,7,2010,Eirini Georgatou
202321,2198.676622,2,1,0,1,21,2004,Napaporn Tongsalee
202456,2198.674991,36,17,0,19,2,2013,Alexandra Cadantu
202494,2198.673291,39,18,0,21,0,2013,Elina Svitolina
202434,2198.671208,4,2,0,2,15,2012,Aleksandra Krunic
200073,2198.669218,4,2,0,2,22,1999,Julie Pullin
201061,2198.669042,2,1,0,1,35,2000,Eva Martincova
207421,2198.666038,4,2,0,2,46,1996,Ruta Deduraite
202202,2198.655593,2,1,0,1,8,1992,Su Jen Lai
212355,2198.65361,2,1,0,1,41,1993,Chiu Mei Ho
212740,2198.641836,6,3,0,3,44,2000,Shahlio Ibadullaeva
200776,2198.62028,5,2,0,3,1,2005,Angelika Bachmann
203053,2198.6177,2,1,0,1,35,2003,Jin Young Choi
201293,2198.61444,18,9,0,9,12,2001,Catalina Castano
200766,2198.609427,44,20,0,24,7,2001,Jennifer Hopkins
201599,2198.601589,2,1,0,1,24,2007,Andrea Hlavackova
201365,2198.593087,2,1,0,1,21,2002,Edina Gallovits Hall
200726,2198.581578,2,1,0,1,35,1992,Nancy Feber
212318,2198.581493,6,3,0,3,33,2013,Aslina Chua
202348,2198.565066,4,2,0,2,43,2002,Lina Stanciute
202410,2198.548634,2,1,0,1,5,2008,Sofia Shapatava
207251,2198.548546,4,2,0,2,52,2002,Pichaya Laosirichon
201869,2198.536053,2,1,0,1,30,1995,Radka Pelikanova
201288,2198.532928,2,1,0,1,42,1994,Maja Palaversic Cooper Smith
202390,2198.531721,2,1,0,1,31,2006,Ellen Barry
207704,2198.529045,2,1,0,1,26,1998,Serra Olgac
206666,2198.527858,6,3,0,3,28,1996,Paula Umana
211472,2198.526902,2,1,0,1,14,2015,Oleksandra Korashvili
202327,2198.526235,2,1,0,1,46,2004,Megan Falcon
201302,2198.522322,11,5,0,6,1,2001,Clarisa Fernandez
202323,2198.515825,4,2,0,2,37,2004,Eden Marama
201809,2198.506768,2,1,0,1,39,1994,Hila Rosen
212557,2198.501172,6,3,0,3,31,1998,Maria Fernanda Carrillo
201674,2198.49136,2,1,0,1,7,2013,Sabina Sharipova
207625,2198.489576,4,2,0,2,53,2000,Aina Rafolomanantsiatosika
202245,2198.489406,4,2,0,2,37,2001,Desislava Topalova
203570,2198.469324,4,2,0,2,45,2010,Bermet Duvanaeva
203218,2198.46648,2,1,0,1,32,2007,Eun Hye Cho
212355,2198.455084,2,1,0,1,33,1992,Chiu Mei Ho
206563,2198.455075,2,1,0,1,26,1998,Helen Laupa
203968,2198.454158,2,1,0,1,30,1999,Dalia El Sheikh
212488,2198.453517,2,1,0,1,26,1998,Lamia Hameurlaine
210740,2198.449769,4,2,0,2,39,2008,Stefanie Tan
206575,2198.449725,2,1,0,1,40,1994,Galina Misiuriova
212690,2198.433416,2,1,0,1,58,1997,Simone Wichman
201442,2198.433416,2,1,0,1,36,2015,Yung Jan Chan
212411,2198.430209,2,1,0,1,24,1991,Rita Pichardo
200087,2198.425657,2,1,0,1,18,1993,Seda Noorlander
203518,2198.422165,2,1,0,1,2,2012,Paula Kania
203110,2198.412785,2,1,0,1,35,2003,Mi Ok Kim
202297,2198.403804,2,1,0,1,19,2008,Maria Kondratieva
201084,2198.400445,2,1,0,1,6,2004,Nadejda Ostrovskaya
201409,2198.380903,2,1,0,1,24,2006,Michaela Pastikova
200559,2198.375834,9,4,0,5,0,1997,Kristine Kunce
200042,2198.364183,2,1,0,1,30,1991,Els Callens
201928,2198.351847,2,1,0,1,9,1995,Julia Lutrova
201547,2198.350643,15,7,0,8,9,2009,Michelle Larcher De Brito
202016,2198.341067,4,2,0,2,44,1992,Pam Nelson
201440,2198.328481,14,7,0,7,7,2005,Laura Pous Tio
201619,2198.32153,2,1,0,1,32,2009,Madison Keys
201427,2198.313298,17,8,0,9,1,2007,Alize Cornet
200010,2198.311431,50,22,0,28,4,2002,Rita Grande
201950,2198.277055,2,1,0,1,3,1993,Miriam Dagostini
201659,2198.266903,2,1,0,1,3,2013,Melanie Klaffner
202452,2198.251666,2,1,0,1,7,2011,Yi Jing Zhao
201287,2198.244728,4,2,0,2,15,2007,Maria Jose Martinez Sanchez
200740,2198.244436,4,2,0,2,31,2000,Elena Tatarkova
201313,2198.234248,4,2,0,2,16,1998,Yoon Jeong Cho
202319,2198.212358,2,1,0,1,3,2003,Lydia Steinbach
201339,2198.198341,2,1,0,1,7,2006,Renata Voracova
201899,2198.188349,2,1,0,1,0,1991,Luciana Tella
201927,2198.177833,2,1,0,1,1,1994,Ludmilla Varmuza
201754,2198.176785,4,2,0,2,52,1998,Leanne Baker
200515,2198.173771,2,1,0,1,27,1990,Lindsay Bartlett
201606,2198.166188,2,1,0,1,1,2008,Rebecca Marino
200661,2198.164912,19,8,0,11,0,1990,Samantha Smith
201429,2198.155974,2,1,0,1,10,1997,Rika Fujiwara
202594,2198.146548,2,1,0,1,34,2015,Elena Bogdan
200626,2198.146276,30,13,0,17,5,1993,Emanuela Zardo
202399,2198.136349,2,1,0,1,36,2003,Margit Ruutel
202478,2198.130693,2,1,0,1,20,2012,Tara Moore
201563,2198.126701,4,2,0,2,14,2008,Darya Kustova
200073,2198.124717,4,2,0,2,19,1997,Julie Pullin
200573,2198.122317,8,4,0,4,4,1992,Cecilia Dahlman
202900,2198.111304,4,2,0,2,31,2005,Maria Fernanda Alvarez Teran
202676,2198.101577,4,2,0,2,0,2012,Prerna Bhambri
202303,2198.09695,2,1,0,1,40,2006,Carla Tiene
202418,2198.088802,34,17,0,17,4,2015,Lara Arruabarrena
201551,2198.081296,10,5,0,5,5,2008,Arantxa Rus
200582,2198.068917,5,2,0,3,31,1993,Maria Strandlund Tomsvik
205010,2198.065116,4,2,0,2,27,2009,Magy Aziz
200740,2198.05466,4,2,0,2,26,1994,Elena Tatarkova
200681,2198.053581,2,1,0,1,18,1990,Natalia Baudone Furlan
201938,2198.047146,2,1,0,1,54,2001,Ainhoa Goni Blanco
201419,2198.033189,4,2,0,2,9,2001,Na Li
211208,2198.023426,2,1,0,1,4,2014,Ho Ching Wu
202031,2198.013097,4,2,0,2,26,1999,Rosa Maria Andres Rodriguez
200722,2198.012054,6,3,0,3,23,2000,Francesca Lubiani
201310,2197.996873,12,5,0,7,2,2001,Martina Muller
206240,2197.984961,4,2,0,2,46,2011,Patricia Ku Flores
201313,2197.972205,10,5,0,5,41,2006,Yoon Jeong Cho
207543,2197.970965,4,2,0,2,21,1991,Jennifer Saret
202423,2197.958746,2,1,0,1,21,2011,Sarah Gronert
201691,2197.957401,4,2,0,2,14,2013,Dia Evtimova
201488,2197.940675,4,2,0,2,25,2008,Jorgelina Cravero
201482,2197.939639,2,1,0,1,38,2013,Andreja Klepac
200768,2197.936052,2,1,0,1,22,1998,Laurence Andretto
201664,2197.914764,4,2,0,2,26,2006,Pemra Ozgen
200018,2197.893371,3,1,0,2,27,2000,Julia Abe
201085,2197.886146,50,25,0,25,2,2005,Shinobu Asagoe
201839,2197.870298,1,0,0,1,10,1993,Syna Schreiber
201368,2197.852303,40,16,0,24,2,2005,Karolina Sprem
200506,2197.846173,16,7,0,9,11,1997,Wiltrud Probst
201321,2197.83698,4,2,0,2,18,1998,Antonella Serra Zanetti
201276,2197.828384,2,1,0,1,11,1992,Nicole London
200058,2197.800063,4,2,0,2,38,1996,Anna Foldenyi Dicker
202669,2197.773181,2,1,0,1,16,2014,Cristina Dinu
200045,2197.74789,3,1,0,2,2,1997,Tara Snyder
202973,2197.741185,4,2,0,2,38,1996,Anna Karin Svensson
201377,2197.719773,4,2,0,2,22,2009,Yuliya Beygelzimer
201044,2197.718439,11,5,0,6,32,1993,Catherine Mothes Jobkel
202276,2197.68986,14,7,0,7,44,2001,Shelley Bryce
200037,2197.673738,45,22,0,23,6,2000,Sabine Appelmans
202478,2197.626482,2,1,0,1,17,2014,Tara Moore
200045,2197.609083,7,3,0,4,15,2003,Tara Snyder
201320,2197.603343,4,2,0,2,13,2001,Svetlana Kuznetsova
202387,2197.585338,2,1,0,1,5,2007,Vlada Ekshibarova
200695,2197.584371,4,2,0,2,34,1993,Tina Krizan
200653,2197.572746,10,5,0,5,4,2000,Yayuk Basuki
201454,2197.562586,4,2,0,2,8,2014,Akgul Amanmuradova
201204,2197.555626,2,1,0,1,5,2005,Iroda Tulyaganova
206329,2197.550499,4,2,0,2,21,2014,Montserrat Gonzalez
200007,2197.547887,2,1,0,1,23,1994,Silvija Talaja
202464,2197.540246,2,1,0,1,35,2014,Yuliana Lizarazo
212462,2197.540076,4,2,0,2,46,2000,Vajira Premaratne
212429,2197.526972,4,2,0,2,44,1994,Gianfranca Devercelli
212146,2197.523599,2,1,0,1,34,1997,Sarah Wetz
201361,2197.494,24,10,0,14,1,2005,Julia Schruff
200720,2197.48766,17,7,0,10,4,2004,Dally Randriantefy
202302,2197.47433,4,2,0,2,30,2006,Maria Fernanda Alves
201574,2197.472557,2,1,0,1,41,2004,Neuza Silva
202477,2197.455173,6,3,0,3,21,2015,Dinah Pfizenmaier
200088,2197.447575,29,13,0,16,5,2001,Adriana Gersi
201518,2197.439748,28,14,0,14,2,2008,Yanina Wickmayer
201465,2197.435971,12,5,0,7,1,2006,Kirsten Flipkens
200036,2197.423709,6,3,0,3,62,1992,Nicole Pratt
200421,2197.414808,27,13,0,14,5,1991,Pascale Paradis Mangon
200754,2197.411056,43,19,0,24,1,2005,Jill Craybas
201423,2197.389367,6,3,0,3,17,2011,Yvonne Meusburger
201444,2197.38866,2,1,0,1,7,2011,Su Wei Hsieh
202475,2197.366697,4,2,0,2,25,2012,Jasmina Tinjic
201044,2197.285003,10,5,0,5,0,1990,Catherine Mothes Jobkel
201330,2197.28116,2,1,0,1,6,2004,Maria Goloviznina
201281,2197.260386,27,12,0,15,1,2005,Laura Granville
201206,2197.253916,11,5,0,6,14,2001,Allison Bradshaw
200587,2197.252653,23,10,0,13,7,1992,Silke Meier
200612,2197.244074,14,6,0,8,4,1996,Natalia Medvedeva
200050,2197.243005,12,5,0,7,3,2003,Sandra Kleinova
200703,2197.236471,19,8,0,11,3,1995,Katarina Studenikova
202443,2197.227157,4,2,0,2,8,2011,Valeria Savinykh
201429,2197.210399,4,2,0,2,7,2004,Rika Fujiwara
201652,2197.20527,2,1,0,1,5,2008,Ksenia Palkina
201325,2197.151836,32,15,0,17,10,2007,Samantha Stosur
200736,2197.141487,12,6,0,6,1,1995,Li Ling Chen
201665,2197.130973,4,2,0,2,22,2006,Ipek Senoglu
200773,2197.116558,23,11,0,12,5,2002,Stephanie Foretz Gacon
200106,2197.10189,7,3,0,4,16,1995,Angeles Montolio
201657,2197.095568,2,1,0,1,17,2011,Nastja Kolar
201454,2197.085688,19,10,0,9,4,2007,Akgul Amanmuradova
200013,2197.07564,39,20,0,19,3,1995,Angelica Gavaldon
200008,2197.064011,38,17,0,21,2,2001,Alicia Molik
201610,2197.057341,8,4,0,4,7,2011,Zarina Diyas
200087,2197.057328,2,1,0,1,21,1996,Seda Noorlander
201447,2197.045163,38,16,0,22,1,2007,Vania King
201723,2197.040137,4,2,0,2,44,1993,Angela Kerek
212445,2197.02087,4,2,0,2,44,1994,Claudia Brause
203084,2196.999807,4,2,0,2,45,2000,Daniela Olivera
201503,2196.948077,50,25,0,25,4,2011,Ayumi Morita
200584,2196.926606,27,12,0,15,6,1990,Laura Golarsa
201448,2196.921475,30,13,0,17,2,2013,Galina Voskoboeva
200074,2196.879211,2,1,0,1,11,1996,Jane Chi
202436,2196.852247,2,1,0,1,15,2013,Reka Luca Jani
201862,2196.83883,2,1,0,1,38,2001,Vanessa Menga
202774,2196.811746,8,4,0,4,9,1998,Ka Po Tong
202701,2196.80023,2,1,0,1,2,2012,Irina Khromacheva
207497,2196.79923,6,3,0,3,32,1997,Biljana Trpeska
200747,2196.793502,18,9,0,9,0,1996,Haruka Inoue
200749,2196.789675,18,8,0,10,4,2003,Samantha Reeves
206404,2196.781168,20,9,0,11,4,2015,Elizaveta Kulichkova
200491,2196.773038,25,10,0,15,5,1994,Christina Singer
201490,2196.732778,29,13,0,16,2,2008,Timea Bacsinszky
202333,2196.70943,2,1,0,1,19,2004,Delia Sescioreanu
201687,2196.705091,2,1,0,1,29,2010,Lina Bennani
200672,2196.687958,8,4,0,4,23,1994,Barbara Mulej
200666,2196.658466,30,15,0,15,4,1997,Marion Maruska
200669,2196.643009,9,4,0,5,4,1996,Debbie Graham
202457,2196.630776,4,2,0,2,41,2012,Bibiane Schoofs
201667,2196.609973,4,2,0,2,8,2009,Ling Zhang
200395,2196.600789,13,6,0,7,25,1992,Catherine Tanvier
200094,2196.600162,27,13,0,14,2,1998,Barbara Rittner
201366,2196.598092,11,5,0,6,3,2013,Barbora Zahlavova Strycova
201862,2196.573747,12,5,0,7,33,1997,Vanessa Menga
202442,2196.555994,6,3,0,3,15,2011,Tatia Mikadze
201965,2196.514583,4,2,0,2,0,1990,Sabrina Giusto
200590,2196.496426,2,1,0,1,0,1990,Gisele Miro
200082,2196.488406,27,13,0,14,8,2000,Kristie Boogert
201490,2196.481247,10,4,0,6,3,2006,Timea Bacsinszky
205285,2196.479513,4,2,0,2,23,2011,Hilda Zuleta Cabrera
200623,2196.476579,4,2,0,2,22,1995,Petra Thoren
202973,2196.458593,4,2,0,2,47,1997,Anna Karin Svensson
201073,2196.438532,2,1,0,1,22,1998,Seon Young Park
200109,2196.410972,36,17,0,19,6,2007,Nathalie Dechy
201429,2196.407382,2,1,0,1,8,2003,Rika Fujiwara
201087,2196.383674,1,0,0,1,15,1994,Mashona Washington
200681,2196.376608,20,8,0,12,12,1995,Natalia Baudone Furlan
201339,2196.319528,2,1,0,1,32,2009,Renata Voracova
204434,2196.303944,1,0,0,1,16,2015,Ysaline Bonaventure
201988,2196.299942,2,1,0,1,23,1993,Sofie Albinus
202456,2196.251994,2,1,0,1,3,2011,Alexandra Cadantu
200428,2196.239539,36,17,0,19,5,1990,Lori Mcneil
201284,2196.207805,1,0,0,1,10,1999,Tatiana Poutchek
201343,2196.125871,2,1,0,1,1,2007,Maret Ani
200465,2196.119181,10,5,0,5,12,1991,Lisa Bonder Kreiss
201370,2196.114977,38,18,0,20,4,2010,Anastasia Rodionova
200455,2196.107814,12,5,0,7,5,1996,Katerina Maleeva
201584,2196.082533,14,7,0,7,2,2013,Ksenia Pervak
201819,2196.080213,4,2,0,2,24,1992,Esmir Hoogendoorn
200002,2196.038827,5,2,0,3,17,2001,Mirjana Lucic
202496,2196.024077,4,2,0,2,8,2015,Samantha Crawford
202373,2196.00656,2,1,0,1,22,2007,Ekaterina Afinogenova
200099,2196.001962,3,1,0,2,2,1993,Sonya Jeyaseelan
201501,2195.985249,27,12,0,15,5,2013,Olga Govortsova
200094,2195.971529,36,16,0,20,4,2002,Barbara Rittner
200443,2195.955857,21,8,0,13,5,1991,Sara Gomer
201862,2195.951987,8,4,0,4,6,1999,Vanessa Menga
202423,2195.941372,2,1,0,1,20,2012,Sarah Gronert
201438,2195.922512,2,1,0,1,6,2004,Ekaterina Bychkova
201496,2195.91105,30,14,0,16,4,2007,Caroline Wozniacki
201462,2195.910813,42,20,0,22,3,2011,Alberta Brianti
201323,2195.908334,16,7,0,9,5,2001,Saori Obata
201326,2195.888347,2,1,0,1,42,2004,Bahia Mouhtassine
201441,2195.885559,6,3,0,3,15,2002,Emma Laine
201529,2195.85708,1,0,0,1,10,2008,Kristie Ahn
200708,2195.843493,10,4,0,6,2,1993,Sandra Cacic
201696,2195.837871,3,1,0,2,15,2014,Laura Siegemund
201470,2195.807593,24,11,0,13,4,2009,Kristina Barrois
201727,2195.805473,10,5,0,5,11,1995,Silvia Ramon Cortes
201696,2195.803403,12,5,0,7,3,2015,Laura Siegemund
202477,2195.788203,3,1,0,2,9,2012,Dinah Pfizenmaier
200627,2195.737703,12,5,0,7,4,1993,Petra Schwarz
200770,2195.715051,11,5,0,6,21,2009,Stephanie Cohen Aloro
201510,2195.689974,13,6,0,7,1,2007,Julie Ditty
200043,2195.671184,15,7,0,8,4,2004,Virginie Razzano
201353,2195.65517,2,1,0,1,8,2000,Stanislava Hrozenska
201044,2195.616998,13,6,0,7,10,1992,Catherine Mothes Jobkel
202663,2195.595647,20,9,0,11,4,2015,Magda Linette
201273,2195.584533,3,1,0,2,2,1991,Shannan Mccarthy
201438,2195.493629,7,3,0,4,7,2010,Ekaterina Bychkova
200623,2195.492494,28,13,0,15,2,1991,Petra Thoren
201329,2195.479417,42,21,0,21,1,2005,Vera Zvonareva
200025,2195.454653,33,15,0,18,11,2004,Ludmila Cervanova
200052,2195.447727,6,3,0,3,7,2003,Olga Barabanschikova
200007,2195.440755,3,1,0,2,3,1993,Silvija Talaja
201191,2195.396222,8,4,0,4,4,1992,Shirli Ann Siddall
200002,2195.381785,11,5,0,6,8,2010,Mirjana Lucic
203530,2195.366349,2,1,0,1,14,2013,Viktorija Golubic
200569,2195.35981,26,12,0,14,11,1990,Petra Pichalova Langrova
200032,2195.309729,9,4,0,5,5,1993,Barbara Schett
212547,2195.305606,6,3,0,3,31,1998,Melissa Golfin
200099,2195.304111,31,14,0,17,7,2000,Sonya Jeyaseelan
203576,2195.28345,7,3,0,4,5,2014,Kai Lin Zhang
200670,2195.268004,5,2,0,3,28,1992,Nathalie Housset Gilbert
200655,2195.25476,3,1,0,2,12,1991,Nicole Arendt
200044,2195.243229,24,10,0,14,1,2002,Denisa Chladkova
201386,2195.237695,50,26,0,24,2,2012,Jie Zheng
200093,2195.227688,5,2,0,3,8,1997,Amelie Cocheteux
200046,2195.220335,17,8,0,9,3,1998,Meghann Shaughnessy
201656,2195.213084,1,0,0,1,15,2009,Tadeja Majeric
201277,2195.207163,8,3,0,5,2,1994,Anne Mall
202425,2195.194183,1,0,0,1,17,2014,Samantha Murray
201601,2195.187899,1,0,0,1,9,2010,Chelsey Gullickson
200481,2195.167627,32,14,0,18,1,1992,Elna Reinach
201294,2195.118023,5,2,0,3,12,2002,Marion Bartoli
201539,2195.117785,18,8,0,10,4,2010,Christina Mchale
201430,2195.084637,7,3,0,4,5,2006,Yulia Fedossova
202287,2195.031177,1,0,0,1,1,2004,Daniela Kix
205591,2195.029674,8,4,0,4,26,2014,Paula Cristina Goncalves
200084,2195.02473,33,15,0,18,3,1994,Asa Svensson
201532,2194.968922,9,4,0,5,15,2010,Anastasia Pivovarova
200110,2194.931789,25,12,0,13,10,2005,Fabiola Zuluaga
201332,2194.928374,1,0,0,1,22,2002,Jane Odonoghue
201341,2194.893672,4,2,0,2,1,1995,Mi Ra Jeon
201524,2194.866392,21,10,0,11,6,2011,Urszula Radwanska
200700,2194.841657,38,20,0,18,9,1995,Silvia Farina Elia
200605,2194.826006,26,12,0,14,10,1990,Regina Rajchrtova
201567,2194.825229,11,5,0,6,9,2014,Alexandra Dulgheru
202429,2194.809258,19,8,0,11,3,2013,Camila Giorgi
200658,2194.805216,5,2,0,3,1,1997,Fang Li
200480,2194.80446,35,18,0,17,2,1990,Claudia Porwik
201811,2194.773907,3,1,0,2,5,1996,Young Ja Choi
201539,2194.76116,40,18,0,22,4,2015,Christina Mchale
201641,2194.731965,6,3,0,3,30,2011,Nadia Lalami
201509,2194.723304,1,0,0,1,10,2007,Ashley Weinhold
200029,2194.715858,16,8,0,8,8,1996,Lisa Mcshea
201396,2194.656056,1,0,0,1,19,2005,Katie Obrien
201452,2194.620587,33,17,0,16,11,2011,Lourdes Dominguez Lino
201537,2194.592706,4,2,0,2,15,2008,Patricia Mayr Achleitner
201344,2194.574447,43,21,0,22,5,2008,Klara Koukalova
201301,2194.518774,38,16,0,22,5,2008,Camille Pin
201209,2194.509072,10,5,0,5,4,2006,Selima Sfar
200554,2194.481196,5,2,0,3,19,2006,Brenda Schultz Mccarthy
201850,2194.473857,3,1,0,2,39,1996,Nino Louarsabishvili
201081,2194.470581,6,3,0,3,22,1999,Joanne Ward
200443,2194.464208,14,6,0,8,4,1990,Sara Gomer
200514,2194.455646,24,11,0,13,12,1993,Monique Javer
200004,2194.429687,12,5,0,7,8,1997,Kerry Anne Guse
200599,2194.403704,23,10,0,13,2,1990,Carrie Cunningham
200658,2194.396928,17,9,0,8,1,1995,Fang Li
201303,2194.388262,19,8,0,11,3,2011,Anne Keothavong
201500,2194.385514,8,4,0,4,7,2007,Nika Ozegovic
200727,2194.373968,23,10,0,13,3,1995,Adriana Serra Zanetti
201663,2194.367975,4,2,0,2,7,2009,Ekaterina Dzehalevich
201318,2194.366666,1,0,0,1,12,2002,Bethanie Mattek Sands
200709,2194.354824,3,1,0,2,3,2004,Rosana De Los Rios
201512,2194.315275,43,22,0,21,2,2013,Monica Niculescu
201426,2194.275507,3,1,0,2,10,2005,Pauline Parmentier
201747,2194.214977,4,2,0,2,18,1993,Lihini Weerasuriya
200498,2194.198388,7,3,0,4,27,1992,Michelle Jaggard Lai
200681,2194.180893,16,7,0,9,6,1992,Natalia Baudone Furlan
200770,2194.157055,9,4,0,5,10,2007,Stephanie Cohen Aloro
200614,2194.155546,18,8,0,10,11,1997,Elena Pampoulova
201428,2194.122628,27,12,0,15,5,2012,Mathilde Johansson
201308,2194.082017,3,1,0,2,17,2012,Maria Elena Camerin
202504,2194.016054,13,6,0,7,4,2015,Ying Ying Duan
201021,2194.012574,24,10,0,14,9,1991,Laura Garrone
201301,2193.972979,40,17,0,23,4,2007,Camille Pin
201438,2193.955219,1,0,0,1,9,2011,Ekaterina Bychkova
200473,2193.887461,3,1,0,2,53,1994,Beverly Bowes Hackney
201363,2193.885788,32,17,0,15,5,2011,Gisela Dulko
202503,2193.860694,15,7,0,8,4,2014,Luksika Kumkhum
201370,2193.852147,15,7,0,8,3,2003,Anastasia Rodionova
201200,2193.838806,3,1,0,2,10,1998,Miriam Schnitzer
202412,2193.836549,1,0,0,1,1,2008,Maria Mokh
201465,2193.805343,7,3,0,4,8,2004,Kirsten Flipkens
200474,2193.798815,24,10,0,14,3,1992,Louise Allen
200043,2193.764474,7,3,0,4,14,2000,Virginie Razzano
202505,2193.753045,5,2,0,3,3,2013,Belinda Bencic
201067,2193.609929,3,1,0,2,21,1996,Caroline Dhenin
200713,2193.606211,5,2,0,3,8,1994,Yuka Yoshida
201547,2193.596363,11,5,0,6,8,2014,Michelle Larcher De Brito
205008,2193.587826,1,0,0,1,31,2005,Eveline Vanhyfte
201078,2193.580489,5,2,0,3,5,2001,Eugenia Kulikovskaya
200101,2193.575464,3,1,0,2,7,1994,Jana Kandarr
202502,2193.55643,3,1,0,2,0,2012,So Ra Lee
200705,2193.514055,28,13,0,15,2,1990,Linda Ferrando
200077,2193.502409,1,0,0,1,1,1994,Jennifer Capriati
203389,2193.498775,1,0,0,1,9,2014,Danielle Rose Collins
201535,2193.489729,3,1,0,2,13,2009,Coco Vandeweghe
201330,2193.48912,5,2,0,3,19,2002,Maria Goloviznina
201539,2193.484494,42,20,0,22,4,2014,Christina Mchale
200043,2193.450692,22,10,0,12,7,2001,Virginie Razzano
200629,2193.443138,7,3,0,4,0,1990,Cristina Tessi
200098,2193.429744,47,21,0,26,1,2002,Henrieta Nagyova
200717,2193.319399,28,13,0,15,10,1998,Anne Miller
200649,2193.315447,3,1,0,2,12,1990,Ginger Helgeson Nielsen
201321,2193.287701,42,18,0,24,1,2005,Antonella Serra Zanetti
200123,2193.247511,30,13,0,17,3,2004,Marlene Weingartner
200676,2193.236854,25,12,0,13,5,1996,Mana Endo
201539,2193.218443,3,1,0,2,9,2009,Christina Mchale
200060,2193.214281,29,13,0,16,9,2009,Tathiana Garbin
200055,2193.211645,30,13,0,17,5,2002,Mariana Diaz Oliva
201366,2193.199138,52,24,0,28,3,2011,Barbora Zahlavova Strycova
202301,2193.189472,6,3,0,3,1,2007,Sunitha Rao
201357,2193.154694,1,0,0,1,25,2004,Virginie Pichet
201728,2193.114266,3,1,0,2,48,1999,Jessica Steck
200128,2193.075838,3,1,0,2,12,1991,Lindsay Davenport
200717,2193.034388,3,1,0,2,18,2000,Anne Miller
202490,2192.992608,1,0,0,1,14,2013,Rebecca Peterson
200678,2192.983228,24,10,0,14,11,1997,Gloria Pizzichini
201646,2192.966212,7,3,0,4,25,2012,Maria Joao Koehler
201492,2192.960502,1,0,0,1,1,2006,Andrea Petkovic
200676,2192.943156,27,11,0,16,8,1995,Mana Endo
200740,2192.935669,7,3,0,4,6,1995,Elena Tatarkova
201058,2192.924002,3,1,0,2,27,1992,Agnes Zugasti
201280,2192.883351,2,1,0,1,11,1997,Jacqueline Trail
201287,2192.882701,16,7,0,9,10,2008,Maria Jose Martinez Sanchez
201698,2192.881536,3,1,0,2,15,2008,Liana Gabriela Ungur
200607,2192.871138,23,10,0,13,7,1995,Beate Reinstadler
200717,2192.867808,1,0,0,1,1,1993,Anne Miller
200694,2192.864515,1,0,0,1,2,1990,Elly Hakami
201424,2192.846345,30,13,0,17,5,2013,Shahar Peer
201189,2192.828076,1,0,0,1,25,1992,Sarah Bentley
201333,2192.81358,3,1,0,2,44,2004,Angelika Roesch
201963,2192.788803,3,1,0,2,38,1994,Sofia Prazeres
200075,2192.779255,21,11,0,10,4,2000,Jing Qian Yi
201771,2192.750469,3,1,0,2,15,1996,Virag Csurgo
200044,2192.734012,38,18,0,20,6,2000,Denisa Chladkova
201084,2192.723379,9,4,0,5,4,2002,Nadejda Ostrovskaya
201377,2192.711992,1,0,0,1,20,2014,Yuliya Beygelzimer
200399,2192.693565,1,0,0,1,2,1990,Jennifer Mundel
201707,2192.690873,1,0,0,1,4,2010,Sachie Ishizu
200030,2192.685907,7,3,0,4,7,1999,Miroslava Vavrinec
200709,2192.660211,6,3,0,3,0,1991,Rosana De Los Rios
201715,2192.650102,1,0,0,1,24,1992,Heike Thoms
200392,2192.617611,32,14,0,18,4,1992,Jo Durie
201504,2192.595775,14,6,0,8,10,2008,Julia Goerges
201318,2192.584044,21,9,0,12,10,2006,Bethanie Mattek Sands
201498,2192.555738,14,7,0,7,9,2012,Karin Knapp
200039,2192.554939,3,1,0,2,16,2005,Chanda Rubin
201703,2192.545472,3,1,0,2,7,2008,Yi Fan Xu
200078,2192.530688,16,7,0,9,7,2001,Barbara Schwartz
200053,2192.482076,1,0,0,1,25,2004,Lubomira Bacheva
207166,2192.475072,3,1,0,2,38,1994,Ismet Duygu Aksit Oal
201307,2192.469929,1,0,0,1,15,2006,Amber Liu
201851,2192.438796,1,0,0,1,2,1991,Joanne Moore
200126,2192.434946,22,8,0,14,12,2001,Marissa Gould
200770,2192.424204,27,12,0,15,4,2003,Stephanie Cohen Aloro
200354,2192.412041,33,14,0,19,8,1991,Claudia Kohde Kilsch
201322,2192.403741,21,10,0,11,12,2002,Eva Dyrberg
200641,2192.398862,26,11,0,15,3,1990,Patricia Tarabini
200548,2192.389332,26,13,0,13,13,1995,Patty Fendick
201468,2192.371526,33,14,0,19,2,2013,Yaroslava Shvedova
201922,2192.333809,1,0,0,1,2,1993,Stephanie Tibbits
211651,2192.284048,5,2,0,3,7,2015,Paula Badosa
200706,2192.282817,1,0,0,1,8,1992,Catalina Cristea
200693,2192.274978,16,7,0,9,16,1998,Elena Makarova
201629,2192.245945,11,5,0,6,18,1993,Yael Segal
201499,2192.240895,1,0,0,1,4,2006,Anastasia Pavlyuchenkova
202071,2192.225854,1,0,0,1,40,1996,Dragana Zaric
202233,2192.209437,1,0,0,1,8,1994,Ayako Hirose
200560,2192.207874,5,2,0,3,3,1995,Rene Collins
201625,2192.1924,1,0,0,1,22,1994,Ju Yeon Choi
202505,2192.190164,1,0,0,1,4,2012,Belinda Bencic
201314,2192.162314,1,0,0,1,14,2001,Nina Duebbers
200072,2192.147213,41,20,0,21,4,2002,Cara Black
201920,2192.132894,3,1,0,2,5,2000,Renata Kolbovic
201518,2192.114654,57,31,0,26,6,2012,Yanina Wickmayer
201368,2192.111691,9,4,0,5,23,2007,Karolina Sprem
201318,2192.094045,5,2,0,3,11,2004,Bethanie Mattek Sands
201659,2192.086957,5,2,0,3,2,2008,Melanie Klaffner
201528,2192.084843,7,3,0,4,1,2008,Melanie Oudin
200708,2192.045979,1,0,0,1,16,2000,Sandra Cacic
200648,2192.039946,1,0,0,1,5,1996,Marketa Kochta
201599,2192.034939,7,3,0,4,8,2015,Andrea Hlavackova
200677,2191.974292,7,3,0,4,0,1991,Katja Oeljeklaus
202622,2191.970041,1,0,0,1,31,2010,Lyudmyla Kichenok
200056,2191.964031,9,4,0,5,1,1999,Jelena Kostanic Tosic
200091,2191.916236,7,3,0,4,11,1997,Janet Lee
202497,2191.901874,1,0,0,1,10,2012,Victoria Duval
201378,2191.901258,3,1,0,2,12,2003,Stephanie Gehrlein
200392,2191.894326,9,4,0,5,14,1994,Jo Durie
203047,2191.884635,1,0,0,1,22,1994,Cecilia Hincapie
202340,2191.883871,1,0,0,1,8,2004,Caroline Maes
200042,2191.870954,17,8,0,9,7,1999,Els Callens
201469,2191.868124,3,1,0,2,18,2006,Melanie South
202427,2191.834682,12,5,0,7,5,2013,Johanna Konta
200115,2191.833158,3,1,0,2,11,1997,Brie Rippner
201548,2191.813942,37,17,0,20,3,2014,Ajla Tomljanovic
201517,2191.806695,29,13,0,16,4,2012,Magdalena Rybarikova
200024,2191.796803,1,0,0,1,11,1992,Maria Vento Kabchi
202078,2191.795127,1,0,0,1,4,1996,Rosabel Moyen
200112,2191.784355,1,0,0,1,9,1997,Julie Halard Decugis
200559,2191.75478,3,1,0,2,30,1991,Kristine Kunce
200720,2191.754604,3,1,0,2,21,2002,Dally Randriantefy
201387,2191.754357,43,17,0,26,5,2011,Sofia Arvidsson
201085,2191.735651,9,4,0,5,2,1999,Shinobu Asagoe
200063,2191.73157,3,1,0,2,1,1994,Tatiana Panova
201707,2191.730856,1,0,0,1,12,2013,Sachie Ishizu
200732,2191.725275,20,9,0,11,16,2000,Magdalena Grzybowska
201490,2191.723031,1,0,0,1,2,2013,Timea Bacsinszky
200696,2191.717865,9,4,0,5,15,1992,Christina Papadaki
201307,2191.700714,3,1,0,2,15,2008,Amber Liu
201370,2191.699898,5,2,0,3,4,2014,Anastasia Rodionova
201406,2191.681853,3,1,0,2,11,2004,Shikha Uberoi
201369,2191.679392,7,3,0,4,12,2003,Carly Gullickson
201195,2191.672927,3,1,0,2,4,1993,Amanda Wainwright
201526,2191.669587,1,0,0,1,3,2015,Julie Coin
201489,2191.66631,7,3,0,4,7,2011,Mariya Koryttseva
201366,2191.664578,3,1,0,2,18,2003,Barbora Zahlavova Strycova
201499,2191.6407,1,0,0,1,18,2007,Anastasia Pavlyuchenkova
204291,2191.62167,1,0,0,1,7,2015,Na Lae Han
202040,2191.534546,5,2,0,3,36,1994,Linda Niemantsverdriet
201068,2191.531877,1,0,0,1,22,1998,Magali Lamarre
201654,2191.500334,1,0,0,1,13,2008,Sandra Roma
201522,2191.483629,3,1,0,2,20,2008,Jelena Pandzic
202454,2191.471626,3,1,0,2,4,2011,Erika Sema
201384,2191.457975,1,0,0,1,30,2008,Chia Jung Chuang
201508,2191.452423,3,1,0,2,5,2007,Petra Cetkovska
202579,2191.442577,1,0,0,1,15,2013,Giulia Gatto Monticone
201752,2191.439211,3,1,0,2,16,1992,Cristina Salvi
200043,2191.434793,40,18,0,22,2,2005,Virginie Razzano
201333,2191.429849,1,0,0,1,24,2007,Angelika Roesch
201309,2191.424813,3,1,0,2,38,1999,Tatiana Perebiynis
201044,2191.384177,1,0,0,1,22,1996,Catherine Mothes Jobkel
202510,2191.363993,1,0,0,1,15,1992,Natacha Randriantefy
200395,2191.359712,20,9,0,11,4,1990,Catherine Tanvier
200620,2191.345968,7,3,0,4,8,1990,Kirrily Sharpe
200031,2191.333889,5,2,0,3,3,1996,Meilen Tu
200117,2191.333523,1,0,0,1,36,1994,Kveta Peschke
202152,2191.313457,1,0,0,1,19,2001,Jana Hlavackova
201475,2191.305254,1,0,0,1,1,2005,Ahsha Rolle
201586,2191.287713,38,18,0,20,3,2015,Heather Watson
200104,2191.284963,27,12,0,15,5,2001,Emilie Loit
201442,2191.263469,37,16,0,21,5,2008,Yung Jan Chan
202484,2191.262408,6,2,0,4,10,2012,Nicole Gibbs
201565,2191.258801,1,0,0,1,25,2007,Katarzyna Piter
201452,2191.255523,42,19,0,23,2,2013,Lourdes Dominguez Lino
201580,2191.251851,7,3,0,4,5,2010,Xinyun Han
201368,2191.247478,31,14,0,17,1,2006,Karolina Sprem
200693,2191.246321,32,14,0,18,3,1996,Elena Makarova
201375,2191.24613,1,0,0,1,10,2008,Shenay Perry
200465,2191.234102,3,1,0,2,34,1990,Lisa Bonder Kreiss
212396,2191.232831,3,1,0,2,48,1992,Helene Holter
201723,2191.231269,1,0,0,1,17,1990,Angela Kerek
200114,2191.212506,3,1,0,2,1,2004,Patricia Wartusch
200691,2191.183858,7,3,0,4,11,1992,Flora Perfetti
201432,2191.183189,1,0,0,1,19,2005,Rebecca Llewellyn
206349,2191.17772,1,0,0,1,9,2015,Mayo Hibi
201389,2191.175307,1,0,0,1,25,2004,Zuzana Kucova
201760,2191.170784,1,0,0,1,12,1990,Heidi Sprung
200721,2191.152847,3,1,0,2,3,1993,Hiromi Nagano
201279,2191.14439,3,1,0,2,12,1995,Keri Phebus
206049,2191.120712,3,1,0,2,6,2013,Jovana Jaksic
201552,2191.116104,1,0,0,1,11,2008,Mallory Cecil
202845,2191.080972,3,1,0,2,17,2007,Vojislava Lukic
203064,2191.080566,5,2,0,3,9,1999,Hsueh Li Hsu
201741,2191.032354,1,0,0,1,14,1992,Alysia May
200101,2191.027686,31,14,0,17,4,2000,Jana Kandarr
201467,2191.023292,7,3,0,4,3,2003,Ivana Abramovic
202445,2191.013341,1,0,0,1,15,2011,Valeria Solovieva
201345,2191.000432,3,1,0,2,7,2002,Maria Sharapova
201548,2190.985342,39,18,0,21,6,2015,Ajla Tomljanovic
202416,2190.97628,3,1,0,2,45,2011,Nungnadda Wannasuk
201675,2190.936274,1,0,0,1,6,2007,So Jung Kim
201604,2190.92806,1,0,0,1,12,2013,Irina Falconi
202036,2190.920282,1,0,0,1,2,1991,Kristi Bastian
211222,2190.910513,1,0,0,1,9,2015,Jamie Loeb
200597,2190.89137,1,0,0,1,10,2000,Mary Joe Fernandez
201952,2190.876353,1,0,0,1,28,1993,Elena Savoldi
201383,2190.86135,5,2,0,3,1,2007,Marie Eve Pelletier
200110,2190.855713,5,2,0,3,2,1995,Fabiola Zuluaga
201343,2190.843438,7,3,0,4,7,2005,Maret Ani
207461,2190.83578,5,2,0,3,45,1993,Kaisaran Siewrattan
201609,2190.818189,7,3,0,4,0,2012,Yi Miao Zhou
200678,2190.813498,5,2,0,3,24,1992,Gloria Pizzichini
201426,2190.799024,38,17,0,21,2,2008,Pauline Parmentier
201551,2190.794893,1,0,0,1,19,2007,Arantxa Rus
201514,2190.775303,29,13,0,16,4,2011,Sorana Cirstea
202269,2190.742419,9,4,0,5,52,2001,Erika Valdes
204426,2190.73798,9,4,0,5,15,2014,Anett Kontaveit
201370,2190.737661,3,1,0,2,4,2015,Anastasia Rodionova
201081,2190.736539,1,0,0,1,24,2000,Joanne Ward
201309,2190.723312,22,9,0,13,10,2008,Tatiana Perebiynis
201812,2190.720395,1,0,0,1,50,1994,Hiroko Mochizuki
202067,2190.71183,1,0,0,1,28,1991,Alice Nohacova
200013,2190.710651,39,19,0,20,1,1993,Angelica Gavaldon
200621,2190.701331,31,15,0,16,13,1990,Isabelle Demongeot
201708,2190.699549,1,0,0,1,9,2008,Natalie Grandin
201437,2190.698144,5,2,0,3,6,2005,Ivana Lisjak
203963,2190.662994,5,2,0,3,45,1998,Boglarka Berecz
200013,2190.661798,32,16,0,16,2,1990,Angelica Gavaldon
200661,2190.638814,3,1,0,2,15,1992,Samantha Smith
201583,2190.602399,1,0,0,1,3,2009,Yana Buchina
202301,2190.578675,3,1,0,2,7,2005,Sunitha Rao
201533,2190.575012,1,0,0,1,6,2006,Shuai Zhang
201378,2190.569806,1,0,0,1,2,2008,Stephanie Gehrlein
200104,2190.531791,1,0,0,1,23,1997,Emilie Loit
202684,2190.516054,7,3,0,4,4,2014,Lin Zhu
201695,2190.514287,1,0,0,1,17,2010,Anna Brazhnikova
200625,2190.507888,1,0,0,1,26,1993,Jana Pospisilova
202389,2190.499647,5,2,0,3,2,2007,Sandra Martinovic
201855,2190.494883,1,0,0,1,27,1993,Adriana Barna
201581,2190.486564,1,0,0,1,5,2009,Chun Mei Ji
200413,2190.485897,8,3,0,5,3,1991,Heather Ludloff
201305,2190.477688,17,8,0,9,5,2001,Eleni Daniilidou
201212,2190.463875,1,0,0,1,29,1999,Francesca Schiavone
201649,2190.455487,1,0,0,1,18,2011,Lenka Jurikova
201592,2190.434225,5,2,0,3,36,2011,Beatriz Garcia Vidagany
201196,2190.433639,3,1,0,2,18,1996,Claire Taylor
201058,2190.427132,1,0,0,1,10,1991,Agnes Zugasti
201503,2190.427098,1,0,0,1,5,2005,Ayumi Morita
202408,2190.415244,1,0,0,1,12,2008,Amanda Fink
202121,2190.413743,9,4,0,5,0,1997,Benjamas Sangaram
201844,2190.40983,1,0,0,1,38,1995,Agnese Gustmane
201383,2190.405237,3,1,0,2,1,2006,Marie Eve Pelletier
202356,2190.390819,1,0,0,1,24,2006,Nikola Frankova
200519,2190.384984,9,4,0,5,0,1991,Sybille Niox Chateau
201053,2190.36758,3,1,0,2,7,1992,Sylvie Sabas
201812,2190.353486,1,0,0,1,5,1996,Hiroko Mochizuki
201585,2190.325209,5,2,0,3,17,2010,Sloane Stephens
200710,2190.320658,3,1,0,2,20,1992,Magdalena Feistel
201665,2190.315576,3,1,0,2,37,2002,Ipek Senoglu
200061,2190.304987,1,0,0,1,11,1995,Gala Leon Garcia
201291,2190.29271,3,1,0,2,47,2003,Nuria Llagostera Vives
201076,2190.271942,1,0,0,1,25,1999,Sophie Georges
200072,2190.252983,3,1,0,2,38,1994,Cara Black
200126,2190.252334,1,0,0,1,15,1998,Marissa Gould
200745,2190.250975,1,0,0,1,30,1992,Andrea Glass
201661,2190.244504,1,0,0,1,15,2007,Tina Schiechtl
200709,2190.220158,3,1,0,2,19,1992,Rosana De Los Rios
200117,2190.219015,3,1,0,2,5,1993,Kveta Peschke
201466,2190.216114,9,4,0,5,15,2002,Kaia Kanepi
207536,2190.193852,3,1,0,2,42,1995,Carla Rodriguez
202324,2190.187798,3,1,0,2,7,2007,Neha Uberoi
201366,2190.169552,34,17,0,17,7,2004,Barbora Zahlavova Strycova
201693,2190.168214,5,2,0,3,18,2011,Timea Babos
200713,2190.16667,3,1,0,2,8,2003,Yuka Yoshida
200579,2190.149877,31,15,0,16,7,1993,Karin Kschwendt
200659,2190.133457,7,3,0,4,45,1998,Rika Hiraki
202988,2190.119108,9,4,0,5,33,1997,Kyung Yee Chae
201540,2190.112958,3,1,0,2,21,2010,Kristina Mladenovic
202498,2190.105438,9,4,0,5,13,2015,Julia Glushko
200046,2190.091191,7,3,0,4,1,1996,Meghann Shaughnessy
201487,2190.090758,7,3,0,4,10,2008,Jessica Moore
200560,2190.085938,1,0,0,1,60,1998,Rene Collins
201529,2190.076781,1,0,0,1,13,2014,Kristie Ahn
201031,2190.069714,1,0,0,1,30,1990,Niurka Sodupe
201648,2190.067725,3,1,0,2,19,2011,Naomi Broady
202152,2190.066657,1,0,0,1,15,2003,Jana Hlavackova
201434,2190.06571,3,1,0,2,15,2005,Sabine Klaschka
204246,2190.062132,1,0,0,1,18,2014,Lesley Kerkhove
201285,2190.058103,3,1,0,2,10,1999,Melissa Middleton
202367,2190.053342,3,1,0,2,5,2006,Jing Ren
201428,2190.048995,1,0,0,1,22,2005,Mathilde Johansson
201411,2190.03834,3,1,0,2,7,2004,Aiko Nakamura
200717,2190.025168,1,0,0,1,10,1999,Anne Miller
201655,2190.025051,1,0,0,1,17,2011,Anna Floris
201521,2190.021405,28,14,0,14,5,2008,Carla Suarez Navarro
200617,2190.015219,17,6,0,11,1,2009,Kimiko Date Krumm
201625,2190.009597,1,0,0,1,16,1998,Ju Yeon Choi
200686,2190.006363,9,4,0,5,4,1990,Sandra Dopfer
201613,2189.991137,3,1,0,2,5,2008,Arina Rodionova
203083,2189.986766,7,3,0,4,33,2003,Stephanie Schaer
201670,2189.984617,3,1,0,2,8,2009,Amra Sadikovic
201418,2189.977081,1,0,0,1,8,2003,Ting Li
201377,2189.969006,9,4,0,5,7,2003,Yuliya Beygelzimer
200540,2189.952252,3,1,0,2,3,1993,Amy Schwartz
200704,2189.949662,12,5,0,7,3,1995,Maria Jose Gaidano
201069,2189.943347,3,1,0,2,29,1999,Karolina Jagieniak
202256,2189.942112,1,0,0,1,6,1995,Helena Vildova
200619,2189.926378,3,1,0,2,22,1990,Kate Mcdonald
201348,2189.919378,24,10,0,14,5,2012,Casey Dellacqua
202405,2189.914086,1,0,0,1,18,2008,Alexis King
203098,2189.9102,1,0,0,1,31,2005,Leslie Butkiewicz
201918,2189.904984,1,0,0,1,15,1991,Melanie Bernard
201442,2189.897042,1,0,0,1,10,2005,Yung Jan Chan
201918,2189.871894,1,0,0,1,23,1995,Melanie Bernard
206086,2189.864949,5,2,0,3,27,2012,Mai El Kamash
200754,2189.849948,3,1,0,2,16,2000,Jill Craybas
200736,2189.848886,3,1,0,2,22,1994,Li Ling Chen
200708,2189.84339,20,9,0,11,14,2001,Sandra Cacic
200022,2189.838824,5,2,0,3,25,2008,Emmanuelle Gagliardi
201374,2189.838767,1,0,0,1,12,2003,Gabriela Lastra
200494,2189.829894,7,3,0,4,10,1994,Dianne Van Rensburg
200442,2189.826264,1,0,0,1,50,1997,Andrea Temesvari
201654,2189.822665,1,0,0,1,17,2009,Sandra Roma
200617,2189.81312,29,12,0,17,3,2013,Kimiko Date Krumm
201465,2189.802765,49,23,0,26,3,2014,Kirsten Flipkens
201602,2189.784495,1,0,0,1,12,2013,Beatrice Capra
200684,2189.756413,38,19,0,19,0,1997,Shi Ting Wang
201318,2189.75435,14,6,0,8,10,2007,Bethanie Mattek Sands
200064,2189.749296,32,15,0,17,2,1990,Amanda Coetzer
201285,2189.732298,1,0,0,1,54,2002,Melissa Middleton
200673,2189.727753,26,11,0,15,2,1991,Susan Sloane Lundy
200068,2189.724858,14,6,0,8,1,2006,Lilia Osterloh
201458,2189.703248,21,9,0,12,1,2006,Victoria Azarenka
200058,2189.702942,7,3,0,4,10,1992,Anna Foldenyi Dicker
200494,2189.693948,7,3,0,4,29,1993,Dianne Van Rensburg
200710,2189.692404,1,0,0,1,16,1998,Magdalena Feistel
201573,2189.687005,8,3,0,5,5,2011,Laura Robson
200073,2189.667708,1,0,0,1,4,1993,Julie Pullin
213530,2189.653402,3,1,0,2,36,2014,Allie Kiick
200004,2189.653291,3,1,0,2,7,1993,Kerry Anne Guse
200643,2189.65153,1,0,0,1,13,1993,Petra Kamstra
203576,2189.648549,3,1,0,2,4,2015,Kai Lin Zhang
201612,2189.645934,1,0,0,1,7,2005,Junri Namigata
201525,2189.644775,1,0,0,1,6,2005,Eva Hrdinova
202283,2189.631638,5,2,0,3,9,2002,Anouska Van Exel
200071,2189.627855,8,3,0,5,9,2001,Lenka Nemeckova
202135,2189.617932,1,0,0,1,5,2000,Vanessa Henke
201293,2189.601015,7,3,0,4,5,2012,Catalina Castano
203080,2189.593412,9,4,0,5,45,1998,Nadia Johnston
203062,2189.591537,3,1,0,2,9,1998,Yu An Chen
204634,2189.591537,1,0,0,1,9,1998,Bettina Horvath
202416,2189.590102,1,0,0,1,40,2012,Nungnadda Wannasuk
200720,2189.58254,1,0,0,1,15,1992,Dally Randriantefy
203051,2189.576108,7,3,0,4,9,1998,Satomi Kinjo
201440,2189.566594,28,13,0,15,9,2011,Laura Pous Tio
200672,2189.544195,3,1,0,2,10,1991,Barbara Mulej
201332,2189.541339,3,1,0,2,22,2004,Jane Odonoghue
212159,2189.533335,5,2,0,3,27,2002,Laura Viquez
200362,2189.526876,29,14,0,15,2,1990,Liz Smylie
200658,2189.525634,3,1,0,2,21,1991,Fang Li
201313,2189.519169,19,9,0,10,4,2005,Yoon Jeong Cho
201728,2189.507311,1,0,0,1,9,2002,Jessica Steck
201620,2189.497614,28,13,0,15,3,2013,Monica Puig
203068,2189.493161,3,1,0,2,57,1997,Natalia Nikitina
200736,2189.485889,3,1,0,2,56,1997,Li Ling Chen
201293,2189.483917,13,6,0,7,16,2010,Catalina Castano
202067,2189.452634,1,0,0,1,12,1990,Alice Nohacova
202504,2189.450585,5,2,0,3,8,2013,Ying Ying Duan
201290,2189.449604,1,0,0,1,4,1999,Daniela Hantuchova
201556,2189.442348,3,1,0,2,7,2006,Lucie Hradecka
201088,2189.43828,3,1,0,2,22,1999,Karen Cross
201579,2189.43821,1,0,0,1,7,2011,Yurika Sema
201622,2189.430072,5,2,0,3,7,2011,Iryna Bremond
200776,2189.414034,1,0,0,1,26,2003,Angelika Bachmann
201275,2189.411132,5,2,0,3,13,1993,Julie Steven
212268,2189.407388,5,2,0,3,31,2010,Camila Quesada
200074,2189.406762,1,0,0,1,7,1993,Jane Chi
202702,2189.403038,3,1,0,2,2,2013,Tereza Smitkova
200688,2189.374814,1,0,0,1,11,1992,Noelia Perez Penate
202445,2189.372225,3,1,0,2,14,2013,Valeria Solovieva
201443,2189.354846,8,3,0,5,11,2011,Alexa Glatch
201305,2189.352052,34,14,0,20,2,2005,Eleni Daniilidou
202257,2189.338167,1,0,0,1,22,1994,Carmina Giraldo
204291,2189.328958,3,1,0,2,7,2014,Na Lae Han
201576,2189.319173,1,0,0,1,1,2006,Valerie Tetreault
200456,2189.315806,1,0,0,1,41,1991,Masako Yanagi
201087,2189.310304,9,4,0,5,2,1999,Mashona Washington
202157,2189.308874,1,0,0,1,35,1992,Paola Tampieri
201575,2189.306499,1,0,0,1,14,2010,Hilary Barte
201637,2189.297788,3,1,0,2,36,2002,Melissa Torres Sandoval
201539,2189.280622,31,13,0,18,7,2013,Christina Mchale
200764,2189.274628,3,1,0,2,24,2009,Elena Bovina
200035,2189.266499,7,3,0,4,9,1994,Maria Sanchez Lorenzo
202431,2189.261878,3,1,0,2,7,2013,Tetyana Arefyeva
214082,2189.254351,1,0,0,1,3,2014,Darya Kasatkina
201431,2189.236407,3,1,0,2,20,2005,Aravane Rezai
202287,2189.224386,1,0,0,1,42,2006,Daniela Kix
201573,2189.223472,1,0,0,1,18,2009,Laura Robson
200014,2189.222179,11,5,0,6,7,2003,Tzipi Obziler
200647,2189.210131,37,17,0,20,4,1992,Noelle Van Lottum
200638,2189.209437,24,11,0,13,7,1995,Stephanie Rottier
201391,2189.204062,3,1,0,2,39,2009,Sanda Mamic
201760,2189.185331,1,0,0,1,28,1991,Heidi Sprung
200066,2189.178194,3,1,0,2,15,1994,Cristina Torrens Valero
201605,2189.173934,3,1,0,2,2,2005,Mandy Minella
200714,2189.161342,3,1,0,2,14,2000,Yvette Basting
201838,2189.140312,1,0,0,1,33,1996,Federica Fortuni
201505,2189.138498,41,19,0,22,3,2009,Ekaterina Makarova
201388,2189.13613,5,2,0,3,22,2005,Sophie Ferguson
202329,2189.121242,3,1,0,2,36,2002,Jessica Fernandez
200027,2189.101519,5,2,0,3,38,2005,Magui Serna
201419,2189.079667,5,2,0,3,9,1999,Na Li
202506,2189.063693,1,0,0,1,4,2012,Margarita Gasparyan
202822,2189.052737,3,1,0,2,26,2006,Ia Jikia
202331,2189.049407,3,1,0,2,31,2007,Vilmarie Castellvi
201863,2189.048888,3,1,0,2,20,1999,Alice Canepa
201867,2189.044911,1,0,0,1,8,2000,Magdalena Kucerova
200704,2189.041792,1,0,0,1,16,1992,Maria Jose Gaidano
201803,2189.040458,1,0,0,1,23,1990,Gabriela Castro
201621,2189.039066,1,0,0,1,3,2010,Mona Barthel
200661,2189.036278,1,0,0,1,4,1995,Samantha Smith
212228,2189.033267,3,1,0,2,26,2009,Ana Lilyan Guzman
201078,2189.0216,1,0,0,1,9,1995,Eugenia Kulikovskaya
203341,2189.018923,1,0,0,1,13,2015,Sanaz Marand
201456,2189.015056,1,0,0,1,11,2013,Olga Savchuk
212292,2189.012766,3,1,0,2,41,2012,Nilushi Fernando
204411,2189.01204,3,1,0,2,49,2014,Storm Sanders
212739,2188.994548,5,2,0,3,56,1997,Mehvish Chishtie
200576,2188.986898,1,0,0,1,22,1995,Nathalie Herreman
212396,2188.984137,3,1,0,2,34,1997,Helene Holter
201698,2188.97775,1,0,0,1,16,2010,Liana Gabriela Ungur
202427,2188.964437,1,0,0,1,21,2011,Johanna Konta
201429,2188.962795,5,2,0,3,13,2011,Rika Fujiwara
205348,2188.958002,3,1,0,2,32,2005,Wei Ping Lee
201278,2188.951319,1,0,0,1,4,1996,Angela Lettiere
200701,2188.944017,3,1,0,2,3,1990,Caroline Vis
201668,2188.942448,3,1,0,2,5,2008,Alexandra Panova
201511,2188.941266,5,2,0,3,19,2008,Ekaterina Ivanova
203509,2188.936888,5,2,0,3,25,2014,Diana Marcinkevica
200545,2188.93539,1,0,0,1,11,1991,Ei Iida
203591,2188.916169,1,0,0,1,19,2014,Katy Dunne
203063,2188.912351,3,1,0,2,56,1997,Julie Huang
212710,2188.899761,1,0,0,1,32,1998,Camille Sesanker
201923,2188.890679,1,0,0,1,2,1993,Alix Creek
201545,2188.884981,1,0,0,1,22,2012,Anastasija Sevastova
201444,2188.849745,1,0,0,1,10,2002,Su Wei Hsieh
201863,2188.843273,1,0,0,1,38,1997,Alice Canepa
200638,2188.842306,24,9,0,15,6,1994,Stephanie Rottier
201653,2188.841541,1,0,0,1,27,2015,Ellen Allgurin
201317,2188.834745,26,12,0,14,3,2004,Aniko Kapros
201513,2188.828209,1,0,0,1,24,2006,Sabine Lisicki
201555,2188.813902,37,14,0,23,5,2012,Polona Hercog
202421,2188.804554,3,1,0,2,20,2011,Alison Van Uytvanck
201331,2188.803904,40,16,0,24,3,2011,Iveta Benesova
201459,2188.80351,5,2,0,3,3,2003,Zi Yan
200069,2188.799127,8,3,0,5,2,1999,Nadia Petrova
201944,2188.79829,1,0,0,1,35,2002,Zuzana Hejdova
202339,2188.796808,1,0,0,1,9,2006,Ayu Fani Damayanti
202484,2188.795889,3,1,0,2,8,2013,Nicole Gibbs
200071,2188.793141,3,1,0,2,8,2004,Lenka Nemeckova
200773,2188.792297,3,1,0,2,25,1999,Stephanie Foretz Gacon
201879,2188.788897,1,0,0,1,5,1993,Reka Vidats
200051,2188.777284,5,2,0,3,21,1991,Irina Spirlea
200403,2188.7735,1,0,0,1,58,1994,Andrea Leand
200552,2188.76782,1,0,0,1,57,1992,Maria Lindstrom
201366,2188.764147,38,16,0,22,3,2010,Barbora Zahlavova Strycova
201811,2188.763785,1,0,0,1,39,2003,Young Ja Choi
200773,2188.758806,3,1,0,2,27,2000,Stephanie Foretz Gacon
201192,2188.755499,1,0,0,1,29,1993,Colette Caple
200706,2188.74771,28,11,0,17,3,1998,Catalina Cristea
201745,2188.744203,3,1,0,2,25,1991,Lupita Novelo
200333,2188.727715,1,0,0,1,55,1994,Betsy Nagelsen
202311,2188.727611,1,0,0,1,32,2003,Petra Dizdar
201435,2188.718708,3,1,0,2,3,2003,Kateryna Bondarenko
200666,2188.711672,1,0,0,1,27,1993,Marion Maruska
201352,2188.687267,6,2,0,4,4,2009,Akiko Morigami
200665,2188.670487,7,3,0,4,8,1992,Yone Kamio
202326,2188.666,3,1,0,2,7,2006,Ankita Bhambri
200654,2188.664388,1,0,0,1,15,1991,Patty Oreilly
202289,2188.658219,1,0,0,1,8,2003,Jin Hee Kim
202314,2188.65545,1,0,0,1,16,2003,Leslie Koffi
204897,2188.642328,3,1,0,2,31,1999,Dina Khalil
201653,2188.642214,1,0,0,1,14,2013,Ellen Allgurin
202496,2188.640344,1,0,0,1,30,2013,Samantha Crawford
203475,2188.620214,1,0,0,1,11,2013,Carol Zhao
201662,2188.618622,1,0,0,1,16,2010,Karolina Pliskova
202289,2188.615993,3,1,0,2,9,1999,Jin Hee Kim
201445,2188.612869,3,1,0,2,43,2004,Viktoria Kutuzova
201414,2188.612717,1,0,0,1,21,2003,Michaella Krajicek
201593,2188.601221,1,0,0,1,17,2009,Irina Camelia Begu
200720,2188.598315,14,6,0,8,11,1996,Dally Randriantefy
201561,2188.595113,5,2,0,3,20,2014,Claire Feuerstein
204536,2188.594017,3,1,0,2,42,1995,Barbara Castro
201397,2188.592417,1,0,0,1,16,2002,Shuai Peng
200696,2188.587676,3,1,0,2,47,1997,Christina Papadaki
200661,2188.584239,1,0,0,1,24,2000,Samantha Smith
201382,2188.581497,1,0,0,1,50,2004,Olivia Lukaszewicz
202339,2188.576475,1,0,0,1,10,2004,Ayu Fani Damayanti
201708,2188.57645,7,3,0,4,9,2005,Natalie Grandin
201702,2188.572745,1,0,0,1,21,2011,Malou Ejdesgaard
202012,2188.570839,3,1,0,2,33,1992,Lee Chan
201059,2188.561267,7,3,0,4,11,1991,Misumi Miyauchi
202329,2188.55357,3,1,0,2,37,1996,Jessica Fernandez
212124,2188.55357,3,1,0,2,30,2001,Ilona Giberte
201086,2188.549122,5,2,0,3,37,2013,Greta Arn
201565,2188.547573,5,2,0,3,22,2009,Katarzyna Piter
200701,2188.542705,3,1,0,2,6,1993,Caroline Vis
202582,2188.541398,3,1,0,2,26,2009,Lizaan Du Plessis
205010,2188.533929,5,2,0,3,25,2008,Magy Aziz
202305,2188.533309,3,1,0,2,52,1995,Manisha Malhotra
200707,2188.531181,3,1,0,2,18,2005,Romana Tedjakusuma
205694,2188.531114,3,1,0,2,25,2008,Helene Auensen
203303,2188.530614,3,1,0,2,25,2013,Ana Veselinovic
206587,2188.528336,3,1,0,2,28,2001,Daniela Alvarez
200659,2188.524007,1,0,0,1,42,2001,Rika Hiraki
208060,2188.522032,1,0,0,1,29,2003,Sihem Ben Youcef
201993,2188.521013,3,1,0,2,0,1994,Pavlina Rajzlova
201408,2188.514825,1,0,0,1,43,2003,Jamea Jackson
201659,2188.514644,1,0,0,1,17,2006,Melanie Klaffner
201306,2188.493392,3,1,0,2,43,2005,Marie Gaiane Mikaelian
212280,2188.492008,3,1,0,2,23,2011,Ana Sofia Cordero
212303,2188.485087,1,0,0,1,28,2012,Justina Mikulskyte
206213,2188.483335,5,2,0,3,27,2012,Amy Bowtell
204759,2188.483037,1,0,0,1,56,1997,Ning Lin
202622,2188.477587,1,0,0,1,7,2013,Lyudmyla Kichenok
202437,2188.475123,1,0,0,1,17,2011,Anastasia Grymalska
205786,2188.475038,3,1,0,2,26,2009,May El Wardany
212736,2188.466084,1,0,0,1,45,2000,Samanthi Wijesekera
200689,2188.461253,3,1,0,2,7,1995,Tessa Price
202464,2188.458653,3,1,0,2,34,2013,Yuliana Lizarazo
205787,2188.451903,3,1,0,2,31,2005,Francesca Segarelli
201657,2188.448171,1,0,0,1,15,2009,Nastja Kolar
202459,2188.442361,1,0,0,1,47,2012,Bojana Bobusic
201428,2188.442254,3,1,0,2,21,2006,Mathilde Johansson
201298,2188.44126,5,2,0,3,30,2007,Zsofia Gubacsi
200641,2188.44055,19,8,0,11,7,1992,Patricia Tarabini
204540,2188.439163,5,2,0,3,45,1993,Maria Virginia Francesca
211539,2188.438592,1,0,0,1,21,2015,Fiona Ferro
201511,2188.434901,5,2,0,3,7,2009,Ekaterina Ivanova
201047,2188.432956,3,1,0,2,23,1995,Andrea Vieira
201324,2188.432802,1,0,0,1,37,1998,Irina Selyutina
201635,2188.421707,5,2,0,3,37,2009,Betina Jozami
201195,2188.421585,1,0,0,1,19,1995,Amanda Wainwright
202419,2188.420662,1,0,0,1,36,2011,Barbara Luz
201319,2188.414901,1,0,0,1,18,1998,Evelyn Fauth
201597,2188.414393,11,5,0,6,0,2012,Kurumi Nara
212585,2188.410862,1,0,0,1,52,2000,Solange Rasoarivelo
202303,2188.409114,13,6,0,7,11,2002,Carla Tiene
206581,2188.405558,1,0,0,1,39,2002,Maria Alejandra Garcia
201454,2188.405093,3,1,0,2,7,2003,Akgul Amanmuradova
200702,2188.399905,1,0,0,1,11,1993,Naoko Kijimuta
210046,2188.39918,5,2,0,3,37,2013,Anna Clarice Patrimonio
201411,2188.389789,1,0,0,1,4,2011,Aiko Nakamura
201809,2188.388048,5,2,0,3,26,2000,Hila Rosen
201804,2188.38558,1,0,0,1,3,1993,Claudia Chabalgoity
201475,2188.379666,1,0,0,1,28,2011,Ahsha Rolle
201062,2188.378071,1,0,0,1,20,1995,Amelie Castera
202766,2188.372538,3,1,0,2,35,2004,Nicole Rencken
201661,2188.371128,1,0,0,1,15,2009,Tina Schiechtl
201069,2188.350523,1,0,0,1,23,1997,Karolina Jagieniak
202427,2188.348494,5,2,0,3,10,2012,Johanna Konta
200687,2188.343461,22,10,0,12,3,1995,Katarzyna Nowak
200034,2188.336399,7,3,0,4,11,2002,Amanda Grahame
201553,2188.336356,1,0,0,1,6,2008,Lenka Wienerova
201853,2188.335897,1,0,0,1,49,1991,Andrea Muller
201603,2188.327221,1,0,0,1,9,2010,Shelby Rogers
201678,2188.3107,5,2,0,3,44,2010,Sacha Jones
201618,2188.304805,1,0,0,1,41,2014,Fatma Al Nabhani
201558,2188.292047,1,0,0,1,21,2009,Lauren Embree
202148,2188.29135,1,0,0,1,26,1993,Alena Havrlikova
202455,2188.285755,1,0,0,1,8,2012,Yue Yue Hu
201040,2188.281614,1,0,0,1,3,1993,Luciana Corsato Owsianka
201471,2188.279083,3,1,0,2,17,2008,Naomi Cavaday
200090,2188.278776,1,0,0,1,9,1994,Anca Barna
201918,2188.278316,1,0,0,1,54,1994,Melanie Bernard
204377,2188.271197,3,1,0,2,31,2015,Indy De Vroome
200075,2188.265348,1,0,0,1,0,1999,Jing Qian Yi
200083,2188.260833,1,0,0,1,15,2005,Alexandra Stevenson
201206,2188.255698,1,0,0,1,17,2002,Allison Bradshaw
201439,2188.249235,1,0,0,1,10,2005,Tiffany Dabek
201340,2188.248306,1,0,0,1,12,2002,Maria Geznenge
201462,2188.241555,1,0,0,1,26,2015,Alberta Brianti
202358,2188.232317,1,0,0,1,22,2006,Irina Kotkina
201583,2188.224509,1,0,0,1,15,2011,Yana Buchina
201359,2188.21787,1,0,0,1,23,2003,Amandine Dulon
201078,2188.217042,1,0,0,1,3,1996,Eugenia Kulikovskaya
201682,2188.21506,1,0,0,1,4,2006,Nudnida Luangnam
201572,2188.213818,3,1,0,2,17,2011,Regina Kulikova
201603,2188.203151,5,2,0,3,8,2013,Shelby Rogers
200483,2188.20215,3,1,0,2,59,1992,Kumiko Okamoto
201863,2188.200276,1,0,0,1,62,2000,Alice Canepa
201715,2188.18342,1,0,0,1,6,1990,Heike Thoms
200742,2188.182964,1,0,0,1,55,1996,Olga Lugina
201964,2188.177741,5,2,0,3,20,1991,Tania Couto
201053,2188.175843,3,1,0,2,32,1993,Sylvie Sabas
200708,2188.17036,1,0,0,1,12,2002,Sandra Cacic
203537,2188.169585,1,0,0,1,43,2014,Victoria Kan
206368,2188.169585,1,0,0,1,43,2014,Veronika Kudermetova
201075,2188.16707,1,0,0,1,0,1997,Liezel Huber
202216,2188.164853,1,0,0,1,26,2000,Lilia Biktyakova
200062,2188.163876,34,14,0,20,17,2001,Kristina Brandi
200091,2188.158433,3,1,0,2,53,1994,Janet Lee
200104,2188.155087,7,3,0,4,21,2009,Emilie Loit
202449,2188.149965,1,0,0,1,21,2012,Victoria Larriere
200120,2188.149035,31,15,0,16,9,2011,Jelena Dokic
201070,2188.125015,1,0,0,1,22,1998,Emmanuelle Curutchet
200773,2188.124018,2,0,0,2,17,2008,Stephanie Foretz Gacon
200122,2188.115318,5,2,0,3,31,2005,Tina Pisnik
204542,2188.113247,3,1,0,2,42,1995,Ninfa Marra
200765,2188.111341,5,2,0,3,17,2009,Katalin Marosi
201401,2188.107334,1,0,0,1,14,2008,Abigail Spears
201055,2188.104043,1,0,0,1,28,1992,Barbara Collet
202275,2188.103896,3,1,0,2,58,1996,Tagifano Soonalole
202279,2188.099956,1,0,0,1,41,2004,Virag Nemeth
207495,2188.0965,5,2,0,3,32,1997,Zdenka Videnova
202997,2188.090098,3,1,0,2,36,2003,Yvonne Doyle
210046,2188.076455,3,1,0,2,42,2012,Anna Clarice Patrimonio
200649,2188.07343,27,12,0,15,1,1992,Ginger Helgeson Nielsen
212304,2188.071302,3,1,0,2,43,2014,Maria Siopacha
204536,2188.069842,3,1,0,2,41,1998,Barbara Castro
214626,2188.069783,3,1,0,2,43,2014,Ida Seljevoll Skancke
212146,2188.069729,3,1,0,2,44,2002,Sarah Wetz
200083,2188.067577,1,0,0,1,53,1996,Alexandra Stevenson
200636,2188.066584,1,0,0,1,53,1991,Danielle Jones
212151,2188.066584,1,0,0,1,47,2002,Lesedi Ramocha
212179,2188.066584,1,0,0,1,31,2003,Linda Svarena
212182,2188.065024,1,0,0,1,46,2000,Hazar Sidki
212259,2188.064678,5,2,0,3,31,2010,Alma Michelle Espinosa Rodriguez
200118,2188.062256,31,13,0,18,13,2001,Virginia Ruano Pascual
201357,2188.054771,1,0,0,1,23,2003,Virginie Pichet
201087,2188.052899,3,1,0,2,16,2001,Mashona Washington
212092,2188.05105,3,1,0,2,45,2001,Archana Reddy
205763,2188.05105,3,1,0,2,27,2003,Essi Laine
210539,2188.05105,3,1,0,2,28,2003,Tapiwa Marobela
202498,2188.05105,3,1,0,2,45,2010,Julia Glushko
212260,2188.05105,3,1,0,2,31,2010,Rosaline Zafir Chavez Tello
202348,2188.051021,3,1,0,2,31,2011,Lina Stanciute
212466,2188.049504,3,1,0,2,31,1992,Ya Hui Lin
200694,2188.046483,1,0,0,1,61,1994,Elly Hakami
205909,2188.046026,3,1,0,2,31,2010,Ola Abou Zekry
202611,2188.045704,1,0,0,1,26,2014,Oksana Kalashnikova
200690,2188.045185,3,1,0,2,63,1997,Kyoko Nagatsuka
202395,2188.045016,3,1,0,2,26,2014,Maria Irigoyen
200043,2188.044377,16,7,0,9,5,2012,Virginie Razzano
210271,2188.04417,3,1,0,2,36,2013,Anita Husaric
205143,2188.035858,5,2,0,3,35,2004,Valentina Castro
201512,2188.034324,3,1,0,2,29,2004,Monica Niculescu
200692,2188.031543,3,1,0,2,24,1995,Marzia Grossi
206910,2188.030729,3,1,0,2,38,2002,Mari Toro
203929,2188.030676,3,1,0,2,40,1992,Giana Gutierrez
212570,2188.030676,3,1,0,2,26,1995,Phyllis Wilunda
210173,2188.030676,3,1,0,2,45,2014,Ushna Suhail
212306,2188.02876,3,1,0,2,27,2012,Paula Castro
212104,2188.027535,3,1,0,2,36,2000,Tinesta Rowe
212045,2188.026374,1,0,0,1,31,2011,Sinead Lohan
212361,2188.026085,3,1,0,2,26,1998,Fabienne Gmeiner
203069,2188.017541,3,1,0,2,42,1998,Elena Krutko
201366,2188.017399,14,5,0,9,5,2008,Barbora Zahlavova Strycova
212448,2188.011209,3,1,0,2,47,1995,Carla Jimenez
209712,2188.010329,3,1,0,2,27,2007,Elaine Genovese
212554,2188.009578,1,0,0,1,27,1997,Kelly Holland
211279,2188.008281,1,0,0,1,18,2015,Harriet Dart
212189,2188.007879,1,0,0,1,46,2000,Nivin Kezbari
212304,2188.007879,1,0,0,1,29,2012,Maria Siopacha
207292,2188.007097,3,1,0,2,26,1998,Caroline Tidemand
204969,2188.007097,1,0,0,1,30,2001,Edita Liachoviciute
205909,2188.006501,1,0,0,1,26,2014,Ola Abou Zekry
212119,2188.005559,5,2,0,3,36,2000,Luisa Elfride Lopez
201950,2188.005496,3,1,0,2,42,1998,Miriam Dagostini
202270,2188.004894,1,0,0,1,25,2005,Habiba Ifrakh
201192,2188.002136,1,0,0,1,25,1992,Colette Caple
202121,2187.996859,1,0,0,1,0,1999,Benjamas Sangaram
202123,2187.989384,7,3,0,4,33,1997,Suvimol Duangchan
213892,2187.988957,1,0,0,1,13,2013,Nazrin Jafarova
212422,2187.987902,1,0,0,1,47,1996,Alexandra Scholer
203061,2187.986739,1,0,0,1,46,1996,Ewa Radzikowska
204451,2187.986739,1,0,0,1,32,2007,Asimina Kaplani
201083,2187.98652,3,1,0,2,37,2005,Daja Bedanova
201530,2187.986353,1,0,0,1,9,2009,Gail Brodsky
201294,2187.985444,1,0,0,1,26,2001,Marion Bartoli
202391,2187.977227,1,0,0,1,38,2008,Akiko Yonemura
200699,2187.976699,3,1,0,2,51,1998,Meredith Mcgrath
205944,2187.974131,1,0,0,1,37,2013,Lidziya Marozava
201498,2187.970411,26,11,0,15,7,2008,Karin Knapp
212536,2187.967375,1,0,0,1,35,1997,Ingy El Taweel
202823,2187.967149,3,1,0,2,35,2004,Mariana Muci Torres
212253,2187.956246,3,1,0,2,40,2009,Celina Goetti
201469,2187.953603,3,1,0,2,18,2007,Melanie South
200752,2187.949439,1,0,0,1,62,2000,Raluca Sandu
200019,2187.949057,1,0,0,1,11,1990,Alexandra Fusai
201835,2187.948827,1,0,0,1,58,1995,Maja Muric
200031,2187.942153,16,7,0,9,3,2006,Meilen Tu
201540,2187.937446,1,0,0,1,22,2011,Kristina Mladenovic
202173,2187.937275,1,0,0,1,40,1998,Joana Cortez
200724,2187.93569,5,2,0,3,25,1999,Lea Ghirardi
202042,2187.934265,3,1,0,2,6,1995,Natalia Soetrisno
204045,2187.932968,3,1,0,2,37,1995,Talina Beiko
201463,2187.927337,3,1,0,2,21,2006,Anda Perianu
200666,2187.926558,13,6,0,7,12,1991,Marion Maruska
200060,2187.926096,1,0,0,1,51,2011,Tathiana Garbin
201946,2187.923073,1,0,0,1,50,1994,Jean Ceniza
200456,2187.921043,5,2,0,3,44,1993,Masako Yanagi
202024,2187.913826,1,0,0,1,44,1992,Barbara Navarro
200583,2187.911724,1,0,0,1,2,1994,Laxmi Poruri
201578,2187.909511,3,1,0,2,4,2015,Kai Chen Chang
200473,2187.906851,19,8,0,11,9,1993,Beverly Bowes Hackney
201210,2187.894857,1,0,0,1,16,2000,Kristen Schlukebir
201693,2187.879419,32,16,0,16,8,2012,Timea Babos
202152,2187.878572,1,0,0,1,21,2002,Jana Hlavackova
204241,2187.874302,1,0,0,1,27,2012,Fatyha Berjane
206897,2187.87119,3,1,0,2,28,1996,Monika Pimentel
200769,2187.863804,1,0,0,1,33,1996,Giulia Casoni
201671,2187.858967,1,0,0,1,19,2007,Ksenia Lykina
202194,2187.85246,1,0,0,1,6,1995,Anna Klim
202455,2187.838527,1,0,0,1,5,2011,Yue Yue Hu
201844,2187.829015,1,0,0,1,21,1994,Agnese Gustmane
200634,2187.821961,33,14,0,19,2,1991,Elena Brioukhovets
202016,2187.817071,1,0,0,1,3,1995,Pam Nelson
201390,2187.815549,1,0,0,1,22,2005,Mervana Jugic Salkic
206075,2187.811984,3,1,0,2,4,2014,Hiroko Kuwata
202031,2187.810915,1,0,0,1,62,2000,Rosa Maria Andres Rodriguez
201588,2187.803905,5,2,0,3,36,2006,Anna Tatishvili
201703,2187.789923,1,0,0,1,7,2007,Yi Fan Xu
200720,2187.779079,1,0,0,1,25,1994,Dally Randriantefy
200730,2187.774639,14,6,0,8,1,1995,Min Tang
201429,2187.770933,24,11,0,13,4,2005,Rika Fujiwara
212591,2187.756587,1,0,0,1,32,1997,Onalenna Leepile
201838,2187.753696,1,0,0,1,36,1991,Federica Fortuni
200747,2187.739508,1,0,0,1,10,2000,Haruka Inoue
200742,2187.737691,5,2,0,3,11,1997,Olga Lugina
201814,2187.731081,1,0,0,1,36,2000,Michelle Gerards
201354,2187.724778,3,1,0,2,16,2004,Libuse Prusova
201466,2187.721887,1,0,0,1,39,2003,Kaia Kanepi
201429,2187.708275,1,0,0,1,11,2000,Rika Fujiwara
201460,2187.707582,1,0,0,1,43,2009,Meng Yuan
200108,2187.702914,1,0,0,1,3,1997,Elena Dementieva
202085,2187.700918,1,0,0,1,9,2000,Galina Fokina
200070,2187.685031,3,1,0,2,25,2002,Anne Gaelle Sidot
202635,2187.681161,3,1,0,2,40,2009,Jin A Lee
201899,2187.675108,1,0,0,1,18,1993,Luciana Tella
201337,2187.670809,1,0,0,1,12,2002,Allison Baker
201725,2187.668934,1,0,0,1,13,1991,Zdenka Malkova
200701,2187.668656,1,0,0,1,55,1996,Caroline Vis
200016,2187.664287,18,8,0,10,10,1991,Sandrine Testud
201407,2187.657492,33,17,0,16,4,2005,Evgenia Linetskaya
201725,2187.655144,3,1,0,2,16,1992,Zdenka Malkova
204655,2187.655079,5,2,0,3,33,1997,Gulberk Gultekin
202493,2187.649807,1,0,0,1,15,2012,Ekaterine Gorgodze
202264,2187.649299,1,0,0,1,16,2005,Cory Ann Avants
202440,2187.644542,1,0,0,1,17,2011,Paula Ormaechea
201269,2187.641801,3,1,0,2,8,1992,Eleni Rossides
201396,2187.625224,1,0,0,1,22,2004,Katie Obrien
201483,2187.620098,3,1,0,2,8,2009,Madison Brengle
200008,2187.615961,31,17,0,14,3,2005,Alicia Molik
209119,2187.615715,3,1,0,2,31,2007,Claudine Paulson
201363,2187.613054,1,0,0,1,44,2000,Gisela Dulko
201422,2187.60796,1,0,0,1,22,2005,Mailyne Andrieux
212393,2187.599894,5,2,0,3,28,1996,Monica Aguero
201611,2187.599657,1,0,0,1,3,2010,Daria Gavrilova
202805,2187.59456,1,0,0,1,35,2003,Natalia Garbellotto
201387,2187.590263,1,0,0,1,16,2015,Sofia Arvidsson
201709,2187.590092,1,0,0,1,3,2010,Yulia Putintseva
212125,2187.587541,3,1,0,2,48,1992,Carol Cassar Torreggiani
202519,2187.586874,3,1,0,2,30,1999,Ouarda Bouchabou
210947,2187.586532,1,0,0,1,42,2012,Ferny Angeles Paz
202230,2187.584295,1,0,0,1,52,1993,Mami Donoshiro
201281,2187.583298,1,0,0,1,10,1999,Laura Granville
201662,2187.583258,1,0,0,1,16,2009,Karolina Pliskova
202700,2187.581224,5,2,0,3,31,2010,Simone Pratt
212569,2187.580562,3,1,0,2,52,2000,Corinne Ng Tung Hing
201437,2187.576889,1,0,0,1,3,2010,Ivana Lisjak
212250,2187.570171,3,1,0,2,25,2008,Elizabeth Tapia
212226,2187.568081,3,1,0,2,25,2008,Marisela Aviles
200101,2187.567354,17,7,0,10,4,1995,Jana Kandarr
201449,2187.567195,1,0,0,1,45,2006,Lauren Breadmore
212136,2187.567132,3,1,0,2,29,2001,Iulia Rozgon
206867,2187.566469,1,0,0,1,35,1997,Eleni Pilava Papanikolaou
202472,2187.564902,1,0,0,1,35,2013,Laura Thorpe
206064,2187.564116,1,0,0,1,26,2009,Cecilia Estlander
204553,2187.562631,5,2,0,3,34,1997,Ines Zouabi
200053,2187.555921,1,0,0,1,9,1991,Lubomira Bacheva
204498,2187.550012,1,0,0,1,38,1994,Shiri Burstein
200620,2187.548588,3,1,0,2,54,1996,Kirrily Sharpe
201950,2187.547795,3,1,0,2,43,1999,Miriam Dagostini
200387,2187.547304,3,1,0,2,38,1990,Anne White
200557,2187.547168,1,0,0,1,51,1998,Katrina Adams
212495,2187.547008,1,0,0,1,48,1992,Esra Bayburt
206458,2187.547008,3,1,0,2,47,1994,Maria Eugenia Fernandez
204081,2187.547008,1,0,0,1,57,1996,Sawitre Naree
207518,2187.547008,3,1,0,2,58,1996,Marisue Jacutin
212690,2187.547008,3,1,0,2,58,1996,Simone Wichman
206666,2187.547008,1,0,0,1,35,1998,Paula Umana
200753,2187.547008,1,0,0,1,61,1999,Cindy Watson
201380,2187.547008,1,0,0,1,37,1999,Claudine Schaul
212155,2187.547008,3,1,0,2,54,1999,Danielle Paynter
212165,2187.547008,3,1,0,2,54,1999,Anneliese Rose
212082,2187.547008,3,1,0,2,30,2001,Lisa Camenzuli
212196,2187.547008,3,1,0,2,31,2004,Alet Boonzaaier
205532,2187.547008,1,0,0,1,27,2005,Karoline Steiro
208882,2187.547008,1,0,0,1,27,2006,Liene Linina
209225,2187.547008,1,0,0,1,27,2006,Ieva Irbe
212212,2187.547008,3,1,0,2,28,2006,Olga Cosic
210132,2187.547008,1,0,0,1,28,2009,Maria Ines Deheza
212262,2187.547008,3,1,0,2,27,2009,Dayna Grazette
204329,2187.547008,3,1,0,2,32,2010,Kimberley Cassar
210880,2187.547008,1,0,0,1,44,2014,Borislava Botusharova
214615,2187.546491,3,1,0,2,44,2014,Khanh Phi Huynh
212081,2187.546342,3,1,0,2,26,1995,Helen Asciak
212771,2187.546223,1,0,0,1,53,1999,Nosheen Ehtesham
214627,2187.546222,3,1,0,2,43,2014,Jane Fennelly
201201,2187.546189,3,1,0,2,32,2007,Surina De Beer
209975,2187.546189,3,1,0,2,31,2007,Zulema Zelaya
209836,2187.545467,1,0,0,1,41,2012,Nikkita Fountain
207202,2187.544959,5,2,0,3,25,1995,Irena Mihailova
204542,2187.544897,5,2,0,3,43,1994,Ninfa Marra
212258,2187.542952,1,0,0,1,26,2009,Olga Zaicenco
200098,2187.539325,10,4,0,6,1,2005,Henrieta Nagyova
209331,2187.538291,3,1,0,2,27,2006,Julia Helbet
200005,2187.537742,5,2,0,3,6,1991,Jolene Watanabe Giltz
201378,2187.529534,1,0,0,1,4,2009,Stephanie Gehrlein
202024,2187.528368,1,0,0,1,0,1991,Barbara Navarro
207943,2187.528245,3,1,0,2,35,2004,Monica Hoz De Vila
212180,2187.528245,3,1,0,2,26,2005,Stephanie Pace
205604,2187.528245,3,1,0,2,28,2007,Andjela Kankaras
204275,2187.528245,3,1,0,2,39,2008,Zi Jun Yang
209975,2187.528245,3,1,0,2,25,2008,Zulema Zelaya
214637,2187.528245,3,1,0,2,31,2014,Kiana Marshall
212182,2187.528216,3,1,0,2,35,2004,Hazar Sidki
212176,2187.527544,1,0,0,1,31,2014,Andrea Brenes
203053,2187.527544,3,1,0,2,46,2000,Jin Young Choi
210740,2187.527393,3,1,0,2,40,2009,Stefanie Tan
212679,2187.526757,1,0,0,1,48,1993,Dyphany Wilkinson
212701,2187.526757,1,0,0,1,48,1996,Andrea Hoch
212224,2187.526757,1,0,0,1,27,1998,Sidonia Wolfinger
212126,2187.526757,1,0,0,1,30,2001,Tatevik Babayan
212188,2187.526757,1,0,0,1,35,2004,Yun Ling Ng
201381,2187.526757,1,0,0,1,39,2009,Tian Tian Sun
202490,2187.52611,1,0,0,1,16,2012,Rebecca Peterson
201665,2187.526035,3,1,0,2,26,2005,Ipek Senoglu
209573,2187.525971,3,1,0,2,27,2009,Fatima Zorah Bouabdallah
212104,2187.523161,1,0,0,1,27,2002,Tinesta Rowe
202300,2187.522768,3,1,0,2,30,2001,Meryem El Haddad
201512,2187.52276,15,6,0,9,7,2010,Monica Niculescu
206298,2187.522136,1,0,0,1,0,2012,Nidhi Chilumula
202289,2187.51771,1,0,0,1,7,2002,Jin Hee Kim
206575,2187.513127,3,1,0,2,30,1999,Galina Misiuriova
206456,2187.512973,1,0,0,1,37,2001,Virginia Sadi
201853,2187.512508,1,0,0,1,55,1992,Andrea Muller
202179,2187.510492,1,0,0,1,27,1990,Shelley Bartlett
201086,2187.509936,13,6,0,7,7,2007,Greta Arn
201610,2187.509892,6,2,0,4,3,2010,Zarina Diyas
207508,2187.509027,3,1,0,2,57,1996,Jil Lin Leong
203105,2187.50887,7,3,0,4,37,2003,I Ting Wang
201207,2187.508608,1,0,0,1,14,2001,Ansley Cargill
212187,2187.507286,1,0,0,1,35,2004,Pei Ling Tong
203521,2187.507114,3,1,0,2,43,2014,Andrea Gamiz
200448,2187.506583,1,0,0,1,2,1993,Sandy Collins
212505,2187.506561,1,0,0,1,27,1995,Lesley O&#39;Halloran
201293,2187.506561,1,0,0,1,37,1996,Catalina Castano
201862,2187.506561,1,0,0,1,37,1996,Vanessa Menga
207007,2187.506561,1,0,0,1,32,1999,Djamila Khaldi
202462,2187.506561,1,0,0,1,46,2010,Karen Castiblanco
201606,2187.506561,1,0,0,1,44,2013,Rebecca Marino
200626,2187.505689,1,0,0,1,39,1996,Emanuela Zardo
204978,2187.505204,1,0,0,1,53,2002,Hsiao Han Chao
202047,2187.502157,3,1,0,2,45,2001,Agustine Limanto
214641,2187.501258,3,1,0,2,31,2014,Ariana Rahmanparast
201584,2187.501141,8,3,0,5,3,2009,Ksenia Pervak
206354,2187.499993,1,0,0,1,24,2013,Lina Qostal
201573,2187.494866,1,0,0,1,2,2008,Laura Robson
202717,2187.492983,3,1,0,2,34,2003,Katarina Misic
203489,2187.488292,3,1,0,2,37,2013,Hao Chen Tang
200053,2187.487882,1,0,0,1,40,2003,Lubomira Bacheva
206903,2187.4875,3,1,0,2,27,1996,Glenny Cepeda
212782,2187.487259,1,0,0,1,35,1993,Isabela Martin
206900,2187.486482,1,0,0,1,36,2000,Daysi Espinal
204655,2187.486171,1,0,0,1,24,1991,Gulberk Gultekin
200047,2187.486059,1,0,0,1,11,1997,Pavlina Nola
203244,2187.485954,3,1,0,2,35,2003,Estefania Craciun
202181,2187.482567,3,1,0,2,52,1995,Lela Zainal
201575,2187.473715,1,0,0,1,14,2009,Hilary Barte
214614,2187.469859,1,0,0,1,44,2014,Sharon Pesch
212256,2187.469842,1,0,0,1,41,2009,Madona Najarian
201738,2187.468901,3,1,0,2,7,1990,Julia Apostoli
203091,2187.468167,3,1,0,2,9,1999,Yumiko Kitamura
204648,2187.468167,5,2,0,3,9,1999,Reiko Ino
201631,2187.467692,1,0,0,1,36,2015,Nicha Lertpitaksinchai
201801,2187.463674,1,0,0,1,39,1991,Ana Maria Segura Perez
201544,2187.459355,1,0,0,1,38,2009,Oxana Lyubtsova
200642,2187.45877,1,0,0,1,52,1993,Denisa Szabova
202521,2187.458545,1,0,0,1,15,2000,Neyssa Etienne
201039,2187.454707,1,0,0,1,18,1990,Caterina Nozzoli
202415,2187.450908,3,1,0,2,37,2012,Ximena Hermoso
212073,2187.449794,1,0,0,1,9,1998,Shizuko Matsuda
202255,2187.448138,1,0,0,1,7,1990,Jillian Muller
201312,2187.446008,1,0,0,1,49,1998,Sarah Taylor
201563,2187.436278,5,2,0,3,7,2010,Darya Kustova
200678,2187.434613,1,0,0,1,19,1995,Gloria Pizzichini
202466,2187.430926,1,0,0,1,37,2012,Nadia Abdala
201691,2187.430258,1,0,0,1,37,2015,Dia Evtimova
201189,2187.430102,1,0,0,1,30,1991,Sarah Bentley
202185,2187.423182,1,0,0,1,9,1996,Anna Bielen Zarska
201617,2187.42194,1,0,0,1,45,2011,Ana Vrljic
201471,2187.421855,1,0,0,1,18,2006,Naomi Cavaday
202111,2187.416695,1,0,0,1,37,1990,Mary Norwood
200073,2187.412627,5,2,0,3,24,1994,Julie Pullin
200039,2187.411608,25,10,0,15,1,1992,Chanda Rubin
207171,2187.409834,1,0,0,1,25,1998,Elena Petrenko
201370,2187.405407,5,2,0,3,1,2005,Anastasia Rodionova
202711,2187.398043,3,1,0,2,32,2000,Antoaneta Pandjerova
200709,2187.395286,1,0,0,1,16,2006,Rosana De Los Rios
213583,2187.390461,5,2,0,3,4,2014,Tatjana Maria
200087,2187.383094,1,0,0,1,20,2003,Seda Noorlander
201470,2187.379329,26,11,0,15,3,2010,Kristina Barrois
201860,2187.373689,9,4,0,5,6,1999,Mariam Ramon Climent
201882,2187.37215,3,1,0,2,48,1997,Katarzyna Straczy
213550,2187.370985,1,0,0,1,9,2015,Sofia Kenin
200578,2187.370705,23,10,0,13,13,1992,Rennae Stubbs
200765,2187.36918,1,0,0,1,18,2011,Katalin Marosi
200027,2187.367394,1,0,0,1,4,1996,Magui Serna
202338,2187.3668,1,0,0,1,12,2004,Elizabeth Kobak
201862,2187.364673,1,0,0,1,0,1991,Vanessa Menga
202320,2187.361452,1,0,0,1,3,2003,Sandra Klemenschits
202480,2187.361022,9,4,0,5,5,2013,Richel Hogenkamp
200099,2187.359879,1,0,0,1,5,2003,Sonya Jeyaseelan
201967,2187.359224,1,0,0,1,33,1993,Joana Manta
201317,2187.349394,1,0,0,1,50,2000,Aniko Kapros
200716,2187.347428,9,4,0,5,10,1998,Sung Hee Park
200720,2187.346489,37,17,0,20,6,2005,Dally Randriantefy
200768,2187.346247,3,1,0,2,26,2001,Laurence Andretto
201618,2187.342564,5,2,0,3,43,2011,Fatma Al Nabhani
200574,2187.34143,24,11,0,13,0,1990,Eva Sviglerova
201319,2187.339513,1,0,0,1,15,1997,Evelyn Fauth
200013,2187.333151,1,0,0,1,2,1999,Angelica Gavaldon
202286,2187.329218,3,1,0,2,37,2004,Elise Tamaela
200362,2187.321603,1,0,0,1,13,1992,Liz Smylie
202443,2187.321047,5,2,0,3,30,2013,Valeria Savinykh
200744,2187.320985,1,0,0,1,24,2002,Svetlana Krivencheva
201545,2187.313788,5,2,0,3,35,2013,Anastasija Sevastova
204605,2187.308824,3,1,0,2,38,1994,Joana Pedroso
201653,2187.301504,1,0,0,1,18,2011,Ellen Allgurin
201346,2187.301041,7,3,0,4,1,2002,Lubomira Kurhajcova
200054,2187.291996,1,0,0,1,31,1997,Sylvia Plischke
202027,2187.290345,1,0,0,1,24,1997,Elena Salvador Reja
202200,2187.289959,1,0,0,1,11,1991,Miki Mizokuchi
200550,2187.285565,1,0,0,1,11,1990,Emmanuelle Derly
202437,2187.285309,1,0,0,1,17,2012,Anastasia Grymalska
202361,2187.280778,3,1,0,2,17,2007,Erika Takao
202628,2187.277137,5,2,0,3,15,2015,Maryna Zanevska
211043,2187.271118,1,0,0,1,29,2015,Maria Paulina Perez Garcia
201523,2187.2526,36,16,0,20,3,2014,Marina Erakovic
202246,2187.249732,1,0,0,1,9,1996,Ines Heise
202336,2187.235904,1,0,0,1,16,2004,Magdalena Kiszczynska
201510,2187.234486,1,0,0,1,37,2010,Julie Ditty
201194,2187.229294,1,0,0,1,30,1990,Tammy Whittington
201638,2187.22926,21,9,0,12,6,2013,Estrella Cabeza Candela
200520,2187.224683,26,12,0,14,4,1990,Sarah Loosemore
203504,2187.219581,1,0,0,1,4,2015,Miyu Kato
201709,2187.196797,3,1,0,2,17,2012,Yulia Putintseva
201676,2187.190821,1,0,0,1,6,2006,Ye Ra Lee
200728,2187.186679,9,4,0,5,12,1995,Melanie Schnell
202482,2187.186609,3,1,0,2,4,2015,Barbara Haas
203110,2187.183118,1,0,0,1,52,2002,Mi Ok Kim
202090,2187.182372,1,0,0,1,9,1994,Emily Bond
201398,2187.178983,1,0,0,1,21,2003,Amanda Keen
200521,2187.17245,1,0,0,1,38,1991,Hellas Ter Riet
202135,2187.170447,1,0,0,1,36,2006,Vanessa Henke
202475,2187.169434,1,0,0,1,14,2013,Jasmina Tinjic
202437,2187.166424,1,0,0,1,25,2014,Anastasia Grymalska
200747,2187.160615,1,0,0,1,47,1999,Haruka Inoue
201043,2187.153637,1,0,0,1,18,1993,Barbara Romano
202275,2187.152435,1,0,0,1,13,2001,Tagifano Soonalole
200689,2187.150509,1,0,0,1,26,1992,Tessa Price
202074,2187.148262,1,0,0,1,58,1992,Katharina Buche
201390,2187.145446,1,0,0,1,35,2013,Mervana Jugic Salkic
201362,2187.145018,1,0,0,1,23,2003,Anais Laurendon
201321,2187.142561,1,0,0,1,16,1996,Antonella Serra Zanetti
212161,2187.142281,5,2,0,3,27,2002,Saira Sanchinelli
215042,2187.138405,1,0,0,1,19,2015,Katie Swan
201383,2187.132813,1,0,0,1,31,2009,Marie Eve Pelletier
211289,2187.131464,1,0,0,1,34,2013,Courtney Collins
202341,2187.130738,1,0,0,1,30,2005,Melanie Gloria
201619,2187.129959,3,1,0,2,9,2011,Madison Keys
200066,2187.125724,1,0,0,1,50,2004,Cristina Torrens Valero
201838,2187.123265,3,1,0,2,24,1995,Federica Fortuni
202293,2187.120218,1,0,0,1,6,2006,Jie Hao
204600,2187.119919,1,0,0,1,49,1997,Monika Starosta
201632,2187.107388,1,0,0,1,4,2006,Ryoko Fuda
201434,2187.105948,1,0,0,1,21,2002,Sabine Klaschka
200013,2187.105578,1,0,0,1,60,1998,Angelica Gavaldon
202374,2187.10509,1,0,0,1,22,2007,Nicole Kriz
200073,2187.105026,1,0,0,1,20,2003,Julie Pullin
202984,2187.097815,1,0,0,1,52,2002,Yang Jin Chung
201642,2187.097553,1,0,0,1,24,2013,Fatima El Allami
202379,2187.096056,1,0,0,1,16,2007,Chieh Yu Hsu
200491,2187.092185,1,0,0,1,63,1997,Christina Singer
201427,2187.090999,3,1,0,2,21,2006,Alize Cornet
201200,2187.086614,1,0,0,1,16,2000,Miriam Schnitzer
201679,2187.086532,1,0,0,1,44,2010,Varatchaya Wongteanchai
202556,2187.086252,1,0,0,1,17,2007,Ana Jovanovic
202879,2187.084886,1,0,0,1,44,2014,Tiffany Cornelius
200617,2187.08443,1,0,0,1,5,2008,Kimiko Date Krumm
212082,2187.083619,3,1,0,2,26,1995,Lisa Camenzuli
202600,2187.08224,1,0,0,1,44,2014,Viktoriya Tomova
204543,2187.082019,3,1,0,2,41,1997,Mariela Salinas
200620,2187.081268,5,2,0,3,52,1991,Kirrily Sharpe
202035,2187.080939,1,0,0,1,1,1992,Holyn Lord
201066,2187.076423,1,0,0,1,12,1990,Neus Avila Bonastre
203365,2187.075368,1,0,0,1,16,2011,Mailen Auroux
203453,2187.075368,1,0,0,1,16,2011,Aranza Salut
202268,2187.074707,1,0,0,1,5,2001,Montinee Tangphong
202778,2187.070194,1,0,0,1,37,2003,Nana Urotadze
201334,2187.067867,18,8,0,10,5,2005,Zuzana Ondraskova
201313,2187.066705,1,0,0,1,10,2007,Yoon Jeong Cho
201069,2187.066273,1,0,0,1,15,1998,Karolina Jagieniak
201380,2187.066128,3,1,0,2,41,2012,Claudine Schaul
202300,2187.065758,1,0,0,1,21,2002,Meryem El Haddad
208093,2187.062547,3,1,0,2,36,2004,Chandra Capozzi
201621,2187.060458,48,25,0,23,2,2013,Mona Barthel
205143,2187.060291,1,0,0,1,40,1998,Valentina Castro
202290,2187.057388,1,0,0,1,6,2005,Kyung Mi Chang
200620,2187.057065,1,0,0,1,24,1995,Kirrily Sharpe
212197,2187.051414,5,2,0,3,26,2006,Elrien De Villiers
201447,2187.048187,1,0,0,1,9,2015,Vania King
202380,2187.047329,1,0,0,1,16,2007,Silvia Disderi
203059,2187.046379,5,2,0,3,40,1998,Alice Pirsu
212359,2187.044634,1,0,0,1,47,1995,Tari Ann Toro
212724,2187.044634,1,0,0,1,54,1999,Pei Yuin Keng
202348,2187.044634,1,0,0,1,52,2000,Lina Stanciute
203584,2187.044634,1,0,0,1,44,2012,Adriana Perez
202166,2187.044604,3,1,0,2,37,1996,Emilie Viqueira
210134,2187.043844,1,0,0,1,42,2012,Natalia Davila
212401,2187.043818,3,1,0,2,26,1998,Angelika Schadler
201591,2187.043086,3,1,0,2,38,1999,Margalita Chakhnashvili
206240,2187.043027,3,1,0,2,38,2013,Patricia Ku Flores
212194,2187.042962,3,1,0,2,26,2005,Laone Botshoma
203046,2187.042752,1,0,0,1,45,1999,Graciela Velez
214617,2187.042236,3,1,0,2,44,2014,Nethmi Himashi Waduge
201733,2187.042072,1,0,0,1,12,1990,Lorenza Jachia
201948,2187.04094,1,0,0,1,3,1993,Vicky Maes
201879,2187.040705,1,0,0,1,33,1996,Reka Vidats
201076,2187.035122,1,0,0,1,27,2001,Sophie Georges
200043,2187.033418,1,0,0,1,25,1999,Virginie Razzano
212390,2187.032588,5,2,0,3,25,1997,Florea De Maria Urrea
201752,2187.029801,1,0,0,1,28,1991,Cristina Salvi
202464,2187.027514,1,0,0,1,25,2008,Yuliana Lizarazo
211701,2187.027313,10,4,0,6,3,2014,Katerina Siniakova
201367,2187.026659,3,1,0,2,19,2008,Arantxa Parra Santonja
200452,2187.026329,1,0,0,1,21,1994,Tine Scheuer Larsen
208244,2187.025838,1,0,0,1,32,2005,Celina Grissi
204643,2187.025084,5,2,0,3,52,1999,Aniela Mojzis
206529,2187.025052,3,1,0,2,38,1999,Hanna Katri Aalto
200603,2187.024294,1,0,0,1,41,1990,Justine Hodder
200577,2187.024294,1,0,0,1,53,1991,Louise Stacey
206780,2187.024294,1,0,0,1,24,1991,Li Hua Yang
200287,2187.024294,1,0,0,1,61,1992,Miki Yokobori
204969,2187.024294,1,0,0,1,49,1992,Edita Liachoviciute
212609,2187.024294,1,0,0,1,42,1992,Rosanna Valerio
206447,2187.024294,3,1,0,2,46,1993,Ingrid Gonzalez
212516,2187.024294,1,0,0,1,37,1993,Kaja Kond
212682,2187.024294,1,0,0,1,49,1993,Brenda Rojas
212144,2187.024294,3,1,0,2,58,1996,Alissa Velts
212711,2187.024294,1,0,0,1,49,1996,Leloba Seitshiro
200469,2187.024294,3,1,0,2,66,1997,Nicole Bradtke
204914,2187.024294,1,0,0,1,59,1997,Yan Chen
206917,2187.024294,1,0,0,1,43,1997,Alexandra Guzman
212423,2187.024294,1,0,0,1,33,1997,Evelyne Gmeiner
212557,2187.024294,1,0,0,1,26,1997,Maria Fernanda Carrillo
212762,2187.024294,1,0,0,1,59,1997,Vera Tere
202273,2187.024294,1,0,0,1,43,1998,Liga Dekmeijere
207456,2187.024294,3,1,0,2,45,1998,Kate Lutgert
203969,2187.024294,1,0,0,1,33,1999,Yomna Farid
204451,2187.024294,1,0,0,1,39,1999,Asimina Kaplani
206505,2187.024294,1,0,0,1,39,1999,Kirsi Lampinen
206911,2187.024294,3,1,0,2,53,1999,Carla Prieto
212093,2187.024294,1,0,0,1,55,1999,Yik Hui Leow
212109,2187.024294,1,0,0,1,54,1999,Francine Harvey
201289,2187.024294,3,1,0,2,58,2001,Christina Wheeler
204580,2187.024294,1,0,0,1,39,2001,Biljana Dimovska
206913,2187.024294,3,1,0,2,39,2001,Paola Guerrero
207560,2187.024294,1,0,0,1,47,2001,Prariyawan Ratanakrong
212132,2187.024294,1,0,0,1,32,2001,Liako Selokoma
202217,2187.024294,1,0,0,1,53,2002,Kamila Dadakhodjaeva
200034,2187.024294,1,0,0,1,52,2003,Amanda Grahame
201415,2187.024294,1,0,0,1,52,2003,Tiffany Welford
203002,2187.024294,5,2,0,3,36,2003,Karin Palme
208272,2187.024294,1,0,0,1,35,2003,Elsa Serrano Eduards
209169,2187.024294,1,0,0,1,38,2004,Camila Belassi
212191,2187.024294,1,0,0,1,37,2004,Veronika Babayan
202333,2187.024294,1,0,0,1,43,2005,Delia Sescioreanu
212130,2187.024294,3,1,0,2,26,2005,Evelyn Otula
212193,2187.024294,3,1,0,2,26,2005,Wanjika Ngaruiya
212188,2187.024294,1,0,0,1,31,2006,Yun Ling Ng
208323,2187.024294,1,0,0,1,33,2007,Anett Kaasik
202467,2187.024294,1,0,0,1,39,2008,Elitsa Kostova
209391,2187.024294,1,0,0,1,26,2008,Gisella Pere
209988,2187.024294,1,0,0,1,28,2008,Tatevik Yedigaryan
204970,2187.024294,1,0,0,1,47,2010,Karina Ildor Jacobsgaard
208277,2187.024294,1,0,0,1,47,2010,Lumay Diaz Hernandez
212262,2187.024294,1,0,0,1,32,2010,Dayna Grazette
202424,2187.024294,1,0,0,1,21,2011,Conny Perrin
202493,2187.024294,1,0,0,1,32,2011,Ekaterine Gorgodze
202786,2187.024294,1,0,0,1,32,2011,Aurelija Miseviciute
205761,2187.024294,1,0,0,1,29,2012,Johanna Hyoty
212312,2187.024294,1,0,0,1,30,2012,Juli Raventos
213019,2187.024294,1,0,0,1,37,2013,Tina Rupert
204391,2187.024294,1,0,0,1,28,2014,Sofia Kvatsabaia
209331,2187.024294,1,0,0,1,44,2014,Julia Helbet
214616,2187.024294,1,0,0,1,45,2014,Medhira Samarasinghe
214640,2187.024294,3,1,0,2,31,2014,Tyler Smith
200518,2187.023583,1,0,0,1,27,1990,Paulette Moreno
206908,2187.022715,1,0,0,1,28,2002,Diana Espinal
212732,2187.022715,3,1,0,2,58,1996,Yun Ning Fu
207508,2187.022656,3,1,0,2,53,1998,Jil Lin Leong
212465,2187.021957,1,0,0,1,36,2000,Edna Vasquez
203969,2187.020655,3,1,0,2,44,2002,Yomna Farid
212563,2187.017703,1,0,0,1,25,1997,Milena Leiva
201323,2187.016105,1,0,0,1,47,1999,Saori Obata
201642,2187.013183,1,0,0,1,23,2007,Fatima El Allami
202346,2187.010466,1,0,0,1,38,2005,Jewel Peterson
212149,2187.008155,1,0,0,1,33,1997,Jeannine Niedhardt
201563,2187.007162,1,0,0,1,41,2012,Darya Kustova
205158,2187.006984,3,1,0,2,26,2006,Rachael Dillon
202785,2187.006066,3,1,0,2,32,2006,Dimana Krastevitch
201964,2187.003951,3,1,0,2,48,1992,Tania Couto
200679,2187.003951,1,0,0,1,61,1995,Caroline Kuhlman
200004,2187.003951,1,0,0,1,65,2000,Kerry Anne Guse
212189,2187.003951,1,0,0,1,36,2004,Nivin Kezbari
202823,2187.003951,1,0,0,1,26,2008,Mariana Muci Torres
202664,2187.00395,3,1,0,2,42,2012,Roxane Vaisemberg
202012,2187.003922,3,1,0,2,53,1999,Lee Chan
207001,2187.003922,3,1,0,2,54,1999,Claudia Argumedo
212110,2187.003922,3,1,0,2,54,1999,Niki Williams
212710,2187.003922,3,1,0,2,54,1999,Camille Sesanker
206583,2187.003922,3,1,0,2,28,2001,Monica Poveda
200124,2187.003922,3,1,0,2,51,2003,Anne Kremer
208828,2187.003922,3,1,0,2,37,2004,Andrea Giraldo
208093,2187.003922,3,1,0,2,31,2005,Chandra Capozzi
210078,2187.003809,3,1,0,2,26,2006,Olfa Dhaoui
212126,2187.003196,1,0,0,1,30,1999,Tatevik Babayan
201284,2187.003185,1,0,0,1,9,1995,Tatiana Poutchek
210884,2187.002497,1,0,0,1,28,2012,Melisa Martinov
202778,2187.001975,1,0,0,1,38,2002,Nana Urotadze
203250,2186.999775,1,0,0,1,31,2007,Lynn Philippe
202476,2186.998097,1,0,0,1,25,2012,Csilla Borsanyi
212093,2186.99795,3,1,0,2,45,2001,Yik Hui Leow
201504,2186.995542,33,15,0,18,3,2014,Julia Goerges
201808,2186.992497,1,0,0,1,57,1994,Hiroko Hara
201844,2186.991923,1,0,0,1,8,1990,Agnese Gustmane
204323,2186.989673,1,0,0,1,39,2009,Zsofia Susanyi
204800,2186.986893,3,1,0,2,39,1996,Sofia Managadze
201186,2186.986509,1,0,0,1,30,1991,Virginia Humphreys Davies
212291,2186.984341,3,1,0,2,44,2014,Geraldine Ang
203469,2186.984341,3,1,0,2,39,2009,Albina Khabibulina
202364,2186.98382,1,0,0,1,47,2010,Sandy Gumulya
212596,2186.9837,1,0,0,1,45,1994,Lori Feingold
204488,2186.983668,1,0,0,1,44,1994,Elena Juricich
212198,2186.983668,1,0,0,1,30,2004,Selima Frioui
202463,2186.983668,1,0,0,1,35,2013,Ines Ferrer Suarez
200657,2186.983607,1,0,0,1,61,1999,Radka Bobkova
200105,2186.983607,1,0,0,1,51,2003,Rachel Mcquillan
204553,2186.98355,3,1,0,2,31,2004,Ines Zouabi
201752,2186.983548,1,0,0,1,26,1993,Cristina Salvi
200045,2186.983519,3,1,0,2,10,2002,Tara Snyder
207828,2186.982376,3,1,0,2,27,1995,Paula Iversen
211701,2186.969714,1,0,0,1,31,2013,Katerina Siniakova
202123,2186.969523,1,0,0,1,53,1999,Suvimol Duangchan
212155,2186.966368,5,2,0,3,36,2000,Danielle Paynter
203058,2186.966165,3,1,0,2,8,1996,Yoshiko Sasano
204732,2186.966165,3,1,0,2,8,1996,Yasuko Nishimata
201694,2186.964959,1,0,0,1,46,2011,Silvia Njiric
200543,2186.964831,1,0,0,1,30,1991,Jill Hetherington
204336,2186.964703,1,0,0,1,27,2012,Cecilie Lundgaard Melsted
200722,2186.964053,1,0,0,1,36,1994,Francesca Lubiani
202266,2186.962453,3,1,0,2,37,2003,Kelly Liggan
201810,2186.957646,1,0,0,1,10,1995,Yuko Hosoki
200554,2186.956373,1,0,0,1,33,2005,Brenda Schultz Mccarthy
212497,2186.945294,3,1,0,2,31,1999,Susanna Bostanjyan
201296,2186.942974,1,0,0,1,47,2003,Bianka Lamade
212233,2186.941757,1,0,0,1,31,2014,Shenelle Mohammed
200742,2186.936516,3,1,0,2,36,1993,Olga Lugina
201613,2186.932143,1,0,0,1,7,2009,Arina Rodionova
200718,2186.93206,3,1,0,2,10,1998,Ludmila Richterova
201191,2186.929557,5,2,0,3,24,1994,Shirli Ann Siddall
201501,2186.929277,37,15,0,22,2,2012,Olga Govortsova
200634,2186.928141,1,0,0,1,63,1997,Elena Brioukhovets
212171,2186.927158,3,1,0,2,36,1995,Francesca La&#39;O
212214,2186.926501,3,1,0,2,32,2006,Johanna De Leon
201370,2186.924986,1,0,0,1,47,2004,Anastasia Rodionova
202265,2186.924164,1,0,0,1,11,2002,Mirielle Dittmann
201079,2186.908926,1,0,0,1,22,2002,Hannah Collin
202355,2186.906588,1,0,0,1,39,2007,Sanja Ancic
201409,2186.906274,1,0,0,1,59,1999,Michaela Pastikova
201210,2186.901442,1,0,0,1,34,2004,Kristen Schlukebir
212178,2186.898988,3,1,0,2,32,2006,Ashley Brooks
204638,2186.894432,1,0,0,1,32,2005,Valeria Bondarenko
201088,2186.892212,3,1,0,2,24,2000,Karen Cross
202669,2186.887955,1,0,0,1,16,2015,Cristina Dinu
200576,2186.887347,13,5,0,8,17,1993,Nathalie Herreman
202329,2186.886386,3,1,0,2,40,1995,Jessica Fernandez
205591,2186.87906,3,1,0,2,14,2015,Paula Cristina Goncalves
201754,2186.879014,3,1,0,2,38,2003,Leanne Baker
202439,2186.869938,1,0,0,1,17,2011,Silvia Albano
201275,2186.859896,1,0,0,1,11,1992,Julie Steven
201546,2186.85848,1,0,0,1,7,2007,Anna Lapushchenkova
201958,2186.846083,1,0,0,1,39,2002,Angela Cardoso
202026,2186.837502,1,0,0,1,23,1996,Noelia Serra Djamdjean
202644,2186.835071,1,0,0,1,2,2012,Ting Fei Juan
200733,2186.835064,1,0,0,1,9,2006,Trudi Musgrave
202383,2186.83308,1,0,0,1,15,2007,Eva Maria Hoch
201610,2186.832334,5,2,0,3,2,2012,Zarina Diyas
200545,2186.83045,1,0,0,1,30,1993,Ei Iida
202153,2186.827147,1,0,0,1,12,2001,Melanie Marois
201661,2186.818658,1,0,0,1,3,2003,Tina Schiechtl
202297,2186.814417,1,0,0,1,21,2002,Maria Kondratieva
200494,2186.81012,1,0,0,1,5,1992,Dianne Van Rensburg
202025,2186.807757,1,0,0,1,32,1995,Rosa Maria Perez
201815,2186.796086,3,1,0,2,23,2000,Petra Rampre
201353,2186.791263,1,0,0,1,5,2002,Stanislava Hrozenska
201643,2186.790252,3,1,0,2,24,2009,Eva Fernandez Brugues
201319,2186.789215,1,0,0,1,15,1994,Evelyn Fauth
200484,2186.788202,1,0,0,1,42,1993,Ann Devries
201469,2186.785749,1,0,0,1,21,2011,Melanie South
201701,2186.785391,1,0,0,1,14,2010,Basak Eraydin
202447,2186.783889,1,0,0,1,14,2011,Alexandra Mueller
202454,2186.782047,1,0,0,1,4,2014,Erika Sema
201938,2186.770802,1,0,0,1,6,1999,Ainhoa Goni Blanco
201322,2186.767434,7,3,0,4,5,2001,Eva Dyrberg
201417,2186.763527,3,1,0,2,15,2012,Marta Domachowska
201309,2186.757428,27,11,0,16,8,2004,Tatiana Perebiynis
200666,2186.75603,1,0,0,1,14,1996,Marion Maruska
202375,2186.754474,1,0,0,1,22,2007,Emilie Bacquet
201428,2186.754286,21,10,0,11,4,2011,Mathilde Johansson
201846,2186.752477,1,0,0,1,9,1996,Katarzyna Teodorowicz Lisowska
202332,2186.748994,1,0,0,1,34,2004,Dominika Nociarova
201627,2186.748571,1,0,0,1,36,1994,Kim De Weille
201503,2186.743773,7,3,0,4,30,2014,Ayumi Morita
202419,2186.741974,1,0,0,1,25,2012,Barbara Luz
203414,2186.731492,1,0,0,1,7,2015,Nicole Melichar
201428,2186.731034,1,0,0,1,21,2015,Mathilde Johansson
212387,2186.725728,3,1,0,2,30,1999,Tanya Volkova
201592,2186.724713,3,1,0,2,33,2013,Beatriz Garcia Vidagany
213021,2186.723316,3,1,0,2,44,2014,Alyssa Boey
201805,2186.712976,1,0,0,1,10,1990,Pilar Perez
201305,2186.703549,1,0,0,1,15,2000,Eleni Daniilidou
200040,2186.703547,1,0,0,1,10,1991,Anna Smashnova
212396,2186.702844,3,1,0,2,36,1993,Helene Holter
202135,2186.699544,1,0,0,1,48,2003,Vanessa Henke
202259,2186.699306,1,0,0,1,27,2001,Valentina Sassi
202156,2186.69906,1,0,0,1,16,1992,Gabriella Boschiero
202340,2186.694212,1,0,0,1,37,2008,Caroline Maes
201377,2186.693715,1,0,0,1,30,2008,Yuliya Beygelzimer
201413,2186.689063,1,0,0,1,8,2004,Capucine Rousseau
201653,2186.685681,1,0,0,1,17,2010,Ellen Allgurin
202158,2186.682645,1,0,0,1,35,1992,Cristina Cavina
201498,2186.67513,7,3,0,4,6,2006,Karin Knapp
202401,2186.668567,1,0,0,1,19,2008,Amanda Elliott
202386,2186.668288,1,0,0,1,6,2008,Sung Hee Han
202149,2186.66504,1,0,0,1,26,1993,Eva Krejcova
202259,2186.664984,1,0,0,1,41,2006,Valentina Sassi
202117,2186.663493,1,0,0,1,20,1999,Maria Paola Zavagli
201852,2186.662968,1,0,0,1,21,1996,Paula Hermida Velo
201478,2186.662884,1,0,0,1,25,2001,Varvara Lepchenko
202261,2186.660285,5,2,0,3,19,2002,Joanna Sakowicz Kostecka
200770,2186.657596,1,0,0,1,45,2011,Stephanie Cohen Aloro
200504,2186.657071,1,0,0,1,18,1993,Julie Salmon
201317,2186.656956,1,0,0,1,6,2006,Aniko Kapros
202360,2186.653833,1,0,0,1,19,2006,Marrit Boonstra
202389,2186.649355,3,1,0,2,39,2009,Sandra Martinovic
201304,2186.64663,8,3,0,5,5,2007,Elena Baltacha
200448,2186.644469,3,1,0,2,8,1992,Sandy Collins
200764,2186.643168,8,3,0,5,5,2000,Elena Bovina
201666,2186.640792,3,1,0,2,14,2009,Cagla Buyukakcay
201469,2186.637649,1,0,0,1,18,2013,Melanie South
201645,2186.635404,3,1,0,2,37,2002,Frederica Piedade
201617,2186.633864,1,0,0,1,7,2005,Ana Vrljic
202586,2186.633186,3,1,0,2,39,2008,Kelly Anderson
202329,2186.632826,1,0,0,1,45,2004,Jessica Fernandez
202500,2186.630921,1,0,0,1,20,2015,Maria Sanchez
201728,2186.628194,1,0,0,1,58,2000,Jessica Steck
200549,2186.627043,1,0,0,1,30,1990,Penny Barg Mager
200118,2186.625469,24,11,0,13,3,1995,Virginia Ruano Pascual
214123,2186.624819,1,0,0,1,25,2015,Kristina Schmiedlova
202180,2186.62313,1,0,0,1,27,1990,Jana Strnadova
202472,2186.6186,1,0,0,1,33,2012,Laura Thorpe
212107,2186.61734,3,1,0,2,28,2001,Tenille Elias
202957,2186.617,1,0,0,1,9,1999,Madoka Kuki
204420,2186.616597,1,0,0,1,34,2015,Marcela Zacarias
204318,2186.616153,1,0,0,1,38,2013,Margarida Moura
201942,2186.612763,3,1,0,2,57,2002,Andreea Ehritt Vanc
201647,2186.612161,1,0,0,1,22,2009,Jasmin Woehr
201939,2186.611192,1,0,0,1,34,1996,Anique Snijders
201393,2186.608228,1,0,0,1,42,2005,Kelly Mccain
202536,2186.607043,3,1,0,2,4,2014,Ana Bogdan
200686,2186.604805,1,0,0,1,40,1999,Sandra Dopfer
200587,2186.602672,1,0,0,1,17,1997,Silke Meier
202134,2186.602616,1,0,0,1,47,1999,Katie Schlukebir
212390,2186.598433,5,2,0,3,28,1996,Florea De Maria Urrea
201472,2186.598421,3,1,0,2,36,2015,Romina Oprandi
201373,2186.594643,17,8,0,9,11,2004,Maria Kirilenko
202012,2186.593863,3,1,0,2,58,1996,Lee Chan
201401,2186.592279,1,0,0,1,8,2003,Abigail Spears
201813,2186.586911,1,0,0,1,36,2000,Patty Van Acker
200665,2186.586261,1,0,0,1,41,1991,Yone Kamio
203816,2186.58266,3,1,0,2,34,1993,Siobhan Nicholson
200087,2186.581829,1,0,0,1,56,1994,Seda Noorlander
212081,2186.580129,1,0,0,1,41,1994,Helen Asciak
201489,2186.579819,3,1,0,2,5,2006,Mariya Koryttseva
212252,2186.578071,3,1,0,2,33,2010,Lee Anne Lingo
201334,2186.576604,1,0,0,1,17,2008,Zuzana Ondraskova
202099,2186.575668,3,1,0,2,6,1995,Louise Pleming
200091,2186.57413,1,0,0,1,6,2005,Janet Lee
212230,2186.572933,5,2,0,3,31,2010,Olivia Bennett
200693,2186.571919,1,0,0,1,8,1990,Elena Makarova
202173,2186.570667,3,1,0,2,6,1999,Joana Cortez
201075,2186.567886,1,0,0,1,3,1996,Liezel Huber
201657,2186.563703,1,0,0,1,29,2015,Nastja Kolar
201319,2186.562711,1,0,0,1,6,2000,Evelyn Fauth
201510,2186.561909,1,0,0,1,41,2005,Julie Ditty
201385,2186.560807,12,5,0,7,3,2004,Yuliana Fedak
202321,2186.56001,3,1,0,2,44,2001,Napaporn Tongsalee
207696,2186.558536,1,0,0,1,44,2002,Imen Ben Larbi
201632,2186.557521,1,0,0,1,14,2011,Ryoko Fuda
200647,2186.557476,1,0,0,1,58,1999,Noelle Van Lottum
202290,2186.555704,1,0,0,1,39,2004,Kyung Mi Chang
201472,2186.55488,1,0,0,1,16,2005,Romina Oprandi
201651,2186.552083,1,0,0,1,17,2009,Michaela Johansson
201810,2186.547547,3,1,0,2,50,1997,Yuko Hosoki
212582,2186.54307,1,0,0,1,32,1999,Ntswaki Mawela
208983,2186.543052,1,0,0,1,44,2012,Larikah Russell
202267,2186.543035,1,0,0,1,12,2001,Diana Srebrovic
201672,2186.541618,1,0,0,1,5,2008,Nigina Abduraimova
212516,2186.540702,3,1,0,2,48,1992,Kaja Kond
212443,2186.540683,1,0,0,1,33,1992,Ku Maizan Shak
206621,2186.540683,1,0,0,1,48,1996,Kelesitse Makgale
200008,2186.540683,5,2,0,3,62,1997,Alicia Molik
208067,2186.540683,1,0,0,1,28,2009,Assia Halo
201423,2186.540683,1,0,0,1,38,2015,Yvonne Meusburger
203969,2186.540428,3,1,0,2,54,2000,Yomna Farid
212547,2186.539635,3,1,0,2,46,1993,Melissa Golfin
202382,2186.539155,1,0,0,1,12,2007,Ekaterina Shulaeva
201656,2186.539127,1,0,0,1,31,2007,Tadeja Majeric
203382,2186.538871,5,2,0,3,26,2006,Elina Gasanova
201423,2186.535397,6,2,0,4,1,2004,Yvonne Meusburger
200627,2186.533233,1,0,0,1,15,1997,Petra Schwarz
200011,2186.532934,21,9,0,12,9,2001,Katarina Srebotnik
212495,2186.53023,1,0,0,1,38,1994,Esra Bayburt
201882,2186.527148,1,0,0,1,40,2001,Katarzyna Straczy
200240,2186.525235,1,0,0,1,28,1991,Eugenia Birioukova
202705,2186.525142,7,3,0,4,8,2014,Veronica Cepede Royg
204591,2186.521759,1,0,0,1,36,2003,Elsa Oriain
201684,2186.521048,1,0,0,1,43,2010,Paula Zabala
201680,2186.520963,3,1,0,2,32,2007,Anna Gerasimou
206862,2186.520847,3,1,0,2,25,1998,Daphne Nicolatou
212683,2186.520579,1,0,0,1,49,1993,Lily Aguirre
212138,2186.520372,3,1,0,2,54,2000,Mariem Nissaf Bouchlaka
202549,2186.520372,1,0,0,1,30,2006,Erika Clarke Magana
201322,2186.520372,1,0,0,1,32,2007,Eva Dyrberg
202416,2186.520372,1,0,0,1,34,2007,Nungnadda Wannasuk
210163,2186.520372,1,0,0,1,25,2011,Cecilia Mercier
205831,2186.520372,1,0,0,1,43,2012,Isabella Robbiani
214622,2186.520372,1,0,0,1,44,2014,Ani Safaryan
200662,2186.520372,3,1,0,2,63,1992,Joanne Limmer
212099,2186.520341,1,0,0,1,44,2001,Sonya Kumar
212346,2186.520186,3,1,0,2,41,1992,Sandra Kellemberger
206286,2186.518793,1,0,0,1,27,2012,Nune Khachatryan
212171,2186.518735,1,0,0,1,41,1993,Francesca La&#39;O
201520,2186.512733,1,0,0,1,14,2007,Petra Kvitova
200450,2186.5123,30,13,0,17,2,1990,Larisa Savchenko
204673,2186.512256,1,0,0,1,20,2001,Daniela Casanova
212081,2186.506303,3,1,0,2,36,1993,Helen Asciak
208260,2186.505973,1,0,0,1,40,2009,Dijana Stojic
201589,2186.502619,1,0,0,1,8,2015,Sharon Fichman
201454,2186.502466,3,1,0,2,25,2001,Akgul Amanmuradova
210580,2186.501593,3,1,0,2,24,2011,Alejandra Alvarez
210271,2186.50079,1,0,0,1,46,2010,Anita Husaric
209033,2186.50079,3,1,0,2,27,2009,Paulina Schippers
212123,2186.500788,1,0,0,1,29,2001,Ignacia Marin
212100,2186.500761,1,0,0,1,44,2001,Tina Jacob
200039,2186.5,1,0,0,1,13,1990,Chanda Rubin
200523,2186.5,1,0,0,1,12,1990,Olga Tsarbopoulou
200577,2186.5,1,0,0,1,41,1990,Louise Stacey
200580,2186.5,1,0,0,1,41,1990,Kimberly Kessaris
200643,2186.5,1,0,0,1,18,1990,Petra Kamstra
200710,2186.5,1,0,0,1,16,1990,Magdalena Feistel
200468,2186.5,1,0,0,1,46,1991,Hu Na
200563,2186.5,1,0,0,1,23,1991,Jane Taylor
200625,2186.5,1,0,0,1,53,1991,Jana Pospisilova
200637,2186.5,1,0,0,1,53,1991,Catherine Barclay
201050,2186.5,1,0,0,1,39,1991,Immaculada Varas Caro
201271,2186.5,1,0,0,1,48,1991,Lisa Green
201279,2186.5,1,0,0,1,46,1991,Keri Phebus
201773,2186.5,1,0,0,1,48,1991,Diedre Herman
201802,2186.5,1,0,0,1,55,1991,Ulrike Priller
201992,2186.5,1,0,0,1,49,1991,Sabine Lohmann
207166,2186.5,3,1,0,2,24,1991,Ismet Duygu Aksit Oal
212500,2186.5,1,0,0,1,26,1991,Aradhana Reddy
212596,2186.5,1,0,0,1,27,1991,Lori Feingold
200702,2186.5,1,0,0,1,59,1992,Naoko Kijimuta
212081,2186.5,3,1,0,2,48,1992,Helen Asciak
212160,2186.5,3,1,0,2,41,1992,Karla Golfin
212446,2186.5,3,1,0,2,41,1992,Elizabeth Gibson
212453,2186.5,1,0,0,1,43,1992,Henrietta Harris
212547,2186.5,1,0,0,1,42,1992,Melissa Golfin
200021,2186.5,1,0,0,1,65,1993,Alexia Dechaume Balleret
200029,2186.5,1,0,0,1,65,1993,Lisa Mcshea
200688,2186.5,1,0,0,1,63,1993,Noelia Perez Penate
201722,2186.5,1,0,0,1,56,1993,Luanne Spadea
201921,2186.5,1,0,0,1,3,1993,Martina Nejedly
212160,2186.5,1,0,0,1,50,1993,Karla Golfin
212421,2186.5,1,0,0,1,42,1993,Tania Zaitouni
212596,2186.5,1,0,0,1,46,1993,Lori Feingold
212680,2186.5,1,0,0,1,50,1993,Brenda Santos
212779,2186.5,1,0,0,1,37,1993,Khady N&#39;Deye Diop
200075,2186.5,1,0,0,1,57,1994,Jing Qian Yi
200425,2186.5,1,0,0,1,59,1994,Sophie Amiach
201878,2186.5,1,0,0,1,63,1994,Junko Watanabe
201906,2186.5,1,0,0,1,42,1994,Marwa El Wany
206567,2186.5,1,0,0,1,40,1994,Odeta Naujokaite
208506,2186.5,1,0,0,1,48,1994,Laura Hernandez
212394,2186.5,1,0,0,1,41,1994,Nicole Wagstaff
200045,2186.5,1,0,0,1,45,1995,Tara Snyder
200439,2186.5,1,0,0,1,66,1995,Jenny Byrne
200494,2186.5,1,0,0,1,66,1995,Dianne Van Rensburg
200563,2186.5,1,0,0,1,64,1995,Jane Taylor
200705,2186.5,1,0,0,1,64,1995,Linda Ferrando
201879,2186.5,1,0,0,1,66,1995,Reka Vidats
201967,2186.5,1,0,0,1,39,1995,Joana Manta
202043,2186.5,1,0,0,1,66,1995,Mimma Chernovita
202044,2186.5,1,0,0,1,66,1995,Eny Sulistyowati
202045,2186.5,1,0,0,1,66,1995,Il Soon Kim
202046,2186.5,1,0,0,1,66,1995,Maaike Koutstaal
202105,2186.5,1,0,0,1,10,1995,Anori Fukuda
203063,2186.5,1,0,0,1,38,1995,Julie Huang
203904,2186.5,1,0,0,1,38,1995,Rachel Clark
204578,2186.5,1,0,0,1,43,1995,Deborah Gaviria
206529,2186.5,1,0,0,1,38,1995,Hanna Katri Aalto
207416,2186.5,1,0,0,1,30,1995,Ambreen Rana
212098,2186.5,1,0,0,1,55,1995,Farah Dayoub
212410,2186.5,3,1,0,2,42,1995,Belkis Rodriguez
212499,2186.5,1,0,0,1,55,1995,Sara Taweel
212553,2186.5,3,1,0,2,53,1995,Upeka Wijeratne
200008,2186.5,1,0,0,1,54,1996,Alicia Molik
200072,2186.5,1,0,0,1,51,1996,Cara Black
200103,2186.5,5,2,0,3,54,1996,Evie Dominikovic
200636,2186.5,5,2,0,3,54,1996,Danielle Jones
202082,2186.5,1,0,0,1,14,1996,Niki Ninaus
202127,2186.5,1,0,0,1,54,1996,Ding Ding
202235,2186.5,1,0,0,1,8,1996,Fukiko Osawa
203125,2186.5,1,0,0,1,54,1996,Rochelle Rosenfield
203234,2186.5,1,0,0,1,8,1996,Keiko Taguchi
204004,2186.5,1,0,0,1,54,1996,Amy Jensen
204021,2186.5,1,0,0,1,8,1996,Yoriko Yamagishi
204052,2186.5,3,1,0,2,8,1996,Nao Akahori
204174,2186.5,1,0,0,1,8,1996,Satoko Kurioka
207078,2186.5,1,0,0,1,51,1996,Helina Lill
207291,2186.5,1,0,0,1,48,1996,Iris Staub
212056,2186.5,1,0,0,1,54,1996,Jodie Lynn
212067,2186.5,1,0,0,1,8,1996,Mika Kanaya
212068,2186.5,1,0,0,1,8,1996,Natsumi Yuki
212081,2186.5,3,1,0,2,48,1996,Helen Asciak
212098,2186.5,1,0,0,1,59,1996,Farah Dayoub
212146,2186.5,1,0,0,1,47,1996,Sarah Wetz
212720,2186.5,1,0,0,1,50,1996,Ruth Tekle Andemariam
212721,2186.5,1,0,0,1,50,1996,Lebogang Seitshiro
212774,2186.5,1,0,0,1,58,1996,Lara Arnaout
212775,2186.5,1,0,0,1,58,1996,Wei Yen Lai
200603,2186.5,1,0,0,1,52,1997,Justine Hodder
200697,2186.5,3,1,0,2,66,1997,Janette Husarova
201835,2186.5,1,0,0,1,45,1997,Maja Muric
202076,2186.5,1,0,0,1,17,1997,Eva Melicharova
202574,2186.5,1,0,0,1,10,1997,Remi Tezuka
202986,2186.5,1,0,0,1,10,1997,Kaori Aoyama
203058,2186.5,7,3,0,4,10,1997,Yoshiko Sasano
203088,2186.5,1,0,0,1,10,1997,Naoko Ishikawa
203882,2186.5,1,0,0,1,44,1997,Lucila Becerra
203974,2186.5,1,0,0,1,10,1997,Susan Huang
203975,2186.5,1,0,0,1,62,1997,Aneta Soukup
204176,2186.5,3,1,0,2,10,1997,Yumi Yokoi
204547,2186.5,1,0,0,1,44,1997,Paola Stephen
206780,2186.5,1,0,0,1,62,1997,Li Hua Yang
207401,2186.5,1,0,0,1,10,1997,Keiko Fujiwara
212065,2186.5,1,0,0,1,33,1997,Electra Henry
212067,2186.5,3,1,0,2,10,1997,Mika Kanaya
212069,2186.5,1,0,0,1,10,1997,Orie Sasaki
212072,2186.5,1,0,0,1,10,1997,Junko Nishida
212590,2186.5,1,0,0,1,32,1997,Ninani Coyne
200014,2186.5,1,0,0,1,57,1998,Tzipi Obziler
200102,2186.5,1,0,0,1,50,1998,Melissa Dowse
200570,2186.5,1,0,0,1,57,1998,Veronika Martinek
200637,2186.5,3,1,0,2,60,1998,Catherine Barclay
200678,2186.5,1,0,0,1,60,1998,Gloria Pizzichini
200733,2186.5,1,0,0,1,60,1998,Trudi Musgrave
200734,2186.5,1,0,0,1,44,1998,Tatjana Jecmenica
201855,2186.5,1,0,0,1,57,1998,Adriana Barna
201857,2186.5,1,0,0,1,57,1998,Juliana Garcia
202152,2186.5,1,0,0,1,18,1998,Jana Hlavackova
202186,2186.5,1,0,0,1,15,1998,Blanka Kumbarova
202245,2186.5,1,0,0,1,44,1998,Desislava Topalova
202265,2186.5,5,2,0,3,50,1998,Mirielle Dittmann
202274,2186.5,3,1,0,2,50,1998,Adrienn Hegedus
202510,2186.5,3,1,0,2,42,1998,Natacha Randriantefy
202574,2186.5,1,0,0,1,9,1998,Remi Tezuka
202716,2186.5,3,1,0,2,50,1998,Helen Crook
202983,2186.5,1,0,0,1,9,1998,Chisayo Ito
203018,2186.5,1,0,0,1,16,1998,Laura Montalvo
203033,2186.5,1,0,0,1,9,1998,Keiko Tameishi
203088,2186.5,1,0,0,1,9,1998,Naoko Ishikawa
203182,2186.5,1,0,0,1,9,1998,Shizu Katsumi
203974,2186.5,1,0,0,1,50,1998,Susan Huang
204021,2186.5,1,0,0,1,9,1998,Yoriko Yamagishi
204121,2186.5,1,0,0,1,50,1998,Tu Dong
204166,2186.5,1,0,0,1,45,1998,Ekaterina Paniouchkina
204174,2186.5,3,1,0,2,9,1998,Satoko Kurioka
204479,2186.5,13,6,0,7,45,1998,Vanessa Kendall
204481,2186.5,5,2,0,3,50,1998,Kylie Moulds
204504,2186.5,3,1,0,2,50,1998,Denisa Sobotkova
204577,2186.5,1,0,0,1,45,1998,Linda Tajnai
204732,2186.5,1,0,0,1,9,1998,Yasuko Nishimata
206819,2186.5,1,0,0,1,50,1998,Sylva Nesvadbova
207341,2186.5,1,0,0,1,50,1998,Silvia Tozzi
212060,2186.5,1,0,0,1,45,1998,Chantel Skulskyj
212062,2186.5,1,0,0,1,45,1998,Marinet Morgan
212149,2186.5,1,0,0,1,29,1998,Jeannine Niedhardt
212727,2186.5,1,0,0,1,35,1998,Allison Tolson
212745,2186.5,1,0,0,1,52,1998,Salima Esmat Salman
200102,2186.5,3,1,0,2,52,1999,Melissa Dowse
200103,2186.5,1,0,0,1,61,1999,Evie Dominikovic
200663,2186.5,1,0,0,1,40,1999,Nanne Dahlman
200678,2186.5,1,0,0,1,61,1999,Gloria Pizzichini
201059,2186.5,1,0,0,1,47,1999,Misumi Miyauchi
201341,2186.5,1,0,0,1,9,1999,Mi Ra Jeon
201449,2186.5,1,0,0,1,52,1999,Lauren Breadmore
201813,2186.5,1,0,0,1,20,1999,Patty Van Acker
201861,2186.5,1,0,0,1,58,1999,Romina Ottoboni
201882,2186.5,1,0,0,1,40,1999,Katarzyna Straczy
201906,2186.5,1,0,0,1,40,1999,Marwa El Wany
202085,2186.5,3,1,0,2,52,1999,Galina Fokina
202276,2186.5,1,0,0,1,57,1999,Shelley Bryce
202374,2186.5,1,0,0,1,52,1999,Nicole Kriz
203080,2186.5,7,3,0,4,52,1999,Nadia Johnston
203117,2186.5,3,1,0,2,52,1999,Jenny Belobrajdic
203182,2186.5,1,0,0,1,9,1999,Shizu Katsumi
203235,2186.5,1,0,0,1,55,1999,Po Kuen Lam
203592,2186.5,1,0,0,1,52,1999,Melanie Ann Clayton
204051,2186.5,1,0,0,1,9,1999,Chie Nagano
204100,2186.5,1,0,0,1,52,1999,Veronika Raimrova
204177,2186.5,1,0,0,1,9,1999,Akiko Kinebuchi
204182,2186.5,1,0,0,1,9,1999,Motoe Uchida
204188,2186.5,1,0,0,1,9,1999,Azusa Konishi
204477,2186.5,1,0,0,1,52,1999,Zsofia Golopencza
204480,2186.5,1,0,0,1,52,1999,Kym Hazzard
204515,2186.5,3,1,0,2,52,1999,Ella Ionescu
204556,2186.5,1,0,0,1,52,1999,Aleksandra Vucenovic
204629,2186.5,1,0,0,1,52,1999,Emma Gott
204855,2186.5,3,1,0,2,52,1999,Sarah Stone
204875,2186.5,1,0,0,1,9,1999,Tomoko Taira
204969,2186.5,1,0,0,1,33,1999,Edita Liachoviciute
206447,2186.5,3,1,0,2,54,1999,Ingrid Gonzalez
206488,2186.5,1,0,0,1,52,1999,Kellie Browne
206999,2186.5,1,0,0,1,56,1999,Erika Villalobos Morsink
207393,2186.5,1,0,0,1,9,1999,Ayako Noda
212098,2186.5,3,1,0,2,54,1999,Farah Dayoub
212111,2186.5,1,0,0,1,56,1999,Zarah De Silva
212386,2186.5,1,0,0,1,33,1999,Margarita Akbacheva
212473,2186.5,1,0,0,1,56,1999,Karla Hall Gonzalez
212700,2186.5,1,0,0,1,55,1999,Tamara Davis
212739,2186.5,1,0,0,1,57,1999,Mehvish Chishtie
200005,2186.5,1,0,0,1,65,2000,Jolene Watanabe Giltz
200021,2186.5,1,0,0,1,65,2000,Alexia Dechaume Balleret
200034,2186.5,1,0,0,1,65,2000,Amanda Grahame
200102,2186.5,1,0,0,1,65,2000,Melissa Dowse
200655,2186.5,1,0,0,1,68,2000,Nicole Arendt
201207,2186.5,1,0,0,1,16,2000,Ansley Cargill
201624,2186.5,1,0,0,1,26,2000,Eun Ha Kim
202748,2186.5,7,3,0,4,59,2000,Tomoe Hotta
203080,2186.5,7,3,0,4,59,2000,Nadia Johnston
203082,2186.5,7,3,0,4,59,2000,Nicole Melch
203188,2186.5,3,1,0,2,59,2000,Emily Hewson
204032,2186.5,1,0,0,1,59,2000,Marion Walter
204472,2186.5,1,0,0,1,46,2000,Ya Fang Tsai
204643,2186.5,1,0,0,1,59,2000,Aniela Mojzis
204892,2186.5,1,0,0,1,34,2000,Monika Schneider
204944,2186.5,1,0,0,1,59,2000,Darya Ivanov
206505,2186.5,1,0,0,1,35,2000,Kirsi Lampinen
207261,2186.5,1,0,0,1,59,2000,Karolina Sadaj
207633,2186.5,3,1,0,2,59,2000,Lucinda Gibbs
212146,2186.5,1,0,0,1,56,2000,Sarah Wetz
212362,2186.5,1,0,0,1,52,2000,Elya Constanta
212563,2186.5,1,0,0,1,40,2000,Milena Leiva
212582,2186.5,1,0,0,1,55,2000,Ntswaki Mawela
200776,2186.5,1,0,0,1,25,2001,Angelika Bachmann
201449,2186.5,1,0,0,1,52,2001,Lauren Breadmore
201637,2186.5,1,0,0,1,52,2001,Melissa Torres Sandoval
202257,2186.5,1,0,0,1,54,2001,Carmina Giraldo
202284,2186.5,3,1,0,2,52,2001,Mariona Gallifa Puig Desens
202297,2186.5,3,1,0,2,52,2001,Maria Kondratieva
202317,2186.5,1,0,0,1,52,2001,Ilke Gers
203079,2186.5,7,3,0,4,52,2001,Diana Gherghi
203080,2186.5,7,3,0,4,52,2001,Nadia Johnston
203082,2186.5,1,0,0,1,52,2001,Nicole Melch
203105,2186.5,1,0,0,1,52,2001,I Ting Wang
203243,2186.5,1,0,0,1,52,2001,Wilawan Choptang
203813,2186.5,3,1,0,2,52,2001,Victoria Davies
204189,2186.5,5,2,0,3,52,2001,Remi Uda
204491,2186.5,3,1,0,2,52,2001,Rebecca Pike
204571,2186.5,1,0,0,1,52,2001,Michelle Summerside
204595,2186.5,1,0,0,1,41,2001,Charlotte Aagaard
204700,2186.5,1,0,0,1,52,2001,Karla Mancinas
204854,2186.5,1,0,0,1,52,2001,Natalie Ko
205044,2186.5,1,0,0,1,52,2001,Karin Ionesco
205127,2186.5,1,0,0,1,52,2001,Ana Cecilia Trevino
206539,2186.5,1,0,0,1,52,2001,Britta Mohlmann
206621,2186.5,1,0,0,1,32,2001,Kelesitse Makgale
207955,2186.5,1,0,0,1,52,2001,Nasheli Martinez
208378,2186.5,3,1,0,2,46,2001,Sobhini De Silva
212103,2186.5,1,0,0,1,31,2001,Alexandra Chong
212105,2186.5,1,0,0,1,32,2001,Leeza Rooks
200038,2186.5,1,0,0,1,65,2002,Annabel Ellwood
200102,2186.5,1,0,0,1,56,2002,Melissa Dowse
200752,2186.5,1,0,0,1,58,2002,Raluca Sandu
201316,2186.5,1,0,0,1,65,2002,Lenka Dlhopolcova
201449,2186.5,3,1,0,2,56,2002,Lauren Breadmore
201664,2186.5,1,0,0,1,39,2002,Pemra Ozgen
202277,2186.5,1,0,0,1,58,2002,Mariana Correa
202282,2186.5,1,0,0,1,24,2002,Goulnara Fattakhetdinova
202597,2186.5,1,0,0,1,63,2002,Veronica Spiegel
203089,2186.5,7,3,0,4,56,2002,Kristen Van Elden
203091,2186.5,1,0,0,1,56,2002,Yumiko Kitamura
203183,2186.5,5,2,0,3,56,2002,Christina Horiatopoulos
203187,2186.5,1,0,0,1,56,2002,Dubravka Cupac
203216,2186.5,3,1,0,2,63,2002,Marcela Arroyo Vergara
203243,2186.5,1,0,0,1,56,2002,Wilawan Choptang
203282,2186.5,1,0,0,1,63,2002,Salome Llaguno
204209,2186.5,3,1,0,2,56,2002,Gabrielle Baker
204618,2186.5,7,3,0,4,63,2002,Caroline Ann Basu
204855,2186.5,5,2,0,3,56,2002,Sarah Stone
205009,2186.5,7,3,0,4,63,2002,Borka Majstorovic
206679,2186.5,1,0,0,1,63,2002,Dragica Joksimovic
207152,2186.5,5,2,0,3,56,2002,Bree Calderwood
207829,2186.5,1,0,0,1,63,2002,Angela Piedrahita
208060,2186.5,1,0,0,1,47,2002,Sihem Ben Youcef
208248,2186.5,3,1,0,2,56,2002,Christine Alford
212143,2186.5,1,0,0,1,53,2002,Wing Shan Cheung
212152,2186.5,1,0,0,1,45,2002,Phemelo Mogapi
212154,2186.5,1,0,0,1,39,2002,Maria Calbeto
200023,2186.5,1,0,0,1,52,2003,Bryanne Stewart
200753,2186.5,1,0,0,1,52,2003,Cindy Watson
201452,2186.5,1,0,0,1,47,2003,Lourdes Dominguez Lino
201864,2186.5,1,0,0,1,45,2003,Celeste Contin
202245,2186.5,1,0,0,1,39,2003,Desislava Topalova
202306,2186.5,1,0,0,1,47,2003,Diana Ospina
202307,2186.5,1,0,0,1,47,2003,Tanner Cochran
202349,2186.5,3,1,0,2,45,2003,Rushmi Chakravarthi
202802,2186.5,1,0,0,1,45,2003,Nicole Leimbach
202899,2186.5,1,0,0,1,45,2003,Cassandra Barr
203010,2186.5,5,2,0,3,45,2003,Ryoko Takemura
203080,2186.5,1,0,0,1,45,2003,Nadia Johnston
203100,2186.5,1,0,0,1,45,2003,Lyndsay Reilly
203119,2186.5,7,3,0,4,45,2003,Melisa Arevalo
203184,2186.5,3,1,0,2,45,2003,Beti Sekulovski
204516,2186.5,1,0,0,1,45,2003,Melody Falco
204518,2186.5,1,0,0,1,45,2003,Brenda Coassolo
204571,2186.5,1,0,0,1,45,2003,Michelle Summerside
205039,2186.5,5,2,0,3,45,2003,Jacqueline Frohlich
205071,2186.5,1,0,0,1,45,2003,Anastasia Dvornikova
206621,2186.5,1,0,0,1,30,2003,Kelesitse Makgale
212075,2186.5,1,0,0,1,45,2003,Asha Burns
212076,2186.5,3,1,0,2,45,2003,Carolyn Mcgann
212079,2186.5,1,0,0,1,45,2003,Amanda Jasso
212108,2186.5,1,0,0,1,36,2003,Sasha Fisher
212124,2186.5,1,0,0,1,30,2003,Ilona Giberte
212180,2186.5,1,0,0,1,32,2003,Stephanie Pace
200103,2186.5,3,1,0,2,50,2004,Evie Dominikovic
200753,2186.5,1,0,0,1,51,2004,Cindy Watson
201388,2186.5,1,0,0,1,50,2004,Sophie Ferguson
201675,2186.5,1,0,0,1,8,2004,So Jung Kim
201942,2186.5,1,0,0,1,47,2004,Andreea Ehritt Vanc
202301,2186.5,1,0,0,1,8,2004,Sunitha Rao
202324,2186.5,1,0,0,1,47,2004,Neha Uberoi
208147,2186.5,3,1,0,2,37,2004,Pamela Duran Vinueza
200753,2186.5,1,0,0,1,46,2005,Cindy Watson
201449,2186.5,1,0,0,1,47,2005,Lauren Breadmore
201545,2186.5,1,0,0,1,29,2005,Anastasija Sevastova
201666,2186.5,1,0,0,1,23,2005,Cagla Buyukakcay
202258,2186.5,1,0,0,1,48,2005,Jaslyn Hewitt
202308,2186.5,1,0,0,1,42,2005,Paula Garcia
202342,2186.5,1,0,0,1,47,2005,Daniella Jeflea
204451,2186.5,1,0,0,1,32,2005,Asimina Kaplani
205230,2186.5,1,0,0,1,32,2005,Yen Hua Lu
208076,2186.5,1,0,0,1,34,2005,Ting Wen Wang
208323,2186.5,1,0,0,1,32,2005,Anett Kaasik
208427,2186.5,1,0,0,1,34,2005,Amanda Melgarejo
212082,2186.5,1,0,0,1,29,2005,Lisa Camenzuli
212186,2186.5,1,0,0,1,33,2005,Yekaterina Morozova
212189,2186.5,1,0,0,1,34,2005,Nivin Kezbari
212199,2186.5,1,0,0,1,34,2005,Inna Gavrilenko
212205,2186.5,1,0,0,1,27,2005,Sandra Kristjansdottir
212207,2186.5,1,0,0,1,28,2005,Puleng Tlhophane
212212,2186.5,1,0,0,1,26,2005,Olga Cosic
200720,2186.5,1,0,0,1,45,2006,Dally Randriantefy
201289,2186.5,1,0,0,1,46,2006,Christina Wheeler
201525,2186.5,1,0,0,1,46,2006,Eva Hrdinova
201605,2186.5,1,0,0,1,35,2006,Mandy Minella
202312,2186.5,1,0,0,1,47,2006,Olga Vymetalkova
202345,2186.5,1,0,0,1,42,2006,Katarina Kachlikova
202351,2186.5,1,0,0,1,46,2006,Shayna Mcdowell
202354,2186.5,1,0,0,1,41,2006,Andrea Benitez
202462,2186.5,1,0,0,1,33,2006,Karen Castiblanco
202582,2186.5,1,0,0,1,33,2006,Lizaan Du Plessis
202930,2186.5,1,0,0,1,33,2006,Jessica Roland Rosario
203309,2186.5,3,1,0,2,31,2006,Mariya Kovaleva
204232,2186.5,1,0,0,1,32,2006,Paula Catalina Robles Garcia
212186,2186.5,1,0,0,1,32,2006,Yekaterina Morozova
212219,2186.5,1,0,0,1,32,2006,Line Jouayed
200777,2186.5,1,0,0,1,42,2007,Marta Marrero
201302,2186.5,1,0,0,1,46,2007,Clarisa Fernandez
201467,2186.5,1,0,0,1,42,2007,Ivana Abramovic
201581,2186.5,1,0,0,1,6,2007,Chun Mei Ji
201638,2186.5,1,0,0,1,42,2007,Estrella Cabeza Candela
202371,2186.5,1,0,0,1,40,2007,Lindsey Nelson
205694,2186.5,1,0,0,1,33,2007,Helene Auensen
208549,2186.5,1,0,0,1,28,2007,Aliaa Fakhry
212225,2186.5,1,0,0,1,36,2007,Sofia Barletta
201289,2186.5,1,0,0,1,43,2008,Christina Wheeler
201302,2186.5,1,0,0,1,43,2008,Clarisa Fernandez
201322,2186.5,1,0,0,1,42,2008,Eva Dyrberg
201407,2186.5,1,0,0,1,43,2008,Evgenia Linetskaya
201560,2186.5,1,0,0,1,5,2008,Kinnie Laisne
201620,2186.5,1,0,0,1,39,2008,Monica Puig
202390,2186.5,1,0,0,1,45,2008,Ellen Barry
202400,2186.5,1,0,0,1,19,2008,Anna Fitzpatrick
202407,2186.5,1,0,0,1,16,2008,Palma Kiraly
202997,2186.5,1,0,0,1,41,2008,Yvonne Doyle
203235,2186.5,1,0,0,1,40,2008,Po Kuen Lam
203310,2186.5,1,0,0,1,27,2008,Ofelya Poghosyan
204391,2186.5,1,0,0,1,42,2008,Sofia Kvatsabaia
208549,2186.5,1,0,0,1,29,2008,Aliaa Fakhry
209371,2186.5,1,0,0,1,29,2008,Maria Fagerstrom
212183,2186.5,1,0,0,1,40,2008,Ummarahmat Hummetova
212783,2186.5,1,0,0,1,39,2008,Marina Lidiya
200002,2186.5,1,0,0,1,45,2009,Mirjana Lucic
201476,2186.5,1,0,0,1,8,2009,Lauren Albanese
201543,2186.5,1,0,0,1,44,2009,Emelyn Starr
201548,2186.5,1,0,0,1,34,2009,Ajla Tomljanovic
201564,2186.5,1,0,0,1,22,2009,Lenka Tvaroskova
201566,2186.5,1,0,0,1,22,2009,Agnes Szatmari
201615,2186.5,1,0,0,1,7,2009,Lesia Tsurenko
201633,2186.5,1,0,0,1,38,2009,Tomoko Yonemura
201652,2186.5,1,0,0,1,17,2009,Ksenia Palkina
202387,2186.5,1,0,0,1,42,2009,Vlada Ekshibarova
202645,2186.5,1,0,0,1,39,2009,Jessy Rompies
202664,2186.5,1,0,0,1,42,2009,Roxane Vaisemberg
205757,2186.5,1,0,0,1,28,2009,Claudia Razzeto
208983,2186.5,1,0,0,1,42,2009,Larikah Russell
212260,2186.5,1,0,0,1,27,2009,Rosaline Zafir Chavez Tello
201553,2186.5,1,0,0,1,43,2010,Lenka Wienerova
201554,2186.5,1,0,0,1,42,2010,Vitalia Diatchenko
202394,2186.5,1,0,0,1,48,2010,Camila Silva
202395,2186.5,1,0,0,1,45,2010,Maria Irigoyen
204271,2186.5,1,0,0,1,46,2010,Biljana Pawlowa Dimitrova
204307,2186.5,1,0,0,1,45,2010,Neesha Thirumalaichelvam
204323,2186.5,1,0,0,1,45,2010,Zsofia Susanyi
205908,2186.5,1,0,0,1,34,2010,Menna El Nagdy
206213,2186.5,3,1,0,2,32,2010,Amy Bowtell
210958,2186.5,1,0,0,1,32,2010,Alexandra Perper
212264,2186.5,1,0,0,1,48,2010,Diala Jamaleddine
201368,2186.5,1,0,0,1,51,2011,Karolina Sprem
201602,2186.5,1,0,0,1,44,2011,Beatrice Capra
201678,2186.5,1,0,0,1,53,2011,Sacha Jones
202403,2186.5,1,0,0,1,44,2011,Leticia Costas
202414,2186.5,1,0,0,1,44,2011,Catherine Harrison
202556,2186.5,1,0,0,1,46,2011,Ana Jovanovic
202607,2186.5,1,0,0,1,50,2011,Yi Chen
202687,2186.5,1,0,0,1,50,2011,Ran Tian
202844,2186.5,1,0,0,1,50,2011,Yui Lynn Miao
203310,2186.5,1,0,0,1,33,2011,Ofelya Poghosyan
206286,2186.5,1,0,0,1,31,2011,Nune Khachatryan
210448,2186.5,1,0,0,1,47,2011,Lina Lileikite
211069,2186.5,3,1,0,2,50,2011,Zhamilia Duisheeva
212252,2186.5,1,0,0,1,28,2011,Lee Anne Lingo
212283,2186.5,1,0,0,1,25,2011,Ximena Mino
201334,2186.5,1,0,0,1,20,2012,Zuzana Ondraskova
201676,2186.5,1,0,0,1,44,2012,Ye Ra Lee
202399,2186.5,1,0,0,1,44,2012,Margit Ruutel
202474,2186.5,1,0,0,1,25,2012,Henrietta Habler
202570,2186.5,1,0,0,1,2,2012,Hao Ching Chan
202879,2186.5,1,0,0,1,43,2012,Tiffany Cornelius
204360,2186.5,1,0,0,1,31,2012,Carolina Betancourt
206106,2186.5,1,0,0,1,0,2012,Prarthana G Thombare
210131,2186.5,1,0,0,1,46,2012,Belen Rivera
211012,2186.5,1,0,0,1,41,2012,Eva Paalma
212295,2186.5,1,0,0,1,45,2012,Sahar Najaei
201678,2186.5,1,0,0,1,44,2013,Sacha Jones
202379,2186.5,1,0,0,1,33,2013,Chieh Yu Hsu
202451,2186.5,1,0,0,1,37,2013,Nicole Rottmann
202457,2186.5,1,0,0,1,36,2013,Bibiane Schoofs
202483,2186.5,1,0,0,1,29,2013,Sandra Zaniewska
202558,2186.5,1,0,0,1,13,2013,Veronika Kapshay
202594,2186.5,1,0,0,1,14,2013,Elena Bogdan
202649,2186.5,1,0,0,1,28,2013,Lynn Kiro
202879,2186.5,1,0,0,1,37,2013,Tiffany Cornelius
206374,2186.5,1,0,0,1,5,2013,Yafan Wang
212266,2186.5,1,0,0,1,38,2013,Khee Yen Wee
212903,2186.5,1,0,0,1,38,2013,Laura Correia
202489,2186.5,1,0,0,1,49,2014,Carina Witthoeft
208983,2186.5,1,0,0,1,46,2014,Larikah Russell
211234,2186.5,1,0,0,1,46,2014,Deria Nur Haliza
211722,2186.5,1,0,0,1,42,2014,Szabina Szlavikovics
212286,2186.5,1,0,0,1,33,2014,Gabriela Gonzalez
214631,2186.5,1,0,0,1,45,2014,Hera Brynjarsdottir
201386,2186.5,1,0,0,1,38,2015,Jie Zheng
201482,2186.5,1,0,0,1,37,2015,Andreja Klepac
201532,2186.5,1,0,0,1,14,2015,Anastasia Pivovarova
201638,2186.5,1,0,0,1,35,2015,Estrella Cabeza Candela
201701,2186.5,1,0,0,1,37,2015,Basak Eraydin
202348,2186.5,1,0,0,1,27,2015,Lina Stanciute
202493,2186.5,1,0,0,1,37,2015,Ekaterine Gorgodze
202600,2186.5,1,0,0,1,37,2015,Viktoriya Tomova
202604,2186.5,1,0,0,1,27,2015,Despina Papamichail
202626,2186.5,1,0,0,1,37,2015,Stephanie Vogt
203290,2186.5,1,0,0,1,37,2015,Piia Suomalainen
203456,2186.5,1,0,0,1,37,2015,Jelena Simic
203509,2186.5,1,0,0,1,37,2015,Diana Marcinkevica
203584,2186.5,1,0,0,1,37,2015,Adriana Perez
204282,2186.5,1,0,0,1,28,2015,Anastasiya Prenko
205909,2186.5,1,0,0,1,37,2015,Ola Abou Zekry
206037,2186.5,1,0,0,1,37,2015,Daniela Seguel
206045,2186.5,1,0,0,1,14,2015,Quirine Lemoine
206060,2186.5,1,0,0,1,28,2015,Ani Amiraghyan
206075,2186.5,1,0,0,1,8,2015,Hiroko Kuwata
206213,2186.5,1,0,0,1,37,2015,Amy Bowtell
206344,2186.5,1,0,0,1,37,2015,Fernanda Brito
206387,2186.5,1,0,0,1,37,2015,Aymet Uzcategui
210303,2186.5,1,0,0,1,37,2015,Kathinka Von Deichmann
210958,2186.5,1,0,0,1,27,2015,Alexandra Perper
211208,2186.5,1,0,0,1,37,2015,Ho Ching Wu
211234,2186.5,1,0,0,1,28,2015,Deria Nur Haliza
211404,2186.5,1,0,0,1,28,2015,Kristina Samardzic
211814,2186.5,1,0,0,1,37,2015,Julia Grabher
212266,2186.5,1,0,0,1,28,2015,Khee Yen Wee
212314,2186.5,1,0,0,1,28,2015,Jahana Bayramova
213631,2186.5,1,0,0,1,34,2015,Marie Bouzkova
213827,2186.5,1,0,0,1,27,2015,Magdalena Stoilkovska
214419,2186.5,1,0,0,1,28,2015,Nina Kalezic
214623,2186.5,1,0,0,1,28,2015,Lusine Chobanyan
214625,2186.5,1,0,0,1,27,2015,Eliza Omirou
214629,2186.5,1,0,0,1,28,2015,Anna Soffia Gronholm
214630,2186.5,1,0,0,1,28,2015,Hjordis Rosa Gudmundsdottir
214632,2186.5,1,0,0,1,28,2015,Ghazal Pakbaten
214842,2186.5,1,0,0,1,14,2015,Zuleykha Safarova
215016,2186.5,1,0,0,1,37,2015,Eleonora Molinaro
215122,2186.5,1,0,0,1,28,2015,Angeline Devi Devanthiran
215124,2186.5,1,0,0,1,28,2015,Sara Amini
215125,2186.5,1,0,0,1,27,2015,Saara Kunakunova
215126,2186.5,1,0,0,1,27,2015,Eliza Askarova
206041,2186.499212,1,0,0,1,37,2013,Laura Ucros
202490,2186.497547,3,1,0,2,15,2014,Rebecca Peterson
200733,2186.496875,1,0,0,1,11,2002,Trudi Musgrave
211864,2186.494379,1,0,0,1,29,2015,Maria Fernanda Herazo Gonzalez
204732,2186.492429,1,0,0,1,10,1997,Yasuko Nishimata
208120,2186.492429,1,0,0,1,10,1997,Ji Young Yoo
212071,2186.492429,1,0,0,1,10,1997,Miki Kuramochi
201372,2186.487541,1,0,0,1,12,2003,Theresa Logar
201855,2186.48528,1,0,0,1,14,1996,Adriana Barna
212251,2186.485193,3,1,0,2,25,2008,Nicole Stanziola
203898,2186.482744,3,1,0,2,25,1998,Tina Samara
202997,2186.482056,3,1,0,2,26,2006,Yvonne Doyle
207459,2186.481999,1,0,0,1,52,1997,Amy Chiminello
201979,2186.48143,1,0,0,1,0,1990,Luciana Della Casa
201753,2186.48042,3,1,0,2,54,1999,Rewa Harriman
212282,2186.48042,3,1,0,2,31,2014,Michelle Marie Valdez
202359,2186.479804,3,1,0,2,43,2014,Chin Wei Chan
212134,2186.47966,3,1,0,2,30,1999,Razalia Phethu
203290,2186.47966,3,1,0,2,32,2007,Piia Suomalainen
201451,2186.479639,1,0,0,1,5,2008,Kathrin Woerle
212537,2186.479628,1,0,0,1,35,1997,Vaida Martinkute
200750,2186.479628,1,0,0,1,61,1999,Karin Miller
200087,2186.479628,1,0,0,1,42,2005,Seda Noorlander
214632,2186.479628,1,0,0,1,44,2014,Ghazal Pakbaten
202410,2186.479117,1,0,0,1,26,2009,Sofia Shapatava
201652,2186.478838,1,0,0,1,45,2011,Ksenia Palkina
200600,2186.478836,1,0,0,1,39,1990,Simone Schilder
201579,2186.47853,1,0,0,1,42,2010,Yurika Sema
203379,2186.475425,3,1,0,2,14,2015,Marina Melnikova
201656,2186.474513,1,0,0,1,7,2006,Tadeja Majeric
211843,2186.471809,1,0,0,1,6,2015,Anhelina Kalinina
204488,2186.470791,3,1,0,2,41,1998,Elena Juricich
201959,2186.468507,5,2,0,3,51,2000,Ana Catarina Nogueira
204759,2186.467317,3,1,0,2,52,1998,Ning Lin
201724,2186.46677,1,0,0,1,41,1991,Julie Exum
200631,2186.465814,3,1,0,2,10,1991,Maria Ekstrand
201855,2186.462681,1,0,0,1,7,2003,Adriana Barna
201559,2186.462536,1,0,0,1,19,2013,Irena Pavlovic
212499,2186.462451,5,2,0,3,56,1997,Sara Taweel
213023,2186.46239,1,0,0,1,38,2013,Iman Qureshi
206529,2186.461304,3,1,0,2,31,2000,Hanna Katri Aalto
201631,2186.460891,1,0,0,1,40,2012,Nicha Lertpitaksinchai
206911,2186.460806,1,0,0,1,33,1998,Carla Prieto
201612,2186.460104,1,0,0,1,33,2015,Junri Namigata
201670,2186.460046,1,0,0,1,41,2012,Amra Sadikovic
200287,2186.459525,1,0,0,1,57,1994,Miki Yokobori
214619,2186.459322,3,1,0,2,44,2014,Ghada Alajeely
202869,2186.459317,1,0,0,1,42,2008,Nicole Thyssen
212261,2186.459317,1,0,0,1,26,2009,Sally Bogaert Morel
201631,2186.459256,1,0,0,1,38,2009,Nicha Lertpitaksinchai
201451,2186.458682,1,0,0,1,42,2007,Kathrin Woerle
202279,2186.457387,1,0,0,1,24,2003,Virag Nemeth
200057,2186.454638,12,5,0,7,0,1999,Erika De Lone
201462,2186.450748,7,3,0,4,5,2006,Alberta Brianti
201665,2186.450687,1,0,0,1,21,2008,Ipek Senoglu
204221,2186.448193,1,0,0,1,31,2006,Kairangi Vano
200579,2186.448033,1,0,0,1,26,2000,Karin Kschwendt
201605,2186.447822,25,11,0,14,4,2012,Mandy Minella
204728,2186.446449,1,0,0,1,52,2002,Sonal Phadke
201309,2186.44109,1,0,0,1,10,2000,Tatiana Perebiynis
200001,2186.44052,1,0,0,1,45,2005,Martina Hingis
212197,2186.44039,3,1,0,2,26,2005,Elrien De Villiers
201045,2186.437399,1,0,0,1,57,1993,Natalia Egorova
202310,2186.435854,1,0,0,1,41,2003,Shadisha Robinson
202192,2186.434724,1,0,0,1,7,1993,Tzu Ting Weng
202701,2186.434336,3,1,0,2,35,2014,Irina Khromacheva
209116,2186.429012,3,1,0,2,32,2006,Marcela Rivero
202705,2186.428531,3,1,0,2,32,2006,Veronica Cepede Royg
201207,2186.426349,1,0,0,1,1,2005,Ansley Cargill
202441,2186.424913,1,0,0,1,15,2011,Nina Khrisanova
201343,2186.424038,1,0,0,1,40,2001,Maret Ani
200090,2186.423721,1,0,0,1,17,1997,Anca Barna
200010,2186.421823,1,0,0,1,18,1993,Rita Grande
204482,2186.421559,1,0,0,1,20,2001,Alienor Tricerri
200475,2186.421096,3,1,0,2,39,1990,Lisa Oneill
201656,2186.420943,1,0,0,1,37,2015,Tadeja Majeric
212464,2186.419165,3,1,0,2,24,1991,Yeon Sook Kim
202064,2186.416565,1,0,0,1,12,1990,Nike Dobrovits
201495,2186.41656,1,0,0,1,18,2005,Dominika Cibulkova
200636,2186.411192,5,2,0,3,7,1993,Danielle Jones
202262,2186.409792,1,0,0,1,19,2001,Katrina Nimmers
201591,2186.409225,1,0,0,1,29,2010,Margalita Chakhnashvili
202633,2186.408513,1,0,0,1,21,2014,Nina Zander
202413,2186.407989,1,0,0,1,35,2014,Florencia Molinero
200674,2186.404222,10,4,0,6,9,1996,Bettina Fulco Villella
201205,2186.398818,6,2,0,4,11,2000,Tracy Almeda Singian
201363,2186.398798,1,0,0,1,50,2001,Gisela Dulko
200084,2186.392997,1,0,0,1,44,1992,Asa Svensson
202495,2186.384846,1,0,0,1,14,2012,Jennifer Elie
201045,2186.379355,1,0,0,1,25,1996,Natalia Egorova
202406,2186.373099,1,0,0,1,16,2008,Natasa Zoric
201507,2186.369575,3,1,0,2,10,2007,Audra Cohen
212597,2186.369079,1,0,0,1,39,1992,Helene Kappler
202485,2186.368722,1,0,0,1,17,2012,Jana Juricova
201347,2186.367643,8,3,0,5,16,2002,Jelena Jankovic
200744,2186.366637,1,0,0,1,45,1997,Svetlana Krivencheva
201453,2186.364595,1,0,0,1,15,1998,Hana Sromova
202706,2186.364386,1,0,0,1,21,2015,Manon Arcangioli
202073,2186.361513,1,0,0,1,44,1992,Chin Bee Khoo
202122,2186.361268,1,0,0,1,40,1991,Orawan Thampensri
201823,2186.357284,1,0,0,1,35,1992,Daphne Van De Zande
201832,2186.355936,1,0,0,1,40,1991,Gabriela Mosca
202334,2186.353687,1,0,0,1,14,2007,Hanna Nooni
201358,2186.351547,1,0,0,1,23,2005,Natalia Gussoni
202263,2186.349025,1,0,0,1,18,2001,Anne Nguyen
201404,2186.347554,3,1,0,2,11,2004,Jessica Kirkland
201771,2186.339561,3,1,0,2,16,1995,Virag Csurgo
202125,2186.337357,5,2,0,3,0,1996,Phorhathai Suksamran
200091,2186.332679,1,0,0,1,13,1993,Janet Lee
202103,2186.332136,1,0,0,1,10,1995,Keiko Ishida
200754,2186.331592,3,1,0,2,29,2013,Jill Craybas
200036,2186.33042,43,18,0,25,4,2003,Nicole Pratt
200360,2186.327445,29,13,0,16,1,1994,Pam Shriver
204912,2186.320849,1,0,0,1,38,1999,Diana Majkic
201926,2186.311771,1,0,0,1,1,1992,Stephanie Reece
201562,2186.310135,3,1,0,2,37,2010,Silvia Soler Espinosa
201531,2186.308166,17,8,0,9,14,2012,Mariana Duque Marino
212064,2186.306008,1,0,0,1,33,1997,Marcia Senn
209836,2186.304089,3,1,0,2,38,2002,Nikkita Fountain
203549,2186.28515,1,0,0,1,14,2015,Olga Ianchuk
201957,2186.283934,1,0,0,1,31,1991,Dorien Wamelink
202897,2186.281557,1,0,0,1,45,2010,Sarah Moundir
201622,2186.27627,1,0,0,1,16,2007,Iryna Bremond
201654,2186.267067,1,0,0,1,16,2012,Sandra Roma
201613,2186.265301,1,0,0,1,7,2010,Arina Rodionova
202448,2186.265231,1,0,0,1,13,2011,Zoe Gwen Scandalis
201646,2186.261647,1,0,0,1,24,2009,Maria Joao Koehler
201303,2186.257727,1,0,0,1,22,2002,Anne Keothavong
201369,2186.253118,1,0,0,1,16,2006,Carly Gullickson
201703,2186.241539,1,0,0,1,0,2012,Yi Fan Xu
202037,2186.238214,1,0,0,1,36,1990,Linley Tanner
202035,2186.23388,1,0,0,1,2,1990,Holyn Lord
201596,2186.231583,7,3,0,4,13,2006,Johanna Larsson
202279,2186.218453,1,0,0,1,42,2002,Virag Nemeth
201456,2186.209751,3,1,0,2,0,2012,Olga Savchuk
202028,2186.205955,1,0,0,1,23,1998,Nuria Montero
201461,2186.193209,1,0,0,1,21,2006,Aurelie Vedy
204426,2186.192412,1,0,0,1,31,2013,Anett Kontaveit
203521,2186.189301,5,2,0,3,14,2013,Andrea Gamiz
206102,2186.186697,3,1,0,2,44,2014,Ankita Raina
201639,2186.182649,1,0,0,1,31,2009,Yevheniia Savranska
200118,2186.180626,21,9,0,12,2,2008,Virginia Ruano Pascual
201645,2186.178581,1,0,0,1,24,2009,Frederica Piedade
200774,2186.174979,3,1,0,2,16,2001,Vanessa Webb
201992,2186.172032,1,0,0,1,37,1992,Sabine Lohmann
202261,2186.16979,3,1,0,2,31,2000,Joanna Sakowicz Kostecka
201360,2186.168587,1,0,0,1,17,2009,Julia Vakulenko
200376,2186.16063,1,0,0,1,42,2007,Katerina Bohmova
201752,2186.159038,1,0,0,1,16,1996,Cristina Salvi
211966,2186.157343,1,0,0,1,14,2014,Ksenia Gaydarzhi
212193,2186.151027,3,1,0,2,31,2004,Wanjika Ngaruiya
200675,2186.148927,1,0,0,1,8,1990,Eugenia Maniokova
201556,2186.143525,36,16,0,20,3,2011,Lucie Hradecka
207176,2186.140701,3,1,0,2,31,1999,Sona Saringulyan
200390,2186.138904,3,1,0,2,57,1993,Mary Lou Daniels
201330,2186.137486,3,1,0,2,7,2003,Maria Goloviznina
200752,2186.137316,3,1,0,2,48,1997,Raluca Sandu
201693,2186.136431,1,0,0,1,17,2010,Timea Babos
201636,2186.132441,1,0,0,1,31,2008,Anna Orlik
202798,2186.13032,3,1,0,2,20,2001,Matea Mezak
201949,2186.129973,1,0,0,1,54,1994,Eva Jimenez Sanz
201445,2186.129566,1,0,0,1,22,2011,Viktoria Kutuzova
200032,2186.127474,1,0,0,1,28,1991,Barbara Schett
201669,2186.125022,1,0,0,1,6,2005,Yan Chong Chen
201439,2186.123841,1,0,0,1,21,2002,Tiffany Dabek
201061,2186.12065,1,0,0,1,30,1995,Eva Martincova
200028,2186.120577,1,0,0,1,8,1997,Maureen Drake
202626,2186.119629,1,0,0,1,14,2012,Stephanie Vogt
200768,2186.118389,3,1,0,2,27,2000,Laurence Andretto
200072,2186.117341,4,1,0,3,12,2006,Cara Black
201556,2186.11726,1,0,0,1,30,2007,Lucie Hradecka
202349,2186.11669,1,0,0,1,35,2004,Rushmi Chakravarthi
212589,2186.116517,3,1,0,2,36,1995,Tatiana Babina
202447,2186.115324,1,0,0,1,12,2013,Alexandra Mueller
200598,2186.115265,1,0,0,1,36,1994,Jeri Ingram
203320,2186.107607,1,0,0,1,39,2008,Ima Bohush
201457,2186.105966,1,0,0,1,47,2004,Jarmila Gajdosova
201418,2186.10419,1,0,0,1,9,2001,Ting Li
202021,2186.098662,1,0,0,1,27,1990,Estefania Bottini
201477,2186.095886,3,1,0,2,3,2004,Stephanie Dubois
202156,2186.095751,1,0,0,1,33,1996,Gabriella Boschiero
201612,2186.095742,7,3,0,4,8,2011,Junri Namigata
202104,2186.095227,1,0,0,1,42,1996,Kazue Takuma
202088,2186.094408,5,2,0,3,34,1997,Aida Khalatian
202315,2186.094259,1,0,0,1,14,2003,Beier Ko
201618,2186.09344,1,0,0,1,35,2013,Fatma Al Nabhani
200099,2186.092626,1,0,0,1,15,1991,Sonya Jeyaseelan
201479,2186.092129,1,0,0,1,8,2009,Olga Puchkova
204036,2186.092,1,0,0,1,40,2009,Fabienne Thill
201285,2186.09021,1,0,0,1,57,2000,Melissa Middleton
201338,2186.088083,1,0,0,1,47,2004,Bea Bielik
202114,2186.087441,1,0,0,1,59,1993,Seiko Ichioka
201939,2186.085532,1,0,0,1,25,1994,Anique Snijders
201309,2186.083995,1,0,0,1,18,2009,Tatiana Perebiynis
200638,2186.082638,16,7,0,9,11,1992,Stephanie Rottier
202073,2186.079399,1,0,0,1,50,1993,Chin Bee Khoo
201729,2186.077501,3,1,0,2,38,2001,Larissa Schaerer
202195,2186.076079,1,0,0,1,6,1996,Petra Gaspar
206458,2186.07087,3,1,0,2,37,1996,Maria Eugenia Fernandez
202409,2186.069751,1,0,0,1,5,2008,Alisa Ogorodova
202296,2186.068042,1,0,0,1,41,2005,Maria Jose Lopez Herrera
201077,2186.06399,1,0,0,1,25,1999,Sophie Lefevre
201696,2186.063479,1,0,0,1,17,2010,Laura Siegemund
202347,2186.061287,1,0,0,1,7,2006,Karolina Kosinska
201343,2186.060601,1,0,0,1,38,2011,Maret Ani
202350,2186.059671,1,0,0,1,5,2005,Olena Antypina
202276,2186.058904,3,1,0,2,53,2002,Shelley Bryce
201337,2186.057655,1,0,0,1,43,2003,Allison Baker
201405,2186.056188,1,0,0,1,11,2001,Nan Nan Liu
202283,2186.055282,1,0,0,1,40,2004,Anouska Van Exel
201516,2186.053812,3,1,0,2,38,2012,Evgeniya Rodina
201283,2186.052141,1,0,0,1,10,1999,Zuzana Lesenarova
205136,2186.049222,1,0,0,1,31,2005,Barbara Pocza
201512,2186.048687,1,0,0,1,42,2007,Monica Niculescu
201070,2186.048132,1,0,0,1,23,1997,Emmanuelle Curutchet
201579,2186.046982,1,0,0,1,37,2012,Yurika Sema
202363,2186.046181,1,0,0,1,9,2006,Vivien Silfany Tony
204840,2186.043592,1,0,0,1,26,2010,Liudmila Nikoyan
202068,2186.043562,1,0,0,1,26,1993,Petra Raclavska
212741,2186.036496,1,0,0,1,47,2000,Simin Liu
202123,2186.036024,3,1,0,2,33,1992,Suvimol Duangchan
202364,2186.035082,3,1,0,2,40,2009,Sandy Gumulya
212281,2186.034419,3,1,0,2,23,2011,Monica Matias
213892,2186.03419,1,0,0,1,14,2014,Nazrin Jafarova
200447,2186.032928,1,0,0,1,27,1990,Adriana Villagran Reami
200545,2186.027106,3,1,0,2,57,1994,Ei Iida
202322,2186.025459,1,0,0,1,3,2003,Maki Arai
201380,2186.022825,1,0,0,1,26,2010,Claudine Schaul
201418,2186.020096,5,2,0,3,6,2005,Ting Li
202066,2186.019548,1,0,0,1,48,1991,Sandra Reichel
212172,2186.018804,3,1,0,2,37,2003,Maylani Ah Hoy
201865,2186.017901,1,0,0,1,58,1999,Alicia Ortuno
202308,2186.017901,1,0,0,1,41,2006,Paula Garcia
201647,2186.017711,1,0,0,1,24,1998,Jasmin Woehr
202075,2186.017118,1,0,0,1,59,1994,Julia Jehs
201324,2186.01645,3,1,0,2,36,1995,Irina Selyutina
212266,2186.016332,1,0,0,1,45,2010,Khee Yen Wee
202012,2186.01606,1,0,0,1,12,1993,Lee Chan
212675,2186.015604,1,0,0,1,46,1993,Vivian Acra
210451,2186.015516,5,2,0,3,26,2009,Olga Terteac
207695,2186.014763,3,1,0,2,25,1998,Issem Essaies
212358,2186.014054,1,0,0,1,25,1998,Temesgen Metasebeya
202404,2186.013849,1,0,0,1,19,2008,Maite Gabarrus Alonso
200064,2186.012288,5,2,0,3,45,2004,Amanda Coetzer
212377,2186.011769,1,0,0,1,48,1992,Catriona Mccarthy
200774,2186.011502,1,0,0,1,7,1999,Vanessa Webb
200569,2186.009609,1,0,0,1,45,1998,Petra Pichalova Langrova
201357,2186.009419,1,0,0,1,21,2006,Virginie Pichet
201365,2186.006637,27,13,0,14,1,2008,Edina Gallovits Hall
200046,2186.006535,1,0,0,1,55,1997,Meghann Shaughnessy
212599,2186.005614,1,0,0,1,22,1994,Magali Benitez
201295,2186.005314,1,0,0,1,6,1996,Wynne Prakusya
212082,2186.004978,1,0,0,1,39,1994,Lisa Camenzuli
203341,2186.004681,1,0,0,1,8,2014,Sanaz Marand
200012,2186.003345,25,11,0,14,3,1995,Jana Nejedly
204970,2186.002266,1,0,0,1,38,2003,Karina Ildor Jacobsgaard
200424,2186.002132,26,13,0,13,19,1990,Etsuko Inoue
202219,2186.001985,1,0,0,1,8,1994,Keiko Nagatomi
201814,2186.000922,1,0,0,1,14,1999,Michelle Gerards
201476,2186.000773,1,0,0,1,43,2010,Lauren Albanese
212097,2185.997643,3,1,0,2,33,2005,Shaza Tinawi
200034,2185.997458,1,0,0,1,34,1999,Amanda Grahame
210660,2185.997373,1,0,0,1,37,2013,Joana Vale Costa
212145,2185.99701,3,1,0,2,37,2003,Gurianna Korinihona
212287,2185.996838,1,0,0,1,23,2011,Trevine Sellier
201729,2185.996077,3,1,0,2,37,1996,Larissa Schaerer
212448,2185.996049,3,1,0,2,29,1997,Carla Jimenez
201680,2185.996049,1,0,0,1,36,2004,Anna Gerasimou
201492,2185.996049,1,0,0,1,43,2008,Andrea Petkovic
212270,2185.996049,1,0,0,1,31,2010,Niamh Coveney
202482,2185.995302,1,0,0,1,20,2012,Barbara Haas
213020,2185.995259,1,0,0,1,39,2013,Guljahan Kadyrova
212108,2185.995258,1,0,0,1,27,2002,Sasha Fisher
212462,2185.994605,3,1,0,2,21,1991,Vajira Premaratne
207947,2185.992089,1,0,0,1,47,2000,Yamile Fors Guerra
200014,2185.990099,1,0,0,1,38,1995,Tzipi Obziler
203521,2185.989801,1,0,0,1,14,2015,Andrea Gamiz
202496,2185.989392,1,0,0,1,8,2014,Samantha Crawford
212409,2185.985947,1,0,0,1,39,1994,Kristina Grunberg
202363,2185.97898,1,0,0,1,39,2008,Vivien Silfany Tony
202966,2185.97841,3,1,0,2,52,2001,Courtenay Chapman
204716,2185.97841,7,3,0,4,52,2001,Nadine Schlotterer
212230,2185.978136,3,1,0,2,31,2014,Olivia Bennett
212420,2185.978103,3,1,0,2,40,1993,Saranga Sangakkara
200612,2185.978077,3,1,0,2,11,1997,Natalia Medvedeva
212113,2185.978073,3,1,0,2,29,2001,Maria Elena Gittens
212554,2185.978071,3,1,0,2,33,1998,Kelly Holland
201609,2185.977867,1,0,0,1,38,2008,Yi Miao Zhou
214630,2185.977285,3,1,0,2,43,2014,Hjordis Rosa Gudmundsdottir
203453,2185.977282,1,0,0,1,45,2010,Aranza Salut
201943,2185.976738,1,0,0,1,34,1999,Ivana Bracun
212228,2185.976642,1,0,0,1,25,2008,Ana Lilyan Guzman
200445,2185.976497,1,0,0,1,57,1992,Svetlana Cherneva
202047,2185.976495,3,1,0,2,52,2002,Agustine Limanto
212099,2185.976495,3,1,0,2,52,2002,Sonya Kumar
209585,2185.976348,5,2,0,3,25,2008,Stefana Lakicevic
200159,2185.975706,1,0,0,1,48,1991,Rosie Casals
200396,2185.975706,1,0,0,1,48,1991,Kim Steinmetz
207262,2185.975706,1,0,0,1,25,1991,Janaki Krishnamoorthy
200743,2185.975706,1,0,0,1,34,1992,Nirupama Sanjeev
202187,2185.975706,1,0,0,1,60,1992,Ilana Berger
200563,2185.975706,1,0,0,1,63,1993,Jane Taylor
201760,2185.975706,1,0,0,1,57,1993,Heidi Sprung
212378,2185.975706,3,1,0,2,47,1993,Joanna Bauza
201276,2185.975706,1,0,0,1,57,1994,Nicole London
212613,2185.975706,1,0,0,1,46,1994,Beverly Corbie
202193,2185.975706,1,0,0,1,6,1995,Maria Veronica Widyadharma
200071,2185.975706,1,0,0,1,34,1996,Lenka Nemeckova
202265,2185.975706,5,2,0,3,54,1996,Mirielle Dittmann
203653,2185.975706,1,0,0,1,54,1996,Esther Knox
203905,2185.975706,1,0,0,1,54,1996,Lechia Trewick
204171,2185.975706,1,0,0,1,54,1996,Yuki Kitamura
207828,2185.975706,3,1,0,2,48,1996,Paula Iversen
212055,2185.975706,3,1,0,2,54,1996,Juliet Drew
212717,2185.975706,1,0,0,1,49,1996,Nicola Corn
212549,2185.975706,1,0,0,1,27,1997,Tara Deen Moore
212556,2185.975706,1,0,0,1,25,1997,Natasha Kelly
212601,2185.975706,1,0,0,1,37,1997,Agathe Belibi
200730,2185.975706,1,0,0,1,55,1998,Min Tang
207152,2185.975706,1,0,0,1,45,1998,Bree Calderwood
207543,2185.975706,1,0,0,1,54,1998,Jennifer Saret
212061,2185.975706,1,0,0,1,45,1998,Verica Spirovska
212063,2185.975706,1,0,0,1,45,1998,Nanette Flichtbeil
212766,2185.975706,1,0,0,1,36,1998,Karla Umana
200637,2185.975706,1,0,0,1,61,1999,Catherine Barclay
201637,2185.975706,1,0,0,1,46,1999,Melissa Torres Sandoval
201866,2185.975706,1,0,0,1,58,1999,Cristina Arribas
212085,2185.975706,1,0,0,1,53,1999,Davilyn Godinet
212592,2185.975706,1,0,0,1,31,1999,Dominique Toliravo
201467,2185.975706,1,0,0,1,43,2000,Ivana Abramovic
202766,2185.975706,3,1,0,2,59,2000,Nicole Rencken
212743,2185.975706,1,0,0,1,48,2000,Roxana Abdurakhmonova
200029,2185.975706,1,0,0,1,59,2001,Lisa Mcshea
204855,2185.975706,1,0,0,1,52,2001,Sarah Stone
207298,2185.975706,3,1,0,2,52,2001,Simona Arghire
212108,2185.975706,3,1,0,2,28,2001,Sasha Fisher
212122,2185.975706,1,0,0,1,29,2001,Shonette Wilson
212114,2185.975706,1,0,0,1,30,2002,Anais Marie Moreno
202335,2185.975706,7,3,0,4,45,2003,Antonia Matic
202961,2185.975706,1,0,0,1,30,2003,Adriana Basaric
204083,2185.975706,1,0,0,1,45,2003,Chattida Thimjapo
204211,2185.975706,1,0,0,1,45,2003,Lara Giltinan
207933,2185.975706,1,0,0,1,30,2003,Sana Ben Salah
212170,2185.975706,1,0,0,1,38,2003,Norzafira Taufik
200733,2185.975706,1,0,0,1,50,2004,Trudi Musgrave
201410,2185.975706,1,0,0,1,51,2004,Monique Adamczak
208023,2185.975706,1,0,0,1,37,2004,Alyssa Ann Labay
212190,2185.975706,1,0,0,1,38,2004,Almira Hallyeva
212202,2185.975706,1,0,0,1,32,2005,Mariaryeni Gutierrez
201322,2185.975706,1,0,0,1,32,2006,Eva Dyrberg
212222,2185.975706,1,0,0,1,27,2006,Amel Benhaj
201682,2185.975706,1,0,0,1,43,2007,Nudnida Luangnam
202635,2185.975706,1,0,0,1,35,2007,Jin A Lee
209369,2185.975706,1,0,0,1,32,2007,Emma Sofia Helisten
212227,2185.975706,1,0,0,1,34,2007,Maria De Los Angeles Cardenas
212233,2185.975706,1,0,0,1,35,2007,Shenelle Mohammed
201388,2185.975706,1,0,0,1,43,2008,Sophie Ferguson
201697,2185.975706,1,0,0,1,24,2008,Kristyna Pliskova
212245,2185.975706,1,0,0,1,41,2008,Carolyn Ann Lim Hui
201607,2185.975706,1,0,0,1,44,2009,Sally Peers
202644,2185.975706,3,1,0,2,50,2011,Ting Fei Juan
205600,2185.975706,1,0,0,1,32,2011,Anna Movsisyan
202462,2185.975706,1,0,0,1,39,2012,Karen Castiblanco
211014,2185.975706,1,0,0,1,43,2012,Tatjana Vorobjova
206177,2185.975706,1,0,0,1,26,2013,Joana Eidukonyte
200746,2185.974917,1,0,0,1,54,2001,Sandra Kloesel
202330,2185.974916,1,0,0,1,42,2005,Maria Vanina Garcia Sokol
202463,2185.974916,1,0,0,1,39,2012,Ines Ferrer Suarez
202362,2185.974738,1,0,0,1,15,2006,Teodora Mircic
200020,2185.974128,1,0,0,1,42,2007,Lisa Raymond
200479,2185.972154,1,0,0,1,40,1991,Emiko Okagawa
200115,2185.966867,1,0,0,1,12,1995,Brie Rippner
202166,2185.964399,1,0,0,1,6,1991,Emilie Viqueira
201880,2185.964342,1,0,0,1,33,1996,Melinda Petkes
204451,2185.964203,1,0,0,1,33,2000,Asimina Kaplani
201571,2185.963245,1,0,0,1,35,2013,Masa Zec Peskiric
202203,2185.963224,3,1,0,2,36,1995,Yu Min Fan Chiang
200553,2185.963039,1,0,0,1,39,1991,Carin Bakkum
200563,2185.96191,5,2,0,3,60,1994,Jane Taylor
212428,2185.960241,3,1,0,2,48,1996,Mmaphala Letsatle
202647,2185.958014,1,0,0,1,25,2013,Madrie Le Roux
204352,2185.957837,1,0,0,1,16,2014,Yvonne Neuwirth
202266,2185.957609,1,0,0,1,23,2006,Kelly Liggan
201289,2185.957029,1,0,0,1,23,2003,Christina Wheeler
201806,2185.956366,1,0,0,1,57,1994,Ying Bi
204690,2185.956239,1,0,0,1,35,2005,Czarina Mae Arevalo
212484,2185.956237,1,0,0,1,35,1992,Alexandra Kleffel
201854,2185.956156,1,0,0,1,63,2000,Mariana Mesa
212271,2185.956156,1,0,0,1,31,2010,Maria Moya
202779,2185.956152,1,0,0,1,32,2004,Tinatin Kavlashvili
212500,2185.956125,3,1,0,2,32,1992,Aradhana Reddy
201941,2185.9561,1,0,0,1,37,1998,Dora Krstulovic
201930,2185.955366,1,0,0,1,57,1992,Monica Guglielmi
212418,2185.955366,1,0,0,1,41,1993,Nahia Abou Khalil
212512,2185.955366,1,0,0,1,36,1997,Juliana Jonsdottir
200103,2185.955366,1,0,0,1,60,1998,Evie Dominikovic
200653,2185.955366,1,0,0,1,61,1999,Yayuk Basuki
200034,2185.955366,3,1,0,2,58,2001,Amanda Grahame
201682,2185.955366,1,0,0,1,45,2011,Nudnida Luangnam
201617,2185.955366,1,0,0,1,30,2014,Ana Vrljic
203489,2185.955366,1,0,0,1,49,2014,Hao Chen Tang
201744,2185.954881,1,0,0,1,18,1993,Caroline Schneider
212146,2185.954638,1,0,0,1,30,2003,Sarah Wetz
212057,2185.954577,1,0,0,1,62,1997,Sarah Gillespie Jones
200735,2185.954577,1,0,0,1,44,2005,Miho Saeki
207213,2185.952821,1,0,0,1,33,2005,Anastasia Michail
201079,2185.952335,1,0,0,1,47,1999,Hannah Collin
201307,2185.952146,1,0,0,1,14,2001,Amber Liu
202049,2185.949863,1,0,0,1,50,1997,Daria Chernova
212074,2185.949101,1,0,0,1,9,1999,Natsuko Matsuda
201298,2185.948617,1,0,0,1,50,2000,Zsofia Gubacsi
202681,2185.948415,3,1,0,2,8,2014,Gabriela Dabrowski
202260,2185.948181,1,0,0,1,22,2001,Nicole Remis
201514,2185.946602,1,0,0,1,13,2006,Sorana Cirstea
201773,2185.946572,1,0,0,1,35,1992,Diedre Herman
203431,2185.945273,1,0,0,1,42,2014,Keren Shlomo
206894,2185.942322,1,0,0,1,39,2004,Mette Iversen
202048,2185.941756,1,0,0,1,21,2004,Liza Andriyani
201708,2185.939001,3,1,0,2,26,2009,Natalie Grandin
201452,2185.936607,1,0,0,1,54,2001,Lourdes Dominguez Lino
201645,2185.936607,1,0,0,1,42,2005,Frederica Piedade
202069,2185.936116,1,0,0,1,23,2000,Jenny Zika
201927,2185.935875,1,0,0,1,65,1997,Ludmilla Varmuza
200489,2185.935818,1,0,0,1,51,1991,Yukie Koizumi
200034,2185.93509,1,0,0,1,54,1996,Amanda Grahame
212166,2185.93509,1,0,0,1,30,2002,Lerissa Maurice
202185,2185.934784,3,1,0,2,38,2001,Anna Bielen Zarska
201082,2185.934409,1,0,0,1,22,1999,Lorna Woodroffe
201368,2185.933061,1,0,0,1,35,2002,Karolina Sprem
201561,2185.931516,1,0,0,1,21,2010,Claire Feuerstein
200491,2185.929567,1,0,0,1,28,1991,Christina Singer
201958,2185.925997,1,0,0,1,38,1999,Angela Cardoso
200684,2185.924,34,16,0,18,0,1998,Shi Ting Wang
201430,2185.923568,3,1,0,2,1,2005,Yulia Fedossova
201928,2185.92317,1,0,0,1,25,1996,Julia Lutrova
202611,2185.922964,1,0,0,1,13,2013,Oksana Kalashnikova
201306,2185.922845,1,0,0,1,5,2000,Marie Gaiane Mikaelian
202433,2185.92189,1,0,0,1,18,2011,Anna Giulia Remondina
205126,2185.919844,1,0,0,1,31,2005,Sousan Massi
202201,2185.919525,1,0,0,1,8,1992,Kiyoko Yazawa
202640,2185.916136,1,0,0,1,4,2015,Irina Ramialison
200754,2185.912022,1,0,0,1,11,1996,Jill Craybas
201540,2185.911956,38,15,0,23,3,2014,Kristina Mladenovic
201516,2185.903429,6,2,0,4,3,2009,Evgeniya Rodina
202377,2185.903046,1,0,0,1,14,2007,Brittany Augustine
201632,2185.901632,1,0,0,1,3,2003,Ryoko Fuda
202396,2185.900947,1,0,0,1,35,2008,Nadja Roma
201645,2185.899005,1,0,0,1,30,2008,Frederica Piedade
200004,2185.898845,3,1,0,2,8,1992,Kerry Anne Guse
200747,2185.898784,1,0,0,1,8,1995,Haruka Inoue
202321,2185.897841,5,2,0,3,52,2002,Napaporn Tongsalee
202500,2185.897082,1,0,0,1,9,2012,Maria Sanchez
202271,2185.895589,1,0,0,1,19,2001,Vanessa Krauth
201772,2185.893388,1,0,0,1,48,1991,Aranzazu Gallardo
200555,2185.890394,1,0,0,1,18,1993,Valda Lake
201483,2185.889954,1,0,0,1,9,2012,Madison Brengle
200608,2185.88933,26,10,0,16,2,1991,Audra Keller
201397,2185.887366,13,6,0,7,21,2015,Shuai Peng
201401,2185.885182,3,1,0,2,8,2009,Abigail Spears
201633,2185.88116,1,0,0,1,9,2005,Tomoko Yonemura
201964,2185.875257,1,0,0,1,17,1990,Tania Couto
201577,2185.870475,1,0,0,1,35,2013,Heidi El Tabakh
201187,2185.869405,1,0,0,1,30,1991,Shawna Martin
201081,2185.869371,1,0,0,1,24,1994,Joanne Ward
201823,2185.86901,1,0,0,1,21,2002,Daphne Van De Zande
201321,2185.867823,1,0,0,1,16,2007,Antonella Serra Zanetti
212612,2185.862571,1,0,0,1,42,1993,Jean Marie Lozano
201202,2185.862267,1,0,0,1,22,1999,Abigail Tordoff
200566,2185.857851,31,14,0,17,0,1990,Donna Faber
200159,2185.855268,1,0,0,1,31,1990,Rosie Casals
201863,2185.854592,1,0,0,1,16,2006,Alice Canepa
200107,2185.85243,19,10,0,9,10,1998,Paola Suarez
200698,2185.850867,2,0,0,2,7,1992,Petra Begerow
201088,2185.846403,1,0,0,1,24,1994,Karen Cross
201648,2185.844399,1,0,0,1,18,2012,Naomi Broady
207421,2185.843593,1,0,0,1,42,1994,Ruta Deduraite
214639,2185.843272,1,0,0,1,34,2014,Ancia Ifill
201703,2185.83502,1,0,0,1,8,2010,Yi Fan Xu
201662,2185.835015,1,0,0,1,24,2007,Karolina Pliskova
202451,2185.834926,1,0,0,1,20,2012,Nicole Rottmann
201942,2185.830923,3,1,0,2,40,2003,Andreea Ehritt Vanc
201881,2185.826868,1,0,0,1,50,1997,Nora Koves
202430,2185.821702,5,2,0,3,14,2015,Alize Lim
204561,2185.818461,1,0,0,1,40,1996,Ana Gaspar
202284,2185.814552,1,0,0,1,24,2002,Mariona Gallifa Puig Desens
201071,2185.814066,1,0,0,1,22,1998,Segolene Berger
200593,2185.814038,1,0,0,1,54,1992,Karine Quentrec
201459,2185.804926,1,0,0,1,11,2002,Zi Yan
202151,2185.803936,1,0,0,1,17,1997,Milena Nekvapilova
200486,2185.796789,13,6,0,7,6,1990,Csilla Cserepy
202153,2185.789989,1,0,0,1,3,2004,Melanie Marois
212001,2185.779048,3,1,0,2,31,2015,Natalia Vikhlyantseva
202410,2185.775594,3,1,0,2,37,2013,Sofia Shapatava
201685,2185.768772,1,0,0,1,6,2007,Kristina Antoniychuk
201082,2185.766287,3,1,0,2,24,2000,Lorna Woodroffe
201326,2185.763172,3,1,0,2,19,2001,Bahia Mouhtassine
202102,2185.761299,1,0,0,1,6,1996,Kaoru Shibata
202451,2185.75976,1,0,0,1,7,2011,Nicole Rottmann
201655,2185.756646,1,0,0,1,16,2009,Anna Floris
201343,2185.754922,6,2,0,4,22,2003,Maret Ani
202121,2185.751907,1,0,0,1,0,1996,Benjamas Sangaram
202136,2185.751619,1,0,0,1,2,1991,Michele Wreem
201845,2185.744392,3,1,0,2,27,1992,Stella Sampras
200598,2185.740655,1,0,0,1,4,1996,Jeri Ingram
201400,2185.735306,38,19,0,19,4,2008,Nicole Vaidisova
201537,2185.730885,20,8,0,12,4,2011,Patricia Mayr Achleitner
201926,2185.72904,1,0,0,1,2,1991,Stephanie Reece
201859,2185.725822,3,1,0,2,34,1999,Luciana Masante
202659,2185.725513,1,0,0,1,9,2015,Tereza Mrdeza
202290,2185.720594,5,2,0,3,7,2002,Kyung Mi Chang
201066,2185.719066,3,1,0,2,0,1991,Neus Avila Bonastre
201863,2185.715371,1,0,0,1,16,2004,Alice Canepa
202467,2185.713741,5,2,0,3,16,2014,Elitsa Kostova
201518,2185.712433,3,1,0,2,17,2007,Yanina Wickmayer
211539,2185.705294,1,0,0,1,20,2014,Fiona Ferro
201920,2185.699704,1,0,0,1,13,1997,Renata Kolbovic
202395,2185.699465,1,0,0,1,26,2009,Maria Irigoyen
201811,2185.694352,3,1,0,2,45,1998,Young Ja Choi
202039,2185.694055,1,0,0,1,14,1998,Ceylan Konuk
201612,2185.692675,1,0,0,1,6,2007,Junri Namigata
201963,2185.692382,1,0,0,1,17,1990,Sofia Prazeres
201307,2185.691033,1,0,0,1,15,2007,Amber Liu
200020,2185.686717,1,0,0,1,13,1990,Lisa Raymond
200480,2185.684724,1,0,0,1,15,1994,Claudia Porwik
201191,2185.68237,7,3,0,4,54,1996,Shirli Ann Siddall
201530,2185.680834,1,0,0,1,8,2011,Gail Brodsky
201963,2185.68078,3,1,0,2,48,1992,Sofia Prazeres
201324,2185.679957,1,0,0,1,16,2001,Irina Selyutina
202119,2185.674781,1,0,0,1,34,1991,Olivia Fery
200682,2185.672437,22,9,0,13,0,1999,Joannette Kruger
200005,2185.668569,3,1,0,2,53,1992,Jolene Watanabe Giltz
201740,2185.668214,1,0,0,1,30,1994,Christiane Hofmann
202388,2185.659385,1,0,0,1,5,2008,Dilyara Saidkhodjaeva
212541,2185.657593,5,2,0,3,31,1998,Camille Walter
201899,2185.657346,1,0,0,1,23,1995,Luciana Tella
201081,2185.647225,1,0,0,1,19,1998,Joanne Ward
201940,2185.647185,1,0,0,1,34,1996,Mirela Vladulescu
201812,2185.644671,1,0,0,1,9,1993,Hiroko Mochizuki
202425,2185.64449,1,0,0,1,21,2011,Samantha Murray
200508,2185.643455,1,0,0,1,11,1991,Virginie Paquet
211321,2185.642063,1,0,0,1,36,2015,Klaartje Liebens
201186,2185.62962,1,0,0,1,25,1992,Virginia Humphreys Davies
214621,2185.629554,1,0,0,1,46,2014,Sadaf Sadeghvaziri
201634,2185.628911,1,0,0,1,36,2008,Viky Nunez Fuentes
200680,2185.626206,1,0,0,1,34,1996,Nadin Ercegovic
200959,2185.624212,1,0,0,1,13,1994,Mareen Louie Harper
202044,2185.622083,1,0,0,1,43,1996,Eny Sulistyowati
201311,2185.622041,3,1,0,2,11,2001,Roberta Vinci
200713,2185.621103,1,0,0,1,52,1993,Yuka Yoshida
200031,2185.620515,5,2,0,3,0,1998,Meilen Tu
200746,2185.619333,1,0,0,1,15,2009,Sandra Kloesel
201673,2185.618916,1,0,0,1,7,2009,Alexandra Kolesnichenko
202688,2185.611658,1,0,0,1,41,2012,Isabella Shinikova
200554,2185.611527,1,0,0,1,25,1999,Brenda Schultz Mccarthy
200645,2185.60842,3,1,0,2,60,1995,Maja Zivec Skulj
201613,2185.603404,1,0,0,1,26,2012,Arina Rodionova
202563,2185.60055,1,0,0,1,40,2009,Pauline Wong
202248,2185.600252,1,0,0,1,23,1991,Cristina Moros
201211,2185.596577,1,0,0,1,16,2000,Kyra Nagy
201869,2185.595316,1,0,0,1,4,1999,Radka Pelikanova
200053,2185.592485,1,0,0,1,30,1994,Lubomira Bacheva
201674,2185.589401,1,0,0,1,7,2009,Sabina Sharipova
201805,2185.58567,1,0,0,1,39,1991,Pilar Perez
202399,2185.581748,1,0,0,1,38,2011,Margit Ruutel
201669,2185.581071,1,0,0,1,7,2008,Yan Chong Chen
201078,2185.580292,1,0,0,1,26,2000,Eugenia Kulikovskaya
201537,2185.577816,13,6,0,7,15,2010,Patricia Mayr Achleitner
206077,2185.576561,1,0,0,1,4,2014,Miharu Imanishi
201851,2185.570456,1,0,0,1,21,1995,Joanne Moore
202467,2185.569755,3,1,0,2,37,2012,Elitsa Kostova
202442,2185.567521,1,0,0,1,39,2008,Tatia Mikadze
201061,2185.567222,1,0,0,1,23,2002,Eva Martincova
201599,2185.567083,14,6,0,8,4,2014,Andrea Hlavackova
202288,2185.566625,1,0,0,1,47,2004,Elke Clijsters
200768,2185.566174,1,0,0,1,23,1997,Laurence Andretto
200071,2185.561421,5,2,0,3,21,2002,Lenka Nemeckova
202308,2185.55613,1,0,0,1,34,2004,Paula Garcia
211864,2185.551083,1,0,0,1,35,2014,Maria Fernanda Herazo Gonzalez
201404,2185.550644,1,0,0,1,44,2003,Jessica Kirkland
204362,2185.546305,5,2,0,3,37,2013,Theiviya Selvarajoo
201681,2185.544788,1,0,0,1,1,2002,Suchanun Viratprasert
200737,2185.541148,11,5,0,6,0,1998,Aleksandra Olsza
212521,2185.538281,1,0,0,1,42,1998,Faratiana Rasoarilalao
202318,2185.537656,1,0,0,1,3,2003,Pichittra Thongdach
201697,2185.537514,1,0,0,1,24,2007,Kristyna Pliskova
211510,2185.536313,3,1,0,2,27,2012,Rafaela Gomez
208426,2185.535413,1,0,0,1,32,2001,Carina Bjornstrom
201550,2185.53342,1,0,0,1,39,2008,Tamaryn Hendler
201348,2185.532551,3,1,0,2,46,2005,Casey Dellacqua
201527,2185.532464,1,0,0,1,18,2005,Stefanie Voegele
202435,2185.532228,1,0,0,1,15,2013,Vanda Lukacs
200376,2185.530034,1,0,0,1,8,2004,Katerina Bohmova
213634,2185.529757,1,0,0,1,25,2014,Rita Atik
200708,2185.529071,3,1,0,2,44,2003,Sandra Cacic
201646,2185.528158,3,1,0,2,24,2014,Maria Joao Koehler
201305,2185.527874,17,8,0,9,5,2008,Eleni Daniilidou
202188,2185.526741,1,0,0,1,34,1991,Valerie Batut
203073,2185.526275,7,3,0,4,54,1996,Caroline Bodart
201346,2185.524845,38,17,0,21,3,2004,Lubomira Kurhajcova
202257,2185.523671,5,2,0,3,35,1996,Carmina Giraldo
202150,2185.52154,1,0,0,1,30,1995,Jana Lubasova
201552,2185.520116,1,0,0,1,37,2010,Mallory Cecil
201534,2185.518492,1,0,0,1,14,2007,Asia Muhammed
201690,2185.516465,1,0,0,1,8,2004,Nina Bratchikova
202086,2185.515842,1,0,0,1,8,1990,Natalia Biletskaia
200662,2185.513518,3,1,0,2,61,1994,Joanne Limmer
201620,2185.513021,3,1,0,2,39,2009,Monica Puig
200616,2185.512839,1,0,0,1,35,1992,Pascale Etchemendy
202930,2185.512273,3,1,0,2,39,2009,Jessica Roland Rosario
210166,2185.511657,3,1,0,2,37,2013,Sara Mansoor
200125,2185.511195,1,0,0,1,57,1995,Corina Morariu
212096,2185.511165,1,0,0,1,56,1997,Shalini Perera
214634,2185.510892,3,1,0,2,31,2014,Camila Ramazzini
201341,2185.510476,1,0,0,1,50,1997,Mi Ra Jeon
202252,2185.509663,1,0,0,1,39,1991,Tanja Hauschildt
201440,2185.507682,1,0,0,1,14,2015,Laura Pous Tio
202134,2185.505511,1,0,0,1,5,2000,Katie Schlukebir
200774,2185.504564,1,0,0,1,13,1992,Vanessa Webb
201692,2185.502233,1,0,0,1,17,2010,Michaela Pochabova
200553,2185.50143,1,0,0,1,18,1993,Carin Bakkum
200402,2185.497736,1,0,0,1,57,1992,Wendy Prausa
201650,2185.496452,1,0,0,1,17,2009,Irina Buryachok
202264,2185.494734,1,0,0,1,50,2002,Cory Ann Avants
212353,2185.493674,3,1,0,2,48,1996,Senait Gebreail
206060,2185.493674,3,1,0,2,31,2011,Ani Amiraghyan
210624,2185.493519,3,1,0,2,43,2014,Kerstin Gressmann
200032,2185.493439,1,0,0,1,24,1992,Barbara Schett
204539,2185.493439,1,0,0,1,37,1996,Laura Bernal
201323,2185.493439,1,0,0,1,45,1998,Saori Obata
212081,2185.493439,1,0,0,1,30,2001,Helen Asciak
202393,2185.493439,1,0,0,1,38,2013,Andrea Koch Benvenuto
212361,2185.492713,5,2,0,3,34,1997,Fabienne Gmeiner
202021,2185.492626,1,0,0,1,49,1993,Estefania Bottini
200770,2185.492353,1,0,0,1,27,2000,Stephanie Cohen Aloro
202302,2185.492174,1,0,0,1,14,2015,Maria Fernanda Alves
212379,2185.4921,3,1,0,2,41,1992,Maribel Amadeo
201462,2185.491926,1,0,0,1,33,2013,Alberta Brianti
202365,2185.491526,1,0,0,1,9,2006,Lavinia Tananta
202488,2185.491305,1,0,0,1,14,2015,Valentyna Ivakhnenko
200598,2185.491114,1,0,0,1,37,1990,Jeri Ingram
201727,2185.487598,1,0,0,1,42,1994,Silvia Ramon Cortes
201287,2185.482954,11,5,0,6,6,2006,Maria Jose Martinez Sanchez
201728,2185.480055,1,0,0,1,53,1997,Jessica Steck
202444,2185.47823,1,0,0,1,13,2013,Kamilla Farhad
211014,2185.476562,1,0,0,1,26,2013,Tatjana Vorobjova
201392,2185.474985,1,0,0,1,3,2003,Severine Beltrame
201501,2185.474973,1,0,0,1,5,2006,Olga Govortsova
202176,2185.474773,1,0,0,1,0,1990,Jorgelina Moreno
212588,2185.474029,1,0,0,1,54,2000,Christine Lukalo
204715,2185.473998,1,0,0,1,41,1998,Cecilia Guillenea
202233,2185.473243,1,0,0,1,61,1993,Ayako Hirose
202076,2185.473243,1,0,0,1,58,1995,Eva Melicharova
201067,2185.473243,1,0,0,1,22,1998,Caroline Dhenin
208379,2185.473243,1,0,0,1,45,2001,Mahesha Seneviratne
201348,2185.473243,1,0,0,1,51,2003,Casey Dellacqua
208426,2185.473243,1,0,0,1,28,2003,Carina Bjornstrom
201413,2185.473243,1,0,0,1,46,2005,Capucine Rousseau
202394,2185.473243,1,0,0,1,37,2008,Camila Silva
204970,2185.473243,1,0,0,1,42,2008,Karina Ildor Jacobsgaard
212273,2185.473243,1,0,0,1,31,2010,Paloma Castillo
202432,2185.473243,1,0,0,1,42,2012,Hilda Melander
201440,2185.473243,1,0,0,1,35,2013,Laura Pous Tio
202419,2185.473243,1,0,0,1,39,2013,Barbara Luz
210439,2185.473243,1,0,0,1,37,2015,Ella Leivo
204182,2185.472699,1,0,0,1,9,1998,Motoe Uchida
204223,2185.472458,1,0,0,1,48,2014,Peangtarn Plipuech
201436,2185.472278,1,0,0,1,10,2005,Mary Gambale
205615,2185.471755,3,1,0,2,33,2011,Julia Moriarty
212399,2185.470966,3,1,0,2,27,1995,Shahira Tawfik
201640,2185.470697,1,0,0,1,32,2009,Maria Teresa Torro Flor
202393,2185.469773,3,1,0,2,31,2007,Andrea Koch Benvenuto
200062,2185.469441,3,1,0,2,57,1995,Kristina Brandi
201082,2185.467815,3,1,0,2,23,2001,Lorna Woodroffe
202430,2185.465733,1,0,0,1,18,2011,Alize Lim
201848,2185.460938,1,0,0,1,21,1995,Hye Jin Park
202693,2185.460686,1,0,0,1,2,2012,Ya Hsuan Lee
202353,2185.460302,3,1,0,2,30,2006,Maria Jose Argeri
201383,2185.459118,1,0,0,1,3,1998,Marie Eve Pelletier
200554,2185.457576,1,0,0,1,35,2008,Brenda Schultz Mccarthy
201326,2185.45667,1,0,0,1,23,2007,Bahia Mouhtassine
201634,2185.456424,3,1,0,2,30,2006,Viky Nunez Fuentes
206699,2185.454593,1,0,0,1,30,1999,Elena Manevska
204503,2185.454563,1,0,0,1,52,1997,Zorica Glisic
201549,2185.453981,1,0,0,1,39,2007,Petra Martic
212231,2185.453922,1,0,0,1,25,2008,Kristen Lopez
206320,2185.453022,1,0,0,1,45,2014,Vita Taher
207583,2185.452992,3,1,0,2,30,2001,Katrina Bandere
208251,2185.452992,1,0,0,1,37,2004,Maria Rossana Vega Saguier
209794,2185.452992,3,1,0,2,40,2008,Leticia Demichelli
212237,2185.452992,1,0,0,1,27,2009,Katherine Hoepelman
202387,2185.452992,1,0,0,1,9,2012,Vlada Ekshibarova
200773,2185.452992,1,0,0,1,38,2015,Stephanie Foretz Gacon
202502,2185.452992,1,0,0,1,37,2015,So Ra Lee
202172,2185.452668,1,0,0,1,18,1993,Ginevra Mugniani
202957,2185.451412,7,3,0,4,9,1998,Madoka Kuki
203968,2185.451412,3,1,0,2,53,2000,Dalia El Sheikh
200695,2185.451361,1,0,0,1,32,2005,Tina Krizan
201823,2185.44898,1,0,0,1,0,1997,Daphne Van De Zande
201087,2185.445435,1,0,0,1,37,2010,Mashona Washington
201633,2185.442202,1,0,0,1,5,2007,Tomoko Yonemura
208060,2185.441601,3,1,0,2,30,2001,Sihem Ben Youcef
201749,2185.440002,1,0,0,1,57,1994,Julie Shiflet
212602,2185.434313,1,0,0,1,41,1997,Silvana Vargas
205393,2185.433675,1,0,0,1,41,2012,Agni Stefanou
208521,2185.433531,1,0,0,1,36,2004,Karen Saravia
205399,2185.433531,1,0,0,1,44,2012,Jelena Stanivuk
202278,2185.43353,1,0,0,1,58,2002,Romy Farah
204294,2185.431919,3,1,0,2,7,2014,Su Jeong Jang
200687,2185.430586,8,3,0,5,22,1993,Katarzyna Nowak
212220,2185.428067,1,0,0,1,32,2006,Caitlin Gordon
201727,2185.424593,1,0,0,1,34,1996,Silvia Ramon Cortes
212509,2185.420004,1,0,0,1,30,1999,Irina Voskanyan
201675,2185.419161,1,0,0,1,7,2009,So Jung Kim
201377,2185.415657,1,0,0,1,25,2001,Yuliya Beygelzimer
201564,2185.414613,1,0,0,1,15,2010,Lenka Tvaroskova
203469,2185.414134,1,0,0,1,47,2010,Albina Khabibulina
202201,2185.412502,7,3,0,4,8,1996,Kiyoko Yazawa
203002,2185.406887,3,1,0,2,42,1999,Karin Palme
201927,2185.406506,3,1,0,2,6,1995,Ludmilla Varmuza
201370,2185.403385,1,0,0,1,26,2000,Anastasia Rodionova
201511,2185.40321,3,1,0,2,7,2007,Ekaterina Ivanova
201311,2185.39956,9,4,0,5,21,2002,Roberta Vinci
201446,2185.398542,12,5,0,7,2,2005,Sybille Bammer
201392,2185.396686,11,4,0,7,1,2008,Severine Beltrame
201952,2185.396541,1,0,0,1,36,1992,Elena Savoldi
200708,2185.390079,28,12,0,16,1,1994,Sandra Cacic
201633,2185.389811,1,0,0,1,4,2010,Tomoko Yonemura
207947,2185.385839,3,1,0,2,25,2008,Yamile Fors Guerra
201672,2185.383545,3,1,0,2,7,2010,Nigina Abduraimova
201754,2185.381572,3,1,0,2,30,2006,Leanne Baker
202496,2185.380509,1,0,0,1,10,2012,Samantha Crawford
201043,2185.375969,1,0,0,1,39,1991,Barbara Romano
201700,2185.371279,1,0,0,1,17,2006,Nikola Hofmanova
201599,2185.369493,1,0,0,1,24,2005,Andrea Hlavackova
201069,2185.367401,1,0,0,1,22,2000,Karolina Jagieniak
202420,2185.365936,1,0,0,1,17,2013,An Sophie Mestach
200450,2185.364032,28,12,0,16,3,1996,Larisa Savchenko
201087,2185.36401,1,0,0,1,35,2008,Mashona Washington
200606,2185.359683,3,1,0,2,46,2000,Nana Smith
200754,2185.353061,1,0,0,1,10,1998,Jill Craybas
201815,2185.348553,1,0,0,1,14,2011,Petra Rampre
201417,2185.344918,1,0,0,1,33,2002,Marta Domachowska
201749,2185.339432,1,0,0,1,18,1993,Julie Shiflet
201067,2185.336102,1,0,0,1,21,2001,Caroline Dhenin
204430,2185.333466,1,0,0,1,22,2015,Antonia Lottner
201630,2185.332781,1,0,0,1,52,1993,Nicole Hummel
200050,2185.325331,34,13,0,21,0,1997,Sandra Kleinova
201291,2185.322281,10,4,0,6,8,2004,Nuria Llagostera Vives
202189,2185.316376,1,0,0,1,23,1995,Anne Sophie Bittighoffer
201056,2185.304928,1,0,0,1,28,1992,Maria Luciana Reynares
201282,2185.302987,1,0,0,1,10,1998,Jean Okada
201502,2185.302675,3,1,0,2,5,2006,Tatjana Malek
202071,2185.30054,3,1,0,2,38,1999,Dragana Zaric
200668,2185.297584,17,7,0,10,6,1993,Silke Frankl
201719,2185.291063,3,1,0,2,14,1991,Stephanie Martin
206430,2185.289119,1,0,0,1,14,2015,Carolina Meligeni Rodrigues Alves
202066,2185.282034,1,0,0,1,12,1990,Sandra Reichel
201046,2185.281294,1,0,0,1,40,1991,Silvia La Fratta
201699,2185.277403,1,0,0,1,16,2010,Martina Caregaro
202030,2185.265943,1,0,0,1,26,1999,Carolina Rodriguez
201809,2185.265082,3,1,0,2,42,1998,Hila Rosen
200663,2185.257171,12,5,0,7,21,1991,Nanne Dahlman
201670,2185.254939,1,0,0,1,7,2013,Amra Sadikovic
201584,2185.254795,16,7,0,9,3,2010,Ksenia Pervak
200672,2185.245424,1,0,0,1,42,1998,Barbara Mulej
204595,2185.24418,3,1,0,2,38,1999,Charlotte Aagaard
202395,2185.232716,1,0,0,1,36,2008,Maria Irigoyen
200590,2185.22871,1,0,0,1,3,1993,Gisele Miro
202273,2185.221901,1,0,0,1,19,2001,Liga Dekmeijere
202162,2185.221145,1,0,0,1,17,1993,Page Bartelt
201479,2185.210587,1,0,0,1,36,2014,Olga Puchkova
200118,2185.208637,1,0,0,1,17,1990,Virginia Ruano Pascual
202501,2185.205633,1,0,0,1,8,2012,Hyun Hui Hong
201672,2185.197544,5,2,0,3,7,2013,Nigina Abduraimova
201450,2185.195665,36,17,0,19,1,2014,Tsvetana Pironkova
200511,2185.180593,3,1,0,2,36,1993,Amy Jonsson Raaholt
204806,2185.180178,3,1,0,2,39,1996,Anna Barinova
201749,2185.178969,1,0,0,1,52,1992,Julie Shiflet
202344,2185.175756,1,0,0,1,30,2005,Magda Mihalache
200050,2185.173722,1,0,0,1,13,2005,Sandra Kleinova
201742,2185.170924,1,0,0,1,14,1994,Susi Fortun Lohrmann
200578,2185.170418,1,0,0,1,4,1997,Rennae Stubbs
202231,2185.168821,1,0,0,1,12,2001,Shiho Hisamatsu
201690,2185.164182,1,0,0,1,5,2008,Nina Bratchikova
202489,2185.160982,1,0,0,1,16,2012,Carina Witthoeft
201899,2185.1547,3,1,0,2,36,1996,Luciana Tella
202491,2185.152991,1,0,0,1,15,2012,Varvara Flink
202286,2185.151085,1,0,0,1,23,2002,Elise Tamaela
202115,2185.149555,3,1,0,2,36,1993,Cathrine Instebo
201739,2185.148873,1,0,0,1,12,1990,Petra Schmitt
200480,2185.144817,9,4,0,5,18,1996,Claudia Porwik
200694,2185.14136,1,0,0,1,42,1991,Elly Hakami
201620,2185.14051,1,0,0,1,39,2011,Monica Puig
202434,2185.140379,5,2,0,3,8,2011,Aleksandra Krunic
201636,2185.140235,1,0,0,1,36,2009,Anna Orlik
201947,2185.137516,1,0,0,1,3,1993,Stephanie Mayorkis
201550,2185.131872,1,0,0,1,17,2007,Tamaryn Hendler
200073,2185.129817,1,0,0,1,19,1998,Julie Pullin
201860,2185.125425,1,0,0,1,21,2002,Mariam Ramon Climent
200114,2185.122616,1,0,0,1,16,1996,Patricia Wartusch
201598,2185.118224,3,1,0,2,26,2014,Noppawan Lertcheewakarn
201211,2185.115937,1,0,0,1,16,2008,Kyra Nagy
201839,2185.107714,1,0,0,1,34,2001,Syna Schreiber
200633,2185.107114,5,2,0,3,42,1991,Stacey Schefflin
201535,2185.10476,1,0,0,1,14,2006,Coco Vandeweghe
201671,2185.103319,1,0,0,1,7,2009,Ksenia Lykina
202126,2185.09992,3,1,0,2,54,1999,Marissa Niroj
202411,2185.095075,1,0,0,1,5,2008,Sariya Khairova
206007,2185.09349,1,0,0,1,40,2014,Laura Pigossi
201049,2185.092622,5,2,0,3,9,1996,Denisa Krajcovicova
201462,2185.091314,1,0,0,1,25,2001,Alberta Brianti
201612,2185.087622,1,0,0,1,38,2008,Junri Namigata
201869,2185.087199,1,0,0,1,15,1998,Radka Pelikanova
201280,2185.085042,1,0,0,1,50,1999,Jacqueline Trail
201464,2185.083556,1,0,0,1,21,2002,Nathalie Vierin
212131,2185.083195,3,1,0,2,29,2001,Tankiso Letseka
202192,2185.078606,1,0,0,1,6,1995,Tzu Ting Weng
201288,2185.07568,1,0,0,1,45,1997,Maja Palaversic Cooper Smith
206049,2185.075608,1,0,0,1,33,2015,Jovana Jaksic
200121,2185.075269,1,0,0,1,14,2009,Alina Jidkova
202403,2185.074925,1,0,0,1,19,2008,Leticia Costas
200045,2185.073654,1,0,0,1,52,1996,Tara Snyder
201088,2185.072867,1,0,0,1,21,1996,Karen Cross
200119,2185.071972,1,0,0,1,50,1997,Rita Kuti Kis
211684,2185.070249,1,0,0,1,35,2014,Magdalena Frech
201531,2185.067661,5,2,0,3,44,2011,Mariana Duque Marino
202444,2185.065769,1,0,0,1,15,2012,Kamilla Farhad
202473,2185.065499,1,0,0,1,33,2012,Annalisa Bona
201551,2185.062847,17,7,0,10,6,2011,Arantxa Rus
201603,2185.062645,1,0,0,1,39,2011,Shelby Rogers
201048,2185.05816,1,0,0,1,16,1992,Leona Laskova
213731,2185.050424,1,0,0,1,43,2014,Tami Grende
213604,2185.050288,1,0,0,1,14,2015,Luisa Stefani
201317,2185.050257,3,1,0,2,46,2010,Aniko Kapros
201295,2185.03671,7,3,0,4,1,1999,Wynne Prakusya
204123,2185.03552,3,1,0,2,41,1997,Maria Dolores Campana
202325,2185.031868,1,0,0,1,47,2004,Isha Lakhani
205789,2185.030631,1,0,0,1,45,2010,Na Ri Kim
212256,2185.028208,3,1,0,2,41,2012,Madona Najarian
200610,2185.024875,1,0,0,1,18,1993,Stacey Martin
212164,2185.015233,1,0,0,1,28,2002,Nicole Agostini
201811,2185.014928,1,0,0,1,62,1997,Young Ja Choi
212101,2185.013261,1,0,0,1,44,2001,Petroena Fong
202349,2185.012287,3,1,0,2,7,2005,Rushmi Chakravarthi
200721,2185.010133,1,0,0,1,15,1991,Hiromi Nagano
200026,2185.008676,50,23,0,27,0,1997,Florencia Labat
207947,2185.008468,3,1,0,2,45,2010,Yamile Fors Guerra
208207,2185.007706,3,1,0,2,44,2002,Ina Sartz
212220,2185.007706,3,1,0,2,32,2010,Caitlin Gordon
202253,2185.002237,1,0,0,1,33,1995,Marijana Kovacevic
200042,2185.000954,1,0,0,1,27,1992,Els Callens
200533,2184.998981,1,0,0,1,28,1990,Pam Casale Telford
201708,2184.997427,1,0,0,1,18,2003,Natalie Grandin
200441,2184.997343,4,1,0,3,24,1994,Louise Field
212058,2184.996863,1,0,0,1,52,1997,Tara Reid
202432,2184.995994,1,0,0,1,18,2011,Hilda Melander
201849,2184.995964,1,0,0,1,21,1995,Veronica Stele
200699,2184.99561,1,0,0,1,54,1992,Meredith Mcgrath
202023,2184.994992,1,0,0,1,39,1991,Maite Martinez Perez
200682,2184.994459,5,2,0,3,7,1992,Joannette Kruger
205611,2184.994455,1,0,0,1,35,2004,Gabriela Mejia Tenorio
202163,2184.993697,1,0,0,1,17,1993,Heather Willens
200004,2184.993498,1,0,0,1,27,1990,Kerry Anne Guse
204304,2184.992441,1,0,0,1,33,2015,Jawairiah Noordin
212117,2184.992126,1,0,0,1,36,2000,Lucia Henkle Gomez
202304,2184.992126,1,0,0,1,59,2002,Nicole Pitts
202101,2184.991497,1,0,0,1,10,1995,Patricia Rogulski
202234,2184.990484,1,0,0,1,7,1999,Monique Viele
207508,2184.989406,3,1,0,2,52,1995,Jil Lin Leong
202047,2184.987298,1,0,0,1,43,1996,Agustine Limanto
202204,2184.985801,1,0,0,1,0,1994,Yu Hsien Liu
201342,2184.980391,1,0,0,1,12,2002,Alexandra Podkolzina
201632,2184.980018,1,0,0,1,6,2004,Ryoko Fuda
207176,2184.977336,5,2,0,3,34,1997,Sona Saringulyan
201917,2184.975999,1,0,0,1,15,1991,Suzanne Italiano
204290,2184.97527,1,0,0,1,45,2010,Min Hwa Yu
204912,2184.975161,3,1,0,2,32,2000,Diana Majkic
201510,2184.974406,1,0,0,1,44,2011,Julie Ditty
202066,2184.974403,1,0,0,1,58,1992,Sandra Reichel
204793,2184.973756,1,0,0,1,10,1997,So Yeon Im
212129,2184.973565,1,0,0,1,30,2004,Caroline Oduor
201199,2184.973104,1,0,0,1,46,1995,Rachel Viollet
201078,2184.972815,1,0,0,1,47,2004,Eugenia Kulikovskaya
202644,2184.97203,1,0,0,1,44,2014,Ting Fei Juan
201269,2184.970304,1,0,0,1,10,1991,Eleni Rossides
208983,2184.967601,3,1,0,2,38,2002,Larikah Russell
202064,2184.965881,1,0,0,1,24,1992,Nike Dobrovits
202642,2184.96586,1,0,0,1,25,2014,Gioia Barbieri
200708,2184.963078,1,0,0,1,41,1991,Sandra Cacic
202437,2184.96177,1,0,0,1,14,2013,Anastasia Grymalska
201771,2184.960995,1,0,0,1,50,1997,Virag Csurgo
201723,2184.957309,1,0,0,1,45,1995,Angela Kerek
211684,2184.957173,1,0,0,1,30,2015,Magdalena Frech
201205,2184.956039,1,0,0,1,11,2001,Tracy Almeda Singian
200709,2184.954547,1,0,0,1,6,1999,Rosana De Los Rios
201472,2184.953517,1,0,0,1,37,2009,Romina Oprandi
204036,2184.949041,3,1,0,2,38,1999,Fabienne Thill
212513,2184.9472,1,0,0,1,40,1994,Mehry Shawki
201917,2184.941647,1,0,0,1,16,1990,Suzanne Italiano
200671,2184.941507,17,7,0,10,4,1997,Meike Babel
206060,2184.934273,3,1,0,2,25,2010,Ani Amiraghyan
201399,2184.933518,1,0,0,1,11,2012,Emily Webley Smith
201748,2184.933469,1,0,0,1,18,1993,Renata Kochta
204493,2184.928698,3,1,0,2,45,1998,Marylene Losey
201278,2184.925327,1,0,0,1,10,1995,Angela Lettiere
202420,2184.922242,1,0,0,1,28,2011,An Sophie Mestach
206111,2184.922165,1,0,0,1,2,2012,Hua Chen Lee
200114,2184.920433,3,1,0,2,18,1998,Patricia Wartusch
203453,2184.918681,1,0,0,1,26,2009,Aranza Salut
201044,2184.918595,1,0,0,1,27,1994,Catherine Mothes Jobkel
206279,2184.91822,1,0,0,1,0,2012,Stephanie Bengson
211885,2184.912799,1,0,0,1,15,2013,Alice Matteucci
202029,2184.910783,1,0,0,1,23,1998,Ana Salas Lozano
200769,2184.90406,1,0,0,1,19,2004,Giulia Casoni
202395,2184.894415,3,1,0,2,16,2011,Maria Irigoyen
201727,2184.893353,1,0,0,1,0,1991,Silvia Ramon Cortes
201313,2184.893207,5,2,0,3,4,2000,Yoon Jeong Cho
202413,2184.889758,3,1,0,2,25,2013,Florencia Molinero
201689,2184.889598,1,0,0,1,24,2010,Magali De Lattre
202147,2184.889544,1,0,0,1,16,1992,Zuzana Nemsakova
201288,2184.880223,1,0,0,1,27,1993,Maja Palaversic Cooper Smith
201450,2184.875947,39,18,0,21,3,2015,Tsvetana Pironkova
201659,2184.874252,1,0,0,1,15,2010,Melanie Klaffner
201057,2184.874218,1,0,0,1,28,1992,Angelique Olivier
200667,2184.874167,1,0,0,1,0,1990,Ines Gorrochategui
201429,2184.866236,1,0,0,1,8,2009,Rika Fujiwara
201597,2184.864528,44,21,0,23,4,2015,Kurumi Nara
200638,2184.857813,3,1,0,2,42,1996,Stephanie Rottier
201438,2184.85465,1,0,0,1,9,2012,Ekaterina Bychkova
201862,2184.834826,1,0,0,1,3,1993,Vanessa Menga
202119,2184.834355,1,0,0,1,11,1990,Olivia Fery
201863,2184.829048,1,0,0,1,17,1998,Alice Canepa
202425,2184.809016,1,0,0,1,20,2012,Samantha Murray
200704,2184.791821,1,0,0,1,48,1999,Maria Jose Gaidano
202203,2184.790016,1,0,0,1,0,1994,Yu Min Fan Chiang
200769,2184.786358,1,0,0,1,18,1995,Giulia Casoni
200348,2184.782522,17,8,0,9,19,1990,Hana Mandlikova
202313,2184.780457,1,0,0,1,32,2003,Darija Jurak
201313,2184.780191,1,0,0,1,0,1997,Yoon Jeong Cho
201497,2184.778448,3,1,0,2,15,2006,Agnes Szavay
202217,2184.776814,1,0,0,1,26,2000,Kamila Dadakhodjaeva
201390,2184.773682,1,0,0,1,16,2010,Mervana Jugic Salkic
201534,2184.769897,1,0,0,1,10,2008,Asia Muhammed
201665,2184.766834,1,0,0,1,14,2009,Ipek Senoglu
201800,2184.759302,1,0,0,1,18,1990,Annika Narbe
200959,2184.758871,28,12,0,16,2,1991,Mareen Louie Harper
200407,2184.752779,1,0,0,1,25,1994,Camille Benjamin
213634,2184.741716,1,0,0,1,25,2015,Rita Atik
201588,2184.738676,1,0,0,1,38,2005,Anna Tatishvili
206144,2184.72552,1,0,0,1,15,2013,Xenia Knoll
206124,2184.720708,3,1,0,2,13,2013,Tereza Martincova
201064,2184.709283,1,0,0,1,22,1995,Audrey Sidot
202426,2184.709244,1,0,0,1,8,2015,Julia Boserup
207461,2184.708384,3,1,0,2,41,1992,Kaisaran Siewrattan
201698,2184.704803,3,1,0,2,37,2002,Liana Gabriela Ungur
202386,2184.687961,1,0,0,1,6,2007,Sung Hee Han
200545,2184.683028,1,0,0,1,8,1992,Ei Iida
201448,2184.680628,7,3,0,4,8,2004,Galina Voskoboeva
204536,2184.675426,1,0,0,1,21,1992,Barbara Castro
201644,2184.670322,1,0,0,1,25,2009,Paula Fondevila Castro
201517,2184.659069,1,0,0,1,18,2005,Magdalena Rybarikova
201588,2184.652261,5,2,0,3,8,2009,Anna Tatishvili
201704,2184.649066,1,0,0,1,7,2010,Nadejda Guskova
200584,2184.649002,16,7,0,9,0,1997,Laura Golarsa
202031,2184.646513,1,0,0,1,41,2005,Rosa Maria Andres Rodriguez
200625,2184.645894,1,0,0,1,29,1994,Jana Pospisilova
201745,2184.642095,8,3,0,5,15,1992,Lupita Novelo
201598,2184.64003,1,0,0,1,38,2008,Noppawan Lertcheewakarn
201452,2184.638496,1,0,0,1,28,2000,Lourdes Dominguez Lino
202425,2184.626731,1,0,0,1,16,2013,Samantha Murray
200005,2184.625536,29,13,0,16,0,1994,Jolene Watanabe Giltz
200713,2184.622712,7,3,0,4,10,2000,Yuka Yoshida
201801,2184.621091,1,0,0,1,35,1992,Ana Maria Segura Perez
200727,2184.620939,17,7,0,10,6,1999,Adriana Serra Zanetti
200123,2184.616284,1,0,0,1,26,1996,Marlene Weingartner
203534,2184.613216,1,0,0,1,42,2014,Melis Sezer
202426,2184.594165,1,0,0,1,21,2011,Julia Boserup
201329,2184.587115,8,3,0,5,17,2014,Vera Zvonareva
202153,2184.582558,1,0,0,1,2,1999,Melanie Marois
202264,2184.579756,1,0,0,1,17,2001,Cory Ann Avants
201669,2184.578125,1,0,0,1,8,2009,Yan Chong Chen
200726,2184.577787,21,9,0,12,1,1995,Nancy Feber
201326,2184.576575,1,0,0,1,23,2006,Bahia Mouhtassine
200738,2184.576359,1,0,0,1,29,1994,Lenka Cenkova
201612,2184.575418,1,0,0,1,7,2009,Junri Namigata
206194,2184.57354,1,0,0,1,39,2014,Gabriela Ce
201466,2184.571919,30,13,0,17,10,2007,Kaia Kanepi
212126,2184.571795,1,0,0,1,52,2000,Tatevik Babayan
201535,2184.569161,1,0,0,1,14,2007,Coco Vandeweghe
203591,2184.566153,1,0,0,1,20,2015,Katy Dunne
201444,2184.565257,15,7,0,8,5,2007,Su Wei Hsieh
201959,2184.565132,1,0,0,1,25,2007,Ana Catarina Nogueira
201089,2184.560728,5,2,0,3,23,2001,Lucie Ahl
201409,2184.554491,7,2,0,5,6,2004,Michaela Pastikova
205465,2184.546381,3,1,0,2,32,2006,Daniela Trigo
201366,2184.54534,1,0,0,1,24,2006,Barbora Zahlavova Strycova
201864,2184.543372,1,0,0,1,16,1998,Celeste Contin
202343,2184.536225,1,0,0,1,41,2005,Erica Krauth
202506,2184.536042,1,0,0,1,8,2014,Margarita Gasparyan
201994,2184.535913,1,0,0,1,52,1992,Christine Oreilly
200055,2184.53445,1,0,0,1,10,1996,Mariana Diaz Oliva
201453,2184.531377,1,0,0,1,10,2008,Hana Sromova
201197,2184.531352,3,1,0,2,18,1996,Megan Miller
201485,2184.530751,1,0,0,1,13,2005,Alla Kudryavtseva
202435,2184.525758,1,0,0,1,18,2011,Vanda Lukacs
201703,2184.518129,1,0,0,1,7,2011,Yi Fan Xu
201292,2184.513456,1,0,0,1,40,1999,Martina Sucha
202330,2184.50953,1,0,0,1,16,2004,Maria Vanina Garcia Sokol
209174,2184.507048,3,1,0,2,32,2006,Adriana Pereira
201548,2184.503506,1,0,0,1,20,2012,Ajla Tomljanovic
200700,2184.500387,5,2,0,3,17,1990,Silvia Farina Elia
201515,2184.497124,1,0,0,1,39,2005,Alisa Kleybanova
201689,2184.485837,1,0,0,1,36,2011,Magali De Lattre
200586,2184.483897,1,0,0,1,30,1995,Federica Bonsignori
200565,2184.482514,11,4,0,7,6,1990,Nathalie Guerree Spitzer
201592,2184.477085,5,2,0,3,16,2014,Beatriz Garcia Vidagany
202047,2184.476685,1,0,0,1,6,1995,Agustine Limanto
212109,2184.475952,1,0,0,1,25,1997,Francine Harvey
201401,2184.46982,1,0,0,1,10,2002,Abigail Spears
202195,2184.468567,3,1,0,2,38,1994,Petra Gaspar
201446,2184.467031,1,0,0,1,23,2000,Sybille Bammer
200615,2184.459973,32,15,0,17,10,1991,Kristin Godridge
200479,2184.445563,1,0,0,1,27,1990,Emiko Okagawa
200028,2184.442316,1,0,0,1,21,1998,Maureen Drake
202295,2184.440729,1,0,0,1,11,2002,Ying Yu
200065,2184.440349,1,0,0,1,22,1995,Amelie Mauresmo
201482,2184.438402,1,0,0,1,0,2012,Andreja Klepac
200514,2184.435437,1,0,0,1,6,1996,Monique Javer
201677,2184.42956,1,0,0,1,7,2009,Mi Yoo
200687,2184.424263,6,2,0,4,21,1994,Katarzyna Nowak
202946,2184.420964,3,1,0,2,38,1994,Christina Zachariadou
201563,2184.419251,1,0,0,1,21,2004,Darya Kustova
201468,2184.417675,3,1,0,2,18,2006,Yaroslava Shvedova
201483,2184.416222,1,0,0,1,43,2010,Madison Brengle
201966,2184.401376,1,0,0,1,28,1991,Natalie Tschan
206252,2184.39855,1,0,0,1,8,2015,Barbora Krejcikova
201588,2184.391793,1,0,0,1,12,2008,Anna Tatishvili
201555,2184.388508,3,1,0,2,14,2008,Polona Hercog
201424,2184.382802,7,3,0,4,7,2004,Shahar Peer
202171,2184.38123,1,0,0,1,18,1993,Klara Blahova
201494,2184.380146,1,0,0,1,16,2014,Raluca Olaru
202205,2184.375793,1,0,0,1,0,1994,Shu Ping Lin
202218,2184.363915,1,0,0,1,24,1999,Anna Zaporozhanova
201591,2184.362442,3,1,0,2,17,2009,Margalita Chakhnashvili
201384,2184.359098,1,0,0,1,7,2005,Chia Jung Chuang
201502,2184.353688,5,2,0,3,4,2012,Tatjana Malek
200056,2184.353655,3,1,0,2,37,1998,Jelena Kostanic Tosic
201658,2184.332033,1,0,0,1,15,2009,Carmen Klaschka
202291,2184.324666,1,0,0,1,7,2002,Seiko Okamoto
200734,2184.324497,1,0,0,1,5,1993,Tatjana Jecmenica
200660,2184.320672,28,11,0,17,1,1994,Kimberly Po Messerli
200635,2184.320277,1,0,0,1,25,1994,Ingelise Driehuis
201659,2184.313237,3,1,0,2,2,2007,Melanie Klaffner
202294,2184.305501,1,0,0,1,6,2005,Yan Ze Xie
201346,2184.297704,1,0,0,1,8,2001,Lubomira Kurhajcova
201925,2184.28421,1,0,0,1,2,1994,Erica Adams
201401,2184.283735,1,0,0,1,20,2012,Abigail Spears
202488,2184.275263,1,0,0,1,17,2012,Valentyna Ivakhnenko
202334,2184.264112,4,1,0,3,18,2003,Hanna Nooni
201702,2184.257284,1,0,0,1,33,2012,Malou Ejdesgaard
200607,2184.244847,11,4,0,7,3,1993,Beate Reinstadler
202487,2184.239267,1,0,0,1,23,2015,Nastassja Burnett
201390,2184.238467,1,0,0,1,25,2012,Mervana Jugic Salkic
201648,2184.237846,1,0,0,1,20,2009,Naomi Broady
201740,2184.217163,1,0,0,1,12,1990,Christiane Hofmann
200093,2184.216365,1,0,0,1,22,1995,Amelie Cocheteux
200048,2184.215031,39,18,0,21,4,1995,Elena Likhovtseva
202366,2184.20374,1,0,0,1,7,2006,Sanaa Bhambri
201626,2184.201548,1,0,0,1,7,1995,Petra Winzenholler
201528,2184.197837,3,1,0,2,8,2014,Melanie Oudin
201375,2184.197398,5,2,0,3,8,2009,Shenay Perry
202293,2184.178806,1,0,0,1,11,2002,Jie Hao
201641,2184.17256,1,0,0,1,23,2007,Nadia Lalami
201365,2184.159858,14,6,0,8,10,2012,Edina Gallovits Hall
201648,2184.13115,1,0,0,1,20,2010,Naomi Broady
200586,2184.123254,25,12,0,13,0,1991,Federica Bonsignori
200579,2184.122896,3,1,0,2,45,1998,Karin Kschwendt
201489,2184.101066,1,0,0,1,5,2005,Mariya Koryttseva
200583,2184.094387,1,0,0,1,17,1993,Laxmi Poruri
201430,2184.093212,1,0,0,1,20,2009,Yulia Fedossova
201708,2184.092374,1,0,0,1,4,2010,Natalie Grandin
200100,2184.091588,4,1,0,3,16,1998,Amanda Hopmans
201675,2184.084709,1,0,0,1,6,2005,So Jung Kim
202251,2184.069862,1,0,0,1,2,1990,Katrina Greenman
202121,2184.068725,1,0,0,1,0,1998,Benjamas Sangaram
212186,2184.06212,3,1,0,2,32,2007,Yekaterina Morozova
201869,2184.055899,1,0,0,1,17,1997,Radka Pelikanova
200579,2184.051422,11,4,0,7,5,1992,Karin Kschwendt
201314,2184.043265,1,0,0,1,21,2002,Nina Duebbers
200775,2184.043088,3,1,0,2,48,1997,Tatiana Kovaltchouk
200393,2184.038816,1,0,0,1,27,1990,Lea Antonoplis
214219,2184.031212,1,0,0,1,3,2015,Tessah Andrianjafitrimo
200678,2184.017777,3,1,0,2,21,2002,Gloria Pizzichini
201418,2184.003702,3,1,0,2,10,2000,Ting Li
202483,2184.001772,3,1,0,2,15,2012,Sandra Zaniewska
201939,2183.966244,1,0,0,1,6,1995,Anique Snijders
202232,2183.956671,1,0,0,1,8,1994,Yuka Tanaka
200776,2183.925657,1,0,0,1,34,2002,Angelika Bachmann
201505,2183.919314,35,14,0,21,3,2010,Ekaterina Makarova
202302,2183.905734,11,5,0,6,11,2002,Maria Fernanda Alves
200119,2183.884722,3,1,0,2,38,1994,Rita Kuti Kis
201516,2183.881596,1,0,0,1,7,2013,Evgeniya Rodina
201077,2183.873325,1,0,0,1,23,2003,Sophie Lefevre
201319,2183.868088,4,1,0,3,21,2002,Evelyn Fauth
201455,2183.855137,1,0,0,1,3,2004,Elena Vesnina
200557,2183.854971,17,7,0,10,4,1996,Katrina Adams
200125,2183.846814,6,2,0,4,8,2002,Corina Morariu
202070,2183.838075,1,0,0,1,22,2000,Scarlett Werner
200715,2183.829451,1,0,0,1,2,1993,Mariaan De Swardt
202086,2183.809891,3,1,0,2,35,1993,Natalia Biletskaia
201327,2183.798156,43,20,0,23,3,2003,Angelique Widjaja
200769,2183.793495,17,7,0,10,8,2000,Giulia Casoni
201301,2183.790635,3,1,0,2,26,2001,Camille Pin
201205,2183.784534,2,0,0,2,7,1999,Tracy Almeda Singian
201836,2183.783274,1,0,0,1,10,1991,Svetlana Komleva
201729,2183.748979,5,2,0,3,20,1991,Larissa Schaerer
201519,2183.734509,1,0,0,1,20,2008,Violette Huck
200573,2183.731225,11,4,0,7,23,1993,Cecilia Dahlman
200727,2183.717171,5,2,0,3,5,1993,Adriana Serra Zanetti
201604,2183.711288,5,2,0,3,8,2014,Irina Falconi
201334,2183.708717,9,3,0,6,5,2007,Zuzana Ondraskova
201317,2183.703862,1,0,0,1,7,2008,Aniko Kapros
202261,2183.697457,3,1,0,2,19,2001,Joanna Sakowicz Kostecka
201605,2183.694276,3,1,0,2,36,2003,Mandy Minella
201047,2183.675125,3,1,0,2,0,1991,Andrea Vieira
201700,2183.668442,1,0,0,1,15,2010,Nikola Hofmanova
200666,2183.667571,1,0,0,1,29,1994,Marion Maruska
202378,2183.664288,1,0,0,1,16,2007,Kirsten Flower
200682,2183.657711,20,8,0,12,16,1993,Joannette Kruger
201568,2183.649947,1,0,0,1,2,2013,Kristina Kucova
201319,2183.643828,3,1,0,2,7,2001,Evelyn Fauth
201575,2183.642807,1,0,0,1,14,2011,Hilary Barte
201420,2183.641885,9,4,0,5,22,2012,Sania Mirza
200077,2183.641838,22,10,0,12,1,1997,Jennifer Capriati
201584,2183.639683,6,2,0,4,8,2014,Ksenia Pervak
202503,2183.626576,5,2,0,3,4,2015,Luksika Kumkhum
200109,2183.606088,46,21,0,25,7,2001,Nathalie Dechy
201291,2183.600738,10,4,0,6,23,2000,Nuria Llagostera Vives
200040,2183.594767,39,17,0,22,14,2001,Anna Smashnova
202041,2183.593785,5,2,0,3,7,1993,Joice Riana Sutedja
200068,2183.592713,34,15,0,19,5,2000,Lilia Osterloh
201191,2183.592381,11,5,0,6,19,1997,Shirli Ann Siddall
201089,2183.584463,3,1,0,2,24,2000,Lucie Ahl
200479,2183.57292,1,0,0,1,8,1992,Emiko Okagawa
202294,2183.565556,1,0,0,1,11,2002,Yan Ze Xie
201371,2183.554259,1,0,0,1,33,2002,Vera Dushevina
201279,2183.542737,1,0,0,1,16,1993,Keri Phebus
202487,2183.537126,12,5,0,7,6,2013,Nastassja Burnett
202468,2183.534067,6,2,0,4,12,2013,Jessica Pegula
201074,2183.528675,5,2,0,3,22,1998,Ana Alcazar
201580,2183.506568,3,1,0,2,7,2008,Xinyun Han
201396,2183.505762,1,0,0,1,19,2011,Katie Obrien
201383,2183.5035,3,1,0,2,9,2012,Marie Eve Pelletier
201945,2183.498541,1,0,0,1,3,1993,Patricia Segala
200768,2183.489489,1,0,0,1,25,2002,Laurence Andretto
200658,2183.481599,23,10,0,13,9,1993,Fang Li
201314,2183.481397,1,0,0,1,8,2000,Nina Duebbers
203433,2183.465819,1,0,0,1,0,2012,Rishika Sunkara
200655,2183.463094,26,11,0,15,3,1995,Nicole Arendt
202312,2183.451356,1,0,0,1,32,2003,Olga Vymetalkova
201727,2183.44633,1,0,0,1,3,1993,Silvia Ramon Cortes
202272,2183.439517,1,0,0,1,19,2001,Ana Timotic
201486,2183.435443,18,8,0,10,9,2014,Aleksandra Wozniak
201533,2183.408488,43,19,0,24,4,2014,Shuai Zhang
200091,2183.404253,20,10,0,10,1,1999,Janet Lee
200647,2183.376355,3,1,0,2,22,1998,Noelle Van Lottum
202089,2183.359675,1,0,0,1,9,1994,Irina Sukhova
202291,2183.342272,1,0,0,1,7,2003,Seiko Okamoto
202285,2183.332282,1,0,0,1,23,2002,Silvana Bauer
200032,2183.311824,41,17,0,24,5,2003,Barbara Schett
200094,2183.295079,33,15,0,18,3,1999,Barbara Rittner
202116,2183.290897,1,0,0,1,17,1997,Laura Dellangelo
201061,2183.277092,1,0,0,1,27,1993,Eva Martincova
204431,2183.272464,17,7,0,10,3,2014,Anna Lena Friedsam
200124,2183.263012,4,1,0,3,3,2009,Anne Kremer
200293,2183.262722,1,0,0,1,20,2005,Martina Navratilova
202068,2183.256325,1,0,0,1,23,2000,Petra Raclavska
200117,2183.254868,14,5,0,9,8,2002,Kveta Peschke
200711,2183.231049,4,1,0,3,2,1991,Tatiana Ignatieva
200010,2183.225294,1,0,0,1,10,2005,Rita Grande
206579,2183.218587,1,0,0,1,39,2001,Sarah Tami Masi
200071,2183.213851,3,1,0,2,11,1995,Lenka Nemeckova
200038,2183.207552,10,4,0,6,6,1995,Annabel Ellwood
201570,2183.202994,21,9,0,12,2,2013,Vesna Dolonc
202508,2183.196983,1,0,0,1,4,2015,Yuxuan Zhang
201304,2183.189776,33,15,0,18,3,2011,Elena Baltacha
201444,2183.173013,3,1,0,2,8,2009,Su Wei Hsieh
200631,2183.169882,4,1,0,3,6,1990,Maria Ekstrand
205815,2183.154331,3,1,0,2,4,2014,Eri Hozumi
207583,2183.147559,3,1,0,2,38,1999,Katrina Bandere
201442,2183.143627,27,10,0,17,4,2007,Yung Jan Chan
200748,2183.136776,7,2,0,5,2,1996,Venus Williams
200390,2183.134045,13,5,0,8,2,1991,Mary Lou Daniels
201525,2183.094484,1,0,0,1,9,2009,Eva Hrdinova
200080,2183.090135,10,4,0,6,5,1991,Dominique Monami
201371,2183.086643,1,0,0,1,35,2014,Vera Dushevina
202685,2183.08047,5,2,0,3,4,2014,Misa Eguchi
200116,2183.056023,1,0,0,1,22,2002,Natalia Zvereva
201349,2183.049857,9,3,0,6,4,2011,Melinda Czink
200627,2183.045968,10,4,0,6,17,1990,Petra Schwarz
202469,2183.039617,14,6,0,8,4,2012,Garbine Muguruza
200751,2183.038645,6,2,0,4,12,2002,Conchita Martinez Granados
201513,2183.011396,1,0,0,1,24,2007,Sabine Lisicki
202398,2183.006696,3,1,0,2,16,2008,Veronika Chvojkova
201451,2182.972673,4,1,0,3,7,2009,Kathrin Woerle
200007,2182.970101,38,17,0,21,3,2003,Silvija Talaja
200092,2182.958148,5,2,0,3,10,1998,Sandra Nacuk
201420,2182.955595,23,11,0,12,12,2008,Sania Mirza
200407,2182.944388,4,1,0,3,18,1993,Camille Benjamin
202154,2182.941765,1,0,0,1,4,1997,Ioana Plesu
201968,2182.941048,3,1,0,2,18,1995,Geraldine Dondit
202153,2182.935337,1,0,0,1,7,2000,Melanie Marois
201059,2182.932051,9,4,0,5,7,1993,Misumi Miyauchi
201695,2182.926858,1,0,0,1,18,2011,Anna Brazhnikova
202384,2182.924495,1,0,0,1,7,2007,Kyra Shroff
200653,2182.92189,27,11,0,16,10,1998,Yayuk Basuki
201754,2182.918435,3,1,0,2,52,1997,Leanne Baker
201274,2182.915278,2,0,0,2,4,1990,Viktoria Milvidskaia
201452,2182.904395,6,2,0,4,9,2010,Lourdes Dominguez Lino
202359,2182.890106,3,1,0,2,5,2006,Chin Wei Chan
200579,2182.889,23,10,0,13,7,1995,Karin Kschwendt
204246,2182.882945,1,0,0,1,14,2013,Lesley Kerkhove
201078,2182.824084,1,0,0,1,0,1997,Eugenia Kulikovskaya
200764,2182.816803,2,0,0,2,1,2006,Elena Bovina
200703,2182.803475,15,6,0,9,5,1993,Katarina Studenikova
200696,2182.792631,23,10,0,13,13,1993,Christina Papadaki
200425,2182.748418,3,1,0,2,15,1991,Sophie Amiach
201177,2182.73901,8,3,0,5,4,1992,Amanda Grunfeld
200695,2182.716696,26,12,0,14,1,1995,Tina Krizan
203095,2182.714776,3,1,0,2,38,2001,Ioana Gaspar
201361,2182.710946,12,5,0,7,30,2008,Julia Schruff
200681,2182.64874,11,4,0,7,11,1996,Natalia Baudone Furlan
200006,2182.637173,30,12,0,18,4,1998,Karina Habsudova
201548,2182.618269,7,3,0,4,39,2010,Ajla Tomljanovic
201708,2182.616481,5,2,0,3,8,2004,Natalie Grandin
201570,2182.614022,6,2,0,4,4,2012,Vesna Dolonc
206626,2182.590259,1,0,0,1,40,2001,Nuria Niemes
201820,2182.547836,3,1,0,2,10,1992,Caroline Wuillot
206374,2182.545593,4,1,0,3,4,2015,Yafan Wang
201638,2182.525552,9,4,0,5,20,2014,Estrella Cabeza Candela
200083,2182.51821,1,0,0,1,2,2012,Alexandra Stevenson
201209,2182.502852,4,1,0,3,12,2008,Selima Sfar
200754,2182.470315,48,22,0,26,1,2008,Jill Craybas
201811,2182.469738,1,0,0,1,10,2001,Young Ja Choi
201856,2182.465874,3,1,0,2,40,1998,Ekaterina Sysoeva
201331,2182.428691,49,21,0,28,1,2005,Iveta Benesova
201555,2182.402584,28,12,0,16,3,2014,Polona Hercog
203972,2182.399434,7,3,0,4,33,1997,Tracey Hiete
201844,2182.388982,6,2,0,4,15,1992,Agnese Gustmane
202121,2182.362093,3,1,0,2,1,1995,Benjamas Sangaram
201303,2182.348251,32,16,0,16,14,2009,Anne Keothavong
200510,2182.317002,12,5,0,7,9,1990,Julie Richardson
200077,2182.305818,20,8,0,12,3,1998,Jennifer Capriati
201562,2182.303237,10,4,0,6,9,2011,Silvia Soler Espinosa
202429,2182.301878,1,0,0,1,19,2011,Camila Giorgi
200415,2182.278766,18,8,0,10,10,1991,Catherine Suire
201309,2182.266036,20,8,0,12,8,2003,Tatiana Perebiynis
201383,2182.250928,1,0,0,1,7,2000,Marie Eve Pelletier
200127,2182.245785,31,14,0,17,4,1997,Sarah Pitkowski Malcor
200672,2182.228703,5,2,0,3,2,1996,Barbara Mulej
201377,2182.226425,12,5,0,7,6,2004,Yuliya Beygelzimer
201040,2182.18575,12,5,0,7,0,1990,Luciana Corsato Owsianka
201284,2182.172594,5,2,0,3,6,2004,Tatiana Poutchek
201417,2182.165557,7,3,0,4,3,2003,Marta Domachowska
201457,2182.156598,16,6,0,10,4,2014,Jarmila Gajdosova
200604,2182.148827,36,17,0,19,10,1998,Barbara Paulus
201705,2182.127484,1,0,0,1,7,2010,Alina Abdurakhimova
200703,2182.123825,18,7,0,11,0,1994,Katarina Studenikova
203415,2182.110853,5,2,0,3,13,2013,Ilona Kremen
200728,2182.08687,3,1,0,2,24,2000,Melanie Schnell
200705,2182.056626,25,11,0,14,7,1992,Linda Ferrando
202306,2182.05248,1,0,0,1,1,2005,Diana Ospina
201703,2182.051419,3,1,0,2,5,2014,Yi Fan Xu
201284,2182.009428,3,1,0,2,8,2009,Tatiana Poutchek
201207,2181.999084,6,2,0,4,7,2002,Ansley Cargill
202791,2181.971293,1,0,0,1,17,2007,Debbrich Feys
201555,2181.958519,42,19,0,23,6,2015,Polona Hercog
201361,2181.958051,9,4,0,5,4,2003,Julia Schruff
201492,2181.951629,6,2,0,4,10,2007,Andrea Petkovic
201969,2181.938861,2,0,0,2,23,1993,Karin Ptaszek
200751,2181.921798,5,2,0,3,15,2005,Conchita Martinez Granados
201497,2181.901658,11,5,0,6,7,2005,Agnes Szavay
201426,2181.898993,17,7,0,10,3,2014,Pauline Parmentier
202348,2181.89189,5,2,0,3,14,2007,Lina Stanciute
206107,2181.889595,3,1,0,2,7,2015,Zhaoxuan Yang
201561,2181.838679,3,1,0,2,9,2012,Claire Feuerstein
201576,2181.808387,4,1,0,3,8,2009,Valerie Tetreault
200617,2181.805611,25,11,0,14,7,2014,Kimiko Date Krumm
201371,2181.776764,12,4,0,8,2,2013,Vera Dushevina
203578,2181.748342,6,2,0,4,4,2014,Fangzhou Liu
201608,2181.705442,1,0,0,1,6,2005,Sheng Nan Sun
200053,2181.673086,12,5,0,7,21,2002,Lubomira Bacheva
201541,2181.639075,16,7,0,9,8,2010,Chanelle Scheepers
200024,2181.635204,13,5,0,8,1,1995,Maria Vento Kabchi
200735,2181.631573,6,2,0,4,7,2002,Miho Saeki
201301,2181.616329,17,7,0,10,5,2006,Camille Pin
201444,2181.611761,15,6,0,9,10,2008,Su Wei Hsieh
201555,2181.58484,14,6,0,8,3,2009,Polona Hercog
201580,2181.489247,2,0,0,2,5,2009,Xinyun Han
201286,2181.479233,36,16,0,20,7,2001,Anabel Medina Garrigues
200713,2181.457628,6,2,0,4,7,1999,Yuka Yoshida
200674,2181.442264,27,12,0,15,10,1991,Bettina Fulco Villella
200727,2181.427511,10,4,0,6,10,1994,Adriana Serra Zanetti
201490,2181.367703,4,1,0,3,5,2004,Timea Bacsinszky
201291,2181.328415,11,4,0,7,9,2010,Nuria Llagostera Vives
201177,2181.297389,4,1,0,3,30,1991,Amanda Grunfeld
201309,2181.284277,6,2,0,4,4,2007,Tatiana Perebiynis
200065,2181.272639,10,4,0,6,2,1997,Amelie Mauresmo
200002,2181.267469,19,8,0,11,7,2013,Mirjana Lucic
201512,2181.262245,26,10,0,16,3,2008,Monica Niculescu
201086,2181.215418,18,7,0,11,4,2010,Greta Arn
201752,2181.208028,2,0,0,2,15,1994,Cristina Salvi
201452,2181.197105,9,4,0,5,9,2015,Lourdes Dominguez Lino
200022,2181.178371,42,19,0,23,4,2002,Emmanuelle Gagliardi
200593,2181.169137,26,10,0,16,10,1990,Karine Quentrec
201524,2181.164331,4,1,0,3,7,2010,Urszula Radwanska
201723,2181.162061,4,1,0,3,16,1992,Angela Kerek
200377,2181.161565,2,0,0,2,19,1998,Helena Sukova
200066,2181.108761,3,1,0,2,3,1993,Cristina Torrens Valero
202038,2181.083946,1,0,0,1,14,1998,Ceyda Keyman
201344,2181.063831,58,30,0,28,3,2014,Klara Koukalova
200118,2181.032895,8,3,0,5,21,2009,Virginia Ruano Pascual
200671,2180.962516,2,0,0,2,7,1991,Meike Babel
200668,2180.951314,8,3,0,5,12,1990,Silke Frankl
200727,2180.927592,22,9,0,13,8,2001,Adriana Serra Zanetti
201616,2180.896675,10,4,0,6,9,2012,Lauren Davis
202340,2180.896464,4,1,0,3,22,2007,Caroline Maes
201328,2180.855205,10,4,0,6,1,2006,Milagros Sequera
203462,2180.768118,4,1,0,3,3,2014,Kateryna Kozlova
201053,2180.744283,2,0,0,2,10,1990,Sylvie Sabas
201988,2180.691974,2,0,0,2,21,1992,Sofie Albinus
201367,2180.649602,43,17,0,26,6,2004,Arantxa Parra Santonja
200009,2180.639999,31,12,0,19,4,2007,Tamarine Tanasugarn
207003,2180.615036,4,1,0,3,34,2003,Liz Cruz
200019,2180.572558,36,15,0,21,1,1998,Alexandra Fusai
201087,2180.512866,4,1,0,3,3,1998,Mashona Washington
201467,2180.490707,4,1,0,3,16,2006,Ivana Abramovic
201533,2180.456508,9,3,0,6,6,2012,Shuai Zhang
201569,2180.358399,2,0,0,2,18,2009,Georgie Gent
200024,2180.354048,27,12,0,15,7,2000,Maria Vento Kabchi
201532,2180.351661,4,1,0,3,16,2009,Anastasia Pivovarova
201335,2180.344537,28,12,0,16,6,2003,Myriam Casanova
200578,2180.340643,4,1,0,3,19,1998,Rennae Stubbs
200043,2180.283176,35,15,0,20,12,2003,Virginie Razzano
202477,2180.237884,11,4,0,7,8,2013,Dinah Pfizenmaier
203533,2180.236096,13,5,0,8,3,2013,Anna Karolina Schmiedlova
201516,2180.228599,21,9,0,12,3,2011,Evgeniya Rodina
201604,2180.187175,2,0,0,2,8,2010,Irina Falconi
201423,2180.18446,20,9,0,11,4,2010,Yvonne Meusburger
200480,2180.178162,34,14,0,20,2,1991,Claudia Porwik
200617,2180.177007,9,3,0,6,7,2015,Kimiko Date Krumm
201059,2180.147011,2,0,0,2,9,1990,Misumi Miyauchi
200026,2180.145699,29,12,0,17,0,1990,Florencia Labat
200675,2180.140534,12,5,0,7,9,1995,Eugenia Maniokova
200715,2180.134378,21,10,0,11,11,1992,Mariaan De Swardt
207985,2180.064848,2,0,0,2,36,2003,Maria Angela Ferreira
200099,2180.06483,12,5,0,7,2,1999,Sonya Jeyaseelan
201400,2180.060669,4,1,0,3,4,2015,Nicole Vaidisova
201655,2180.058396,2,0,0,2,16,2010,Anna Floris
200126,2180.057944,2,0,0,2,1,1999,Marissa Gould
201682,2180.048292,6,2,0,4,33,2013,Nudnida Luangnam
200423,2180.036239,4,1,0,3,51,1992,Carling Bassett Seguso
201840,2180.031477,2,0,0,2,28,1999,Germana Di Natale
201416,2180.017831,32,15,0,17,5,2005,Alona Bondarenko
201470,2180.011513,25,11,0,14,9,2011,Kristina Barrois
201348,2179.973614,8,3,0,5,7,2006,Casey Dellacqua
200721,2179.92038,2,0,0,2,8,1992,Hiromi Nagano
200699,2179.838102,10,4,0,6,32,1991,Meredith Mcgrath
201484,2179.82626,2,0,0,2,5,2008,Sandra Zahlavova
200677,2179.81137,2,0,0,2,42,1994,Katja Oeljeklaus
200056,2179.802439,37,19,0,18,1,2006,Jelena Kostanic Tosic
200089,2179.798509,33,13,0,20,3,1998,Miriam Oremans
201478,2179.705519,6,2,0,4,1,2008,Varvara Lepchenko
202102,2179.697039,2,0,0,2,8,1994,Kaoru Shibata
202386,2179.694794,4,1,0,3,8,2012,Sung Hee Han
201690,2179.68134,25,11,0,14,0,2012,Nina Bratchikova
202016,2179.65918,4,1,0,3,3,1991,Pam Nelson
201428,2179.639776,2,0,0,2,20,2014,Mathilde Johansson
200565,2179.626498,10,4,0,6,15,1991,Nathalie Guerree Spitzer
201317,2179.581461,8,3,0,5,15,2005,Aniko Kapros
212059,2179.573808,6,2,0,4,33,1997,Kelly Duns
201697,2179.554947,2,0,0,2,13,2010,Kristyna Pliskova
200700,2179.540558,48,25,0,23,2,2005,Silvia Farina Elia
202684,2179.524919,10,4,0,6,14,2015,Lin Zhu
201612,2179.50946,4,1,0,3,4,2010,Junri Namigata
201570,2179.483743,6,2,0,4,7,2009,Vesna Dolonc
201272,2179.413675,2,0,0,2,12,1991,Sandra Birch
201381,2179.365851,2,0,0,2,11,2002,Tian Tian Sun
200687,2179.361396,20,8,0,12,4,1992,Katarzyna Nowak
200104,2179.336781,8,3,0,5,14,1998,Emilie Loit
201405,2179.336286,2,0,0,2,8,2004,Nan Nan Liu
200050,2179.318171,24,10,0,14,0,1999,Sandra Kleinova
201315,2179.308002,8,3,0,5,5,2002,Ashley Harkleroad
200090,2179.286526,10,4,0,6,25,2005,Anca Barna
200091,2179.264071,4,1,0,3,4,2003,Janet Lee
201485,2179.20655,7,3,0,4,13,2013,Alla Kudryavtseva
200099,2179.194988,10,4,0,6,2,1994,Sonya Jeyaseelan
201561,2179.176136,2,0,0,2,21,2009,Claire Feuerstein
201353,2179.173104,2,0,0,2,20,2003,Stanislava Hrozenska
204479,2179.161535,16,7,0,9,33,1997,Vanessa Kendall
212410,2179.138976,6,2,0,4,22,1994,Belkis Rodriguez
201420,2179.121989,18,8,0,10,7,2010,Sania Mirza
201304,2179.110268,10,4,0,6,19,2005,Elena Baltacha
200114,2179.091748,12,5,0,7,0,1999,Patricia Wartusch
200676,2179.077159,10,4,0,6,11,1991,Mana Endo
201303,2179.070796,6,2,0,4,20,2003,Anne Keothavong
200019,2179.066984,6,2,0,4,22,2002,Alexandra Fusai
200452,2179.007006,6,2,0,4,18,1990,Tine Scheuer Larsen
200020,2178.981086,33,14,0,19,1,2005,Lisa Raymond
201356,2178.965263,12,5,0,7,10,2005,Eva Birnerova
212399,2178.962413,2,0,0,2,40,1994,Shahira Tawfik
201483,2178.957214,4,1,0,3,10,2007,Madison Brengle
200643,2178.938764,14,6,0,8,14,1991,Petra Kamstra
203578,2178.932449,2,0,0,2,4,2015,Fangzhou Liu
200704,2178.906369,20,8,0,12,5,1993,Maria Jose Gaidano
201486,2178.894172,13,5,0,8,8,2011,Aleksandra Wozniak
201088,2178.85739,6,2,0,4,19,1998,Karen Cross
200007,2178.849109,42,19,0,23,1,2002,Silvija Talaja
200540,2178.846439,2,0,0,2,15,1990,Amy Schwartz
200006,2178.836825,37,14,0,23,8,2000,Karina Habsudova
200085,2178.821964,40,17,0,23,2,2007,Ai Sugiyama
200035,2178.761639,10,4,0,6,11,1995,Maria Sanchez Lorenzo
200063,2178.755852,41,16,0,25,0,1999,Tatiana Panova
200698,2178.732849,22,9,0,13,1,1994,Petra Begerow
201599,2178.703934,4,1,0,3,8,2010,Andrea Hlavackova
200582,2178.698889,4,1,0,3,7,1994,Maria Strandlund Tomsvik
200645,2178.685378,8,3,0,5,0,1994,Maja Zivec Skulj
200024,2178.668301,9,3,0,6,1,1994,Maria Vento Kabchi
201292,2178.65972,45,21,0,24,1,2002,Martina Sucha
201482,2178.648779,4,1,0,3,7,2005,Andreja Klepac
200728,2178.617098,2,0,0,2,45,1997,Melanie Schnell
200547,2178.616974,19,8,0,11,13,1993,Sandra Wasserman
200706,2178.612006,23,9,0,14,0,1996,Catalina Cristea
200713,2178.605029,4,1,0,3,42,2005,Yuka Yoshida
202048,2178.600553,2,0,0,2,17,1996,Liza Andriyani
201394,2178.553051,9,3,0,6,4,2003,Anna Lena Groenefeld
200747,2178.549973,8,3,0,5,8,1997,Haruka Inoue
200045,2178.54651,21,8,0,13,7,2000,Tara Snyder
201457,2178.493869,9,3,0,6,5,2008,Jarmila Gajdosova
200392,2178.492252,4,1,0,3,19,1995,Jo Durie
200771,2178.479873,2,0,0,2,27,2000,Sophie Erre
200770,2178.45899,4,1,0,3,1,2002,Stephanie Cohen Aloro
201717,2178.448089,2,0,0,2,15,1991,Michelle Jackson Nobrega
201417,2178.445421,31,14,0,17,2,2008,Marta Domachowska
200766,2178.404779,2,0,0,2,2,1999,Jennifer Hopkins
200589,2178.366672,26,10,0,16,1,1992,Halle Cioffi
201646,2178.360204,4,1,0,3,30,2011,Maria Joao Koehler
200554,2178.35073,4,1,0,3,16,2007,Brenda Schultz Mccarthy
200765,2178.343484,4,1,0,3,0,1999,Katalin Marosi
201376,2178.33921,7,2,0,5,11,2004,Angela Haynes
201527,2178.33741,4,1,0,3,10,2008,Stefanie Voegele
201295,2178.335908,30,14,0,16,5,2001,Wynne Prakusya
204377,2178.315402,2,0,0,2,16,2014,Indy De Vroome
201466,2178.302032,21,9,0,12,9,2015,Kaia Kanepi
200713,2178.264092,24,11,0,13,0,1997,Yuka Yoshida
201200,2178.241774,2,0,0,2,16,1997,Miriam Schnitzer
201503,2178.235287,36,15,0,21,2,2012,Ayumi Morita
200036,2178.230476,2,0,0,2,2,1995,Nicole Pratt
201632,2178.214544,2,0,0,2,4,2009,Ryoko Fuda
200680,2178.214125,7,2,0,5,9,1991,Nadin Ercegovic
207078,2178.200165,2,0,0,2,39,1994,Helina Lill
201323,2178.157172,4,1,0,3,39,2006,Saori Obata
200773,2178.135406,27,12,0,15,5,2003,Stephanie Foretz Gacon
201608,2178.114669,2,0,0,2,5,2010,Sheng Nan Sun
201286,2178.093133,49,23,0,26,5,2012,Anabel Medina Garrigues
201072,2178.092912,4,1,0,3,17,1998,Eva Bes Ostariz
201771,2178.091925,2,0,0,2,30,1998,Virag Csurgo
201450,2178.086801,38,13,0,25,3,2011,Tsvetana Pironkova
201383,2178.078074,12,5,0,7,1,2005,Marie Eve Pelletier
201063,2178.075642,4,1,0,3,27,1994,Maria Francesca Bentivoglio
200015,2178.075567,36,16,0,20,4,2002,Petra Mandula
200656,2178.059183,6,2,0,4,2,1993,Jessica Emmons
201200,2178.05131,4,1,0,3,6,1999,Miriam Schnitzer
201504,2178.046028,38,17,0,21,4,2015,Julia Goerges
200018,2178.038521,10,4,0,6,24,1999,Julia Abe
200085,2177.980148,48,22,0,26,5,2000,Ai Sugiyama
201203,2177.975465,8,3,0,5,12,2001,Alena Nesticka
200655,2177.951462,27,12,0,15,1,1993,Nicole Arendt
200072,2177.940855,2,0,0,2,12,2008,Cara Black
200053,2177.913859,6,2,0,4,4,1992,Lubomira Bacheva
200084,2177.877558,29,13,0,16,9,2002,Asa Svensson
201384,2177.835076,6,2,0,4,8,2004,Chia Jung Chuang
201300,2177.825816,24,10,0,14,1,2001,Maria Emilia Salerni
202453,2177.778344,6,2,0,4,5,2013,Saisai Zheng
201301,2177.76628,2,0,0,2,23,2003,Camille Pin
201394,2177.759589,2,0,0,2,28,2011,Anna Lena Groenefeld
200657,2177.756941,17,6,0,11,10,1998,Radka Bobkova
201321,2177.754907,4,1,0,3,14,1999,Antonella Serra Zanetti
201062,2177.747924,2,0,0,2,27,1994,Amelie Castera
200121,2177.707999,9,3,0,6,13,2001,Alina Jidkova
211719,2177.68601,2,0,0,2,5,2014,Shilin Xu
200680,2177.67782,29,13,0,16,3,1993,Nadin Ercegovic
200636,2177.658204,4,1,0,3,0,1994,Danielle Jones
201571,2177.657744,4,1,0,3,7,2006,Masa Zec Peskiric
200089,2177.633279,22,9,0,13,12,2002,Miriam Oremans
200777,2177.61007,45,21,0,24,1,2004,Marta Marrero
201329,2177.565311,15,7,0,8,30,2015,Vera Zvonareva
200028,2177.563909,4,1,0,3,2,1994,Maureen Drake
201334,2177.54885,12,5,0,7,12,2003,Zuzana Ondraskova
201746,2177.526553,2,0,0,2,2,1993,Amanda Basica
202359,2177.511849,4,1,0,3,6,2013,Chin Wei Chan
202340,2177.506991,2,0,0,2,20,2002,Caroline Maes
201424,2177.503194,4,1,0,3,16,2015,Shahar Peer
210930,2177.498954,4,1,0,3,43,2014,Chia Hsien Yang
201525,2177.485647,2,0,0,2,14,2008,Eva Hrdinova
201448,2177.467922,20,8,0,12,1,2008,Galina Voskoboeva
200016,2177.466935,2,0,0,2,11,1990,Sandrine Testud
200716,2177.452057,30,13,0,17,0,1996,Sung Hee Park
201480,2177.44872,4,1,0,3,8,2004,Lioudmila Skavronskaia
201835,2177.440661,2,0,0,2,25,1994,Maja Muric
200677,2177.433082,2,0,0,2,57,1993,Katja Oeljeklaus
201317,2177.422959,10,4,0,6,15,2002,Aniko Kapros
201473,2177.409511,9,3,0,6,10,2006,Vasilisa Bardina
202258,2177.409376,2,0,0,2,21,2001,Jaslyn Hewitt
203905,2177.394082,4,1,0,3,45,1998,Lechia Trewick
200514,2177.381597,29,12,0,17,3,1990,Monique Javer
204480,2177.372953,6,2,0,4,45,1998,Kym Hazzard
200634,2177.368586,19,7,0,12,1,1992,Elena Brioukhovets
201577,2177.364648,2,0,0,2,8,2009,Heidi El Tabakh
202478,2177.355479,2,0,0,2,16,2013,Tara Moore
200004,2177.329136,6,2,0,4,10,1995,Kerry Anne Guse
201373,2177.324809,14,5,0,9,5,2014,Maria Kirilenko
201926,2177.324326,2,0,0,2,6,1995,Stephanie Reece
201364,2177.319746,6,2,0,4,23,2008,Tatiana Golovin
201288,2177.312284,2,0,0,2,21,2002,Maja Palaversic Cooper Smith
206913,2177.311612,2,0,0,2,43,1999,Paola Guerrero
203079,2177.302095,8,3,0,5,45,1998,Diana Gherghi
210785,2177.298767,6,2,0,4,27,2012,Joanna Nena Savva
201447,2177.254306,31,14,0,17,7,2010,Vania King
203552,2177.237171,6,2,0,4,4,2015,Risa Ozaki
201824,2177.18545,8,3,0,5,6,1999,Gisela Riera Roura
201510,2177.146773,4,1,0,3,20,2009,Julie Ditty
201371,2177.120895,28,12,0,16,4,2004,Vera Dushevina
201414,2177.111472,4,1,0,3,4,2004,Michaella Krajicek
201547,2177.090375,13,6,0,7,9,2012,Michelle Larcher De Brito
209331,2177.07998,4,1,0,3,32,2011,Julia Helbet
202663,2177.072676,6,2,0,4,4,2014,Magda Linette
201367,2177.066041,4,1,0,3,2,2013,Arantxa Parra Santonja
201572,2177.063901,15,6,0,9,9,2010,Regina Kulikova
206304,2177.061424,4,1,0,3,27,2012,Yolimar Ogando
200090,2177.035527,8,3,0,5,26,2000,Anca Barna
206621,2177.019911,4,1,0,3,52,2000,Kelesitse Makgale
200530,2177.019266,22,9,0,13,11,1995,Radomira Zrubakova
202364,2177.018611,2,0,0,2,7,2007,Sandy Gumulya
202946,2177.017442,4,1,0,3,35,1993,Christina Zachariadou
200047,2176.984608,2,0,0,2,17,1995,Pavlina Nola
200053,2176.984608,2,0,0,2,17,1995,Lubomira Bacheva
203518,2176.974791,9,4,0,5,3,2015,Paula Kania
202503,2176.967006,6,2,0,4,0,2012,Luksika Kumkhum
203643,2176.940789,2,0,0,2,21,1992,Hana Adamkova Guy
200570,2176.935179,17,7,0,10,0,1994,Veronika Martinek
201446,2176.917489,2,0,0,2,5,2003,Sybille Bammer
200062,2176.901999,6,2,0,4,18,2007,Kristina Brandi
200615,2176.898427,15,6,0,9,7,1993,Kristin Godridge
212540,2176.896989,6,2,0,4,31,1998,Jeanine Baillie
200765,2176.893095,4,1,0,3,17,2012,Katalin Marosi
201921,2176.892569,4,1,0,3,12,1999,Martina Nejedly
201427,2176.874944,48,20,0,28,3,2009,Alize Cornet
200128,2176.870059,7,2,0,5,11,1992,Lindsay Davenport
202671,2176.857702,2,0,0,2,16,2014,Cristina Andreea Mitu
200735,2176.851087,2,0,0,2,10,1995,Miho Saeki
212414,2176.846627,2,0,0,2,23,1993,Oksana Bushevitsa
201444,2176.798524,2,0,0,2,7,2010,Su Wei Hsieh
200607,2176.792139,2,0,0,2,11,1992,Beate Reinstadler
201496,2176.769493,6,2,0,4,13,2005,Caroline Wozniacki
201427,2176.767827,50,23,0,27,3,2015,Alize Cornet
200506,2176.749671,25,11,0,14,3,1994,Wiltrud Probst
201485,2176.735453,30,12,0,18,6,2008,Alla Kudryavtseva
201315,2176.730872,2,0,0,2,14,2010,Ashley Harkleroad
201355,2176.727565,40,20,0,20,5,2003,Flavia Pennetta
200040,2176.713666,29,13,0,16,0,1998,Anna Smashnova
201417,2176.70745,42,19,0,23,2,2005,Marta Domachowska
201310,2176.698044,12,4,0,8,4,2005,Martina Muller
201456,2176.692111,15,6,0,9,10,2007,Olga Savchuk
201457,2176.660954,23,9,0,14,9,2009,Jarmila Gajdosova
200641,2176.659582,24,9,0,15,0,1991,Patricia Tarabini
202185,2176.656484,2,0,0,2,22,2000,Anna Bielen Zarska
201066,2176.655069,8,3,0,5,23,1994,Neus Avila Bonastre
201048,2176.653561,6,2,0,4,12,1990,Leona Laskova
204539,2176.64919,4,1,0,3,42,1999,Laura Bernal
201664,2176.618177,4,1,0,3,14,2009,Pemra Ozgen
200489,2176.617185,6,2,0,4,27,1990,Yukie Koizumi
200028,2176.61206,4,1,0,3,16,2001,Maureen Drake
200019,2176.606129,6,2,0,4,14,2000,Alexandra Fusai
200698,2176.573512,21,8,0,13,3,1995,Petra Begerow
212097,2176.568236,4,1,0,3,44,2001,Shaza Tinawi
212097,2176.555444,4,1,0,3,45,2000,Shaza Tinawi
201443,2176.544601,2,0,0,2,10,2007,Alexa Glatch
202278,2176.537102,2,0,0,2,34,2003,Romy Farah
203083,2176.534732,4,1,0,3,37,2002,Stephanie Schaer
201508,2176.532934,15,6,0,9,3,2013,Petra Cetkovska
201966,2176.52483,2,0,0,2,6,1992,Natalie Tschan
201927,2176.522538,4,1,0,3,0,1996,Ludmilla Varmuza
201410,2176.520961,4,1,0,3,7,2007,Monique Adamczak
201200,2176.520643,8,3,0,5,19,2001,Miriam Schnitzer
204206,2176.519259,2,0,0,2,42,1999,Cacilia Charbonnier
202607,2176.499077,4,1,0,3,31,2005,Yi Chen
203886,2176.494817,4,1,0,3,46,1993,Joni Van Ryck De Groot
202286,2176.471765,4,1,0,3,3,2003,Elise Tamaela
200696,2176.450766,8,3,0,5,16,1991,Christina Papadaki
201771,2176.426546,2,0,0,2,21,1991,Virag Csurgo
201431,2176.400287,2,0,0,2,19,2013,Aravane Rezai
200578,2176.383445,17,7,0,10,3,1995,Rennae Stubbs
200745,2176.369398,22,10,0,12,10,1999,Andrea Glass
203913,2176.343065,8,3,0,5,45,2000,Niki Tippins
201466,2176.334755,4,1,0,3,22,2001,Kaia Kanepi
200024,2176.321364,46,19,0,27,3,2004,Maria Vento Kabchi
201733,2176.304798,4,1,0,3,28,1991,Lorenza Jachia
201614,2176.302436,6,2,0,4,8,2011,Caroline Garcia
200023,2176.294911,13,5,0,8,52,1997,Bryanne Stewart
200695,2176.290987,4,1,0,3,10,1998,Tina Krizan
200570,2176.268513,18,8,0,10,11,1995,Veronika Martinek
200654,2176.261541,4,1,0,3,18,1993,Patty Oreilly
201578,2176.254149,28,12,0,16,4,2010,Kai Chen Chang
201501,2176.25249,51,23,0,28,1,2008,Olga Govortsova
200690,2176.242173,9,3,0,6,8,1992,Kyoko Nagatsuka
201598,2176.22917,2,0,0,2,4,2007,Noppawan Lertcheewakarn
207698,2176.225342,2,0,0,2,41,1994,Aicha Ferjani
212445,2176.21776,6,2,0,4,24,1993,Claudia Brause
201059,2176.213279,8,3,0,5,8,1992,Misumi Miyauchi
201427,2176.209076,38,17,0,21,4,2010,Alize Cornet
200774,2176.170606,2,0,0,2,10,1998,Vanessa Webb
200657,2176.161958,4,1,0,3,0,1991,Radka Bobkova
200038,2176.156753,8,3,0,5,22,1998,Annabel Ellwood
200005,2176.147841,15,6,0,9,2,1993,Jolene Watanabe Giltz
203069,2176.143924,2,0,0,2,39,1999,Elena Krutko
201804,2176.102351,4,1,0,3,0,1991,Claudia Chabalgoity
212760,2176.099796,4,1,0,3,57,1997,Anushka Rajiyah
200057,2176.09725,4,1,0,3,42,2002,Erika De Lone
205467,2176.097034,4,1,0,3,35,2004,Maria Eugenia Roca Recarey
203234,2176.091537,6,2,0,4,9,1998,Keiko Taguchi
201607,2176.091537,4,1,0,3,51,2011,Sally Peers
201365,2176.091537,2,0,0,2,44,2013,Edina Gallovits Hall
212440,2176.085629,4,1,0,3,34,1997,Indre Kastanauskaite
202663,2176.072673,4,1,0,3,46,2011,Magda Linette
201672,2176.07023,4,1,0,3,9,2012,Nigina Abduraimova
212746,2176.058036,4,1,0,3,46,2000,Hamidan Bibi
212240,2176.049218,4,1,0,3,26,2007,Astrid Tixier
212392,2176.049001,4,1,0,3,44,1994,Alejandra Gomez
201301,2176.047188,2,0,0,2,25,2002,Camille Pin
212357,2176.038668,4,1,0,3,36,2000,Sheenagh Cosgrove
202331,2176.038555,4,1,0,3,42,1997,Vilmarie Castellvi
203290,2176.030951,4,1,0,3,26,2005,Piia Suomalainen
200596,2176.024465,4,1,0,3,39,1991,Sabine Krein Auer
203367,2176.019076,2,0,0,2,17,2006,Nicole Riner
201332,2176.01709,6,2,0,4,20,2003,Jane Odonoghue
202269,2175.995996,6,2,0,4,40,2002,Erika Valdes
209836,2175.988499,4,1,0,3,28,2001,Nikkita Fountain
201442,2175.986349,9,3,0,6,4,2011,Yung Jan Chan
212178,2175.982768,4,1,0,3,31,2007,Ashley Brooks
200074,2175.982335,2,0,0,2,7,2000,Jane Chi
209992,2175.980524,4,1,0,3,35,2004,Lara Alsamman
201839,2175.977314,2,0,0,2,15,1998,Syna Schreiber
202334,2175.974963,4,1,0,3,17,2004,Hanna Nooni
200416,2175.966295,27,13,0,14,1,1992,Robin White
200035,2175.954872,50,23,0,27,1,2004,Maria Sanchez Lorenzo
204123,2175.944222,4,1,0,3,41,1998,Maria Dolores Campana
201664,2175.93747,4,1,0,3,29,2004,Pemra Ozgen
200612,2175.937265,21,9,0,12,12,1995,Natalia Medvedeva
200776,2175.930121,4,1,0,3,23,2008,Angelika Bachmann
200109,2175.90409,45,17,0,28,1,2006,Nathalie Dechy
202339,2175.900298,2,0,0,2,31,2005,Ayu Fani Damayanti
201580,2175.876716,2,0,0,2,4,2015,Xinyun Han
201305,2175.867633,4,1,0,3,41,1998,Eleni Daniilidou
201456,2175.861581,7,2,0,5,4,2015,Olga Savchuk
200766,2175.842815,19,8,0,11,5,2000,Jennifer Hopkins
201824,2175.828792,4,1,0,3,28,2000,Gisela Riera Roura
201304,2175.818682,2,0,0,2,23,2001,Elena Baltacha
200011,2175.818641,18,8,0,10,11,2010,Katarina Srebotnik
200712,2175.807447,2,0,0,2,10,1996,Katerina Kroupova
202622,2175.775047,8,3,0,5,4,2014,Lyudmyla Kichenok
200575,2175.769636,2,0,0,2,19,1990,Anna Ivan
200622,2175.765407,2,0,0,2,57,1994,Maya Kidowaki
201477,2175.738063,2,0,0,2,8,2014,Stephanie Dubois
201969,2175.732687,2,0,0,2,21,1994,Karin Ptaszek
201425,2175.722291,44,21,0,23,1,2006,Lucie Safarova
201751,2175.71483,4,1,0,3,13,1994,Melissa Mazzotta
201804,2175.711333,6,2,0,4,0,1990,Claudia Chabalgoity
204388,2175.707581,4,1,0,3,4,2014,Lisa Maria Moser
201303,2175.69862,11,4,0,7,6,2007,Anne Keothavong
200073,2175.695991,2,0,0,2,19,1995,Julie Pullin
201697,2175.685481,6,2,0,4,6,2015,Kristyna Pliskova
202043,2175.675398,2,0,0,2,8,1997,Mimma Chernovita
202301,2175.670197,9,3,0,6,19,2008,Sunitha Rao
201049,2175.66826,5,1,0,4,4,1990,Denisa Krajcovicova
201300,2175.655432,4,1,0,3,21,2009,Maria Emilia Salerni
201367,2175.639303,2,0,0,2,33,2012,Arantxa Parra Santonja
200529,2175.638892,2,0,0,2,17,1990,Jill Smoller
201497,2175.636015,10,4,0,6,22,2011,Agnes Szavay
200390,2175.633154,19,8,0,11,2,1990,Mary Lou Daniels
207003,2175.610707,4,1,0,3,35,2004,Liz Cruz
200581,2175.609369,4,1,0,3,8,1992,Tamaka Takagi
201815,2175.60439,2,0,0,2,43,1998,Petra Rampre
202468,2175.602474,6,2,0,4,8,2015,Jessica Pegula
203996,2175.592772,2,0,0,2,41,1998,Cristina Correia
204179,2175.59028,6,2,0,4,9,1999,Chiaki Nakajima
201325,2175.577807,4,1,0,3,56,2002,Samantha Stosur
208686,2175.573443,4,1,0,3,30,2004,Sanja Racic
200118,2175.573308,2,0,0,2,23,2010,Virginia Ruano Pascual
201854,2175.566243,6,2,0,4,40,1998,Mariana Mesa
201969,2175.561492,4,1,0,3,46,1996,Karin Ptaszek
202261,2175.56033,6,2,0,4,16,2003,Joanna Sakowicz Kostecka
201354,2175.550999,4,1,0,3,22,2000,Libuse Prusova
203084,2175.547565,2,0,0,2,43,1998,Daniela Olivera
202943,2175.546146,4,1,0,3,37,2001,Evagelia Roussi
201961,2175.542867,2,0,0,2,24,1993,Patricia Miller
202453,2175.540859,6,2,0,4,2,2012,Saisai Zheng
212118,2175.538105,4,1,0,3,29,2001,Elena Branker
211122,2175.538105,4,1,0,3,43,2014,Charlotte Roemer
201582,2175.537752,2,0,0,2,5,2010,Jing Jing Lu
200560,2175.537333,19,8,0,11,11,1992,Rene Collins
201443,2175.536205,6,2,0,4,8,2010,Alexa Glatch
212092,2175.532801,4,1,0,3,46,2000,Archana Reddy
202694,2175.5173,24,12,0,12,9,2014,Teliana Pereira
201522,2175.510852,2,0,0,2,48,2011,Jelena Pandzic
201753,2175.510052,6,2,0,4,52,1998,Rewa Harriman
200604,2175.507908,12,5,0,7,0,1994,Barbara Paulus
204772,2175.507293,4,1,0,3,26,1995,Liina Suurvarik
200082,2175.506824,2,0,0,2,26,2003,Kristie Boogert
200547,2175.501788,18,7,0,11,9,1991,Sandra Wasserman
202572,2175.496671,4,1,0,3,35,2004,I Hsuan Hwang
202446,2175.489477,6,2,0,4,8,2011,Eugenie Bouchard
201308,2175.473842,13,5,0,8,21,2002,Maria Elena Camerin
212425,2175.473542,4,1,0,3,28,1996,Sasha Hanna
202135,2175.473526,4,1,0,3,11,2002,Vanessa Henke
201412,2175.469541,4,1,0,3,5,2008,Anastasia Yakimova
200012,2175.466536,2,0,0,2,2,1997,Jana Nejedly
200103,2175.465309,4,1,0,3,26,2000,Evie Dominikovic
202932,2175.4402,2,0,0,2,30,2013,Marta Sirotkina
210641,2175.440192,4,1,0,3,29,2001,Mamotebang Molise
201196,2175.432182,4,1,0,3,24,1994,Claire Taylor
208287,2175.385424,4,1,0,3,25,2008,Nihal Tarek Saleh
200738,2175.380459,8,3,0,5,17,1997,Lenka Cenkova
201082,2175.370265,2,0,0,2,29,1993,Lorna Woodroffe
201637,2175.369743,2,0,0,2,35,2009,Melissa Torres Sandoval
200519,2175.35903,2,0,0,2,11,1990,Sybille Niox Chateau
201629,2175.347594,2,0,0,2,16,1990,Yael Segal
201648,2175.334012,4,1,0,3,8,2014,Naomi Broady
200621,2175.329222,4,1,0,3,21,1996,Isabelle Demongeot
200607,2175.325162,21,9,0,12,0,1990,Beate Reinstadler
200124,2175.32485,4,1,0,3,41,2012,Anne Kremer
200043,2175.317983,40,18,0,22,6,2008,Virginie Razzano
200776,2175.314361,2,0,0,2,8,2004,Angelika Bachmann
202100,2175.30238,2,0,0,2,1,1995,Iwalani Mccalla
202298,2175.302225,6,2,0,4,21,2002,Feriel Esseghir
201203,2175.298702,2,0,0,2,8,2000,Alena Nesticka
201381,2175.292004,14,6,0,8,3,2003,Tian Tian Sun
201771,2175.280184,2,0,0,2,34,1993,Virag Csurgo
202581,2175.272255,6,2,0,4,8,2013,Chanel Simmonds
200711,2175.268212,15,6,0,9,1,1994,Tatiana Ignatieva
201196,2175.251709,2,0,0,2,19,1997,Claire Taylor
201355,2175.243541,4,1,0,3,19,2002,Flavia Pennetta
202261,2175.238943,2,0,0,2,38,2004,Joanna Sakowicz Kostecka
212098,2175.229682,2,0,0,2,34,1994,Farah Dayoub
200016,2175.226818,24,10,0,14,10,1994,Sandrine Testud
204158,2175.224538,10,4,0,6,33,1997,Cindy Dock
207625,2175.222033,2,0,0,2,43,1998,Aina Rafolomanantsiatosika
201318,2175.211766,14,5,0,9,5,2012,Bethanie Mattek Sands
201298,2175.207779,4,1,0,3,39,1998,Zsofia Gubacsi
206903,2175.19695,2,0,0,2,37,2001,Glenny Cepeda
202362,2175.195013,2,0,0,2,16,2008,Teodora Mircic
200415,2175.193347,2,0,0,2,15,1993,Catherine Suire
201445,2175.172482,2,0,0,2,40,2010,Viktoria Kutuzova
200595,2175.171303,31,12,0,19,6,1995,Ann Wunderlich
200751,2175.151412,8,3,0,5,6,1999,Conchita Martinez Granados
202287,2175.123823,2,0,0,2,4,2002,Daniela Kix
203290,2175.111923,4,1,0,3,26,2014,Piia Suomalainen
201491,2175.110202,2,0,0,2,22,2011,Olivia Sanchez
206900,2175.110192,2,0,0,2,25,2011,Daysi Espinal
201638,2175.109444,2,0,0,2,31,2009,Estrella Cabeza Candela
200480,2175.098074,33,13,0,20,4,1993,Claudia Porwik
201582,2175.09643,2,0,0,2,5,2009,Jing Jing Lu
200663,2175.095834,4,1,0,3,10,1990,Nanne Dahlman
212678,2175.082963,4,1,0,3,46,1993,Amanda Browne
202364,2175.081644,4,1,0,3,36,2004,Sandy Gumulya
212106,2175.070932,4,1,0,3,27,2002,Lisa Fung Kee Fung
201836,2175.069891,2,0,0,2,24,1995,Svetlana Komleva
202170,2175.069772,4,1,0,3,42,1995,Paula Cabezas
207001,2175.068507,4,1,0,3,36,2000,Claudia Argumedo
212564,2175.060153,2,0,0,2,45,1994,Ann Simons
205467,2175.058622,4,1,0,3,30,2006,Maria Eugenia Roca Recarey
204430,2175.05733,2,0,0,2,3,2014,Antonia Lottner
200053,2175.054621,2,0,0,2,36,1996,Lubomira Bacheva
200744,2175.054621,2,0,0,2,36,1996,Svetlana Krivencheva
201281,2175.04714,26,11,0,15,10,2007,Laura Granville
212232,2175.045629,4,1,0,3,23,2011,Carlista Mohammed
206666,2175.042625,4,1,0,3,46,1993,Paula Umana
201649,2175.042108,2,0,0,2,15,2009,Lenka Jurikova
200510,2175.040341,2,0,0,2,25,1994,Julie Richardson
206912,2175.039184,2,0,0,2,43,1999,Myriam Cueva
201333,2175.037857,14,5,0,9,9,2002,Angelika Roesch
200105,2175.034745,4,1,0,3,61,1999,Rachel Mcquillan
212183,2175.033309,2,0,0,2,43,2012,Ummarahmat Hummetova
212134,2175.032136,2,0,0,2,29,2001,Razalia Phethu
212580,2175.030614,2,0,0,2,28,1995,Lamia Alami
200651,2175.030088,4,1,0,3,66,1997,Sabine Hack
212112,2175.030088,4,1,0,3,36,2000,Isoke Perry
201559,2175.029581,4,1,0,3,21,2012,Irena Pavlovic
201423,2175.024131,4,1,0,3,30,2006,Yvonne Meusburger
212208,2175.023396,2,0,0,2,25,2008,Rebekka Petursdottir
212282,2175.016625,4,1,0,3,27,2012,Michelle Marie Valdez
213021,2175.014216,2,0,0,2,37,2013,Alyssa Boey
208979,2175.013043,2,0,0,2,26,2005,Idunn Hertzberg
202502,2175.011269,2,0,0,2,44,2014,So Ra Lee
201021,2175.002838,7,2,0,5,23,1994,Laura Garrone
200674,2174.999879,2,0,0,2,53,1997,Bettina Fulco Villella
212498,2174.994597,4,1,0,3,25,1998,Tereza Simonian
201493,2174.985768,9,3,0,6,9,2009,Angelique Kerber
209753,2174.972621,4,1,0,3,27,2009,Ecaterina Vasenina
202216,2174.969978,4,1,0,3,52,1998,Lilia Biktyakova
201502,2174.95883,2,0,0,2,42,2011,Tatjana Malek
210159,2174.956713,4,1,0,3,45,2010,Anna Christine Patrimonio
212091,2174.95288,2,0,0,2,56,1997,Adriana Thaggard
204036,2174.952253,4,1,0,3,46,1996,Fabienne Thill
204419,2174.945215,4,1,0,3,30,2013,Ana Sofia Sanchez
200127,2174.940561,4,1,0,3,32,1993,Sarah Pitkowski Malcor
204497,2174.937299,2,0,0,2,48,1997,Galina Dimitrova
201530,2174.928821,2,0,0,2,10,2008,Gail Brodsky
201514,2174.916809,38,16,0,22,4,2014,Sorana Cirstea
200052,2174.914922,6,2,0,4,0,1996,Olga Barabanschikova
201608,2174.913349,2,0,0,2,7,2011,Sheng Nan Sun
201472,2174.911457,23,9,0,14,4,2012,Romina Oprandi
202272,2174.905488,4,1,0,3,4,2005,Ana Timotic
200518,2174.904317,4,1,0,3,35,1995,Paulette Moreno
200774,2174.898844,2,0,0,2,13,1995,Vanessa Webb
200007,2174.896642,6,2,0,4,22,1997,Silvija Talaja
200634,2174.89064,19,7,0,12,5,1993,Elena Brioukhovets
201589,2174.884359,2,0,0,2,39,2012,Sharon Fichman
202072,2174.881124,8,3,0,5,37,1999,Tina Hergold
202299,2174.871938,2,0,0,2,15,2002,Maria Wolfbrandt
213583,2174.870816,2,0,0,2,16,2013,Tatjana Maria
202308,2174.862299,2,0,0,2,46,2003,Paula Garcia
201442,2174.859762,4,1,0,3,5,2013,Yung Jan Chan
211637,2174.855324,2,0,0,2,13,2014,Tornado Alicia Black
200001,2174.841796,2,0,0,2,27,2015,Martina Hingis
200427,2174.827749,2,0,0,2,23,1990,Beth Herr
203089,2174.819571,4,1,0,3,52,1999,Kristen Van Elden
201072,2174.80675,2,0,0,2,10,1992,Eva Bes Ostariz
207536,2174.744733,4,1,0,3,40,1997,Carla Rodriguez
200015,2174.739092,4,1,0,3,22,2005,Petra Mandula
212151,2174.732324,2,0,0,2,31,2004,Lesedi Ramocha
200495,2174.719368,2,0,0,2,33,1993,Akiko Kijimuta
201383,2174.708794,2,0,0,2,1,2008,Marie Eve Pelletier
201197,2174.699855,4,1,0,3,19,1995,Megan Miller
200042,2174.69724,22,9,0,13,7,2000,Els Callens
202334,2174.681478,2,0,0,2,15,2005,Hanna Nooni
201830,2174.675672,2,0,0,2,35,1991,Katharina Duell
201691,2174.67464,4,1,0,3,17,2012,Dia Evtimova
212171,2174.647601,4,1,0,3,32,1994,Francesca La&#39;O
200091,2174.625602,2,0,0,2,43,1996,Janet Lee
200695,2174.622957,6,2,0,4,24,1992,Tina Krizan
201465,2174.610765,16,6,0,10,19,2011,Kirsten Flipkens
208098,2174.610043,4,1,0,3,33,2003,Vanessa Masalles
201589,2174.606816,2,0,0,2,1,2008,Sharon Fichman
201531,2174.59701,19,9,0,10,15,2010,Mariana Duque Marino
200110,2174.595942,2,0,0,2,13,1994,Fabiola Zuluaga
201749,2174.590867,4,1,0,3,0,1991,Julie Shiflet
202581,2174.588084,4,1,0,3,25,2010,Chanel Simmonds
200727,2174.586207,2,0,0,2,17,2005,Adriana Serra Zanetti
211562,2174.585216,4,1,0,3,27,2012,Vladica Babic
212320,2174.584366,2,0,0,2,38,2013,Arezou Youlghouni
200595,2174.578965,6,2,0,4,22,1998,Ann Wunderlich
201657,2174.576989,2,0,0,2,45,2014,Nastja Kolar
212130,2174.571302,2,0,0,2,30,1999,Evelyn Otula
212685,2174.568662,4,1,0,3,52,1998,Youliya Dimitrova
202298,2174.566584,2,0,0,2,31,1999,Feriel Esseghir
212360,2174.566584,2,0,0,2,38,2000,Anya Moyston
212151,2174.566584,2,0,0,2,28,2003,Lesedi Ramocha
208775,2174.566584,2,0,0,2,31,2005,Briggitt Marcovich
209991,2174.566584,2,0,0,2,31,2006,Sarah Makki
212259,2174.566584,2,0,0,2,26,2009,Alma Michelle Espinosa Rodriguez
200740,2174.566546,2,0,0,2,25,2001,Elena Tatarkova
201295,2174.551358,12,5,0,7,5,2000,Wynne Prakusya
209494,2174.55105,2,0,0,2,27,2007,Sayyara Mammadova
211105,2174.550235,4,1,0,3,26,2014,Akvile Parazinskaite
206897,2174.546483,2,0,0,2,48,1993,Monika Pimentel
206756,2174.546483,2,0,0,2,46,2000,Carolina Aravena
205195,2174.546483,4,1,0,3,35,2004,Alanna Broderick
202352,2174.546483,2,0,0,2,26,2009,Daniela Munoz Gallegos
212584,2174.544925,2,0,0,2,53,2000,Vonjiniana Rasamuel
208603,2174.544925,2,0,0,2,27,2009,Amira Benaissa
202286,2174.544455,6,2,0,4,6,2007,Elise Tamaela
200022,2174.54069,16,7,0,9,0,1997,Emmanuelle Gagliardi
204051,2174.538054,4,1,0,3,9,1998,Chie Nagano
201406,2174.533646,4,1,0,3,32,2007,Shikha Uberoi
212347,2174.530794,2,0,0,2,40,1992,Carolina Torres
202048,2174.530794,2,0,0,2,55,1999,Liza Andriyani
206583,2174.530794,2,0,0,2,34,2003,Monica Poveda
202302,2174.529886,4,1,0,3,39,2008,Maria Fernanda Alves
202326,2174.529173,4,1,0,3,7,2005,Ankita Bhambri
201467,2174.528735,2,0,0,2,6,2004,Ivana Abramovic
213022,2174.526435,2,0,0,2,38,2013,Maryam Mazaheri
200093,2174.524613,34,15,0,19,0,1999,Amelie Cocheteux
201293,2174.514895,4,1,0,3,3,2009,Catalina Castano
212390,2174.512641,4,1,0,3,44,1994,Florea De Maria Urrea
212138,2174.512001,2,0,0,2,29,2001,Mariem Nissaf Bouchlaka
201656,2174.509615,6,2,0,4,13,2013,Tadeja Majeric
204772,2174.508154,4,1,0,3,25,1998,Liina Suurvarik
200442,2174.495215,18,9,0,9,3,1995,Andrea Temesvari
200002,2174.492277,2,0,0,2,44,2003,Mirjana Lucic
212242,2174.491799,2,0,0,2,27,2007,Marina Kojanova
203149,2174.491713,8,3,0,5,33,1997,Stephanie Hazlett
207421,2174.489661,4,1,0,3,26,1995,Ruta Deduraite
200006,2174.483546,19,7,0,12,5,1993,Karina Habsudova
201088,2174.481384,2,0,0,2,4,1993,Karen Cross
212082,2174.478248,4,1,0,3,47,1996,Lisa Camenzuli
212562,2174.471684,2,0,0,2,27,1996,Donna Fields Gibbs
202121,2174.463106,2,0,0,2,4,2000,Benjamas Sangaram
201573,2174.45795,2,0,0,2,49,2014,Laura Robson
200083,2174.456406,2,0,0,2,15,1997,Alexandra Stevenson
201341,2174.455886,2,0,0,2,36,1994,Mi Ra Jeon
201809,2174.452669,2,0,0,2,37,1995,Hila Rosen
208797,2174.442788,4,1,0,3,30,2006,Denise Dy
201691,2174.437889,4,1,0,3,31,2007,Dia Evtimova
203509,2174.436733,4,1,0,3,45,2010,Diana Marcinkevica
201567,2174.433591,39,16,0,23,5,2011,Alexandra Dulgheru
212138,2174.423928,2,0,0,2,46,2002,Mariem Nissaf Bouchlaka
201834,2174.410544,2,0,0,2,30,1994,Heike Rusch
201354,2174.404006,10,4,0,6,1,2002,Libuse Prusova
202352,2174.395855,2,0,0,2,33,2007,Daniela Munoz Gallegos
212119,2174.393589,6,2,0,4,25,1997,Luisa Elfride Lopez
200623,2174.373103,2,0,0,2,22,1994,Petra Thoren
203297,2174.360874,6,2,0,4,6,2013,Nadiya Kichenok
202711,2174.356726,2,0,0,2,17,1996,Antoaneta Pandjerova
200707,2174.345688,2,0,0,2,20,1992,Romana Tedjakusuma
201541,2174.3389,2,0,0,2,13,2008,Chanelle Scheepers
200083,2174.333593,2,0,0,2,31,2009,Alexandra Stevenson
201089,2174.319866,2,0,0,2,22,1999,Lucie Ahl
200581,2174.3139,2,0,0,2,59,1993,Tamaka Takagi
201833,2174.311209,2,0,0,2,35,1991,Anouschka Popp
200397,2174.308533,13,5,0,8,25,1994,Tracy Austin
200547,2174.2914,28,12,0,16,2,1990,Sandra Wasserman
201277,2174.282124,7,2,0,5,3,1993,Anne Mall
200617,2174.281506,26,10,0,16,0,2012,Kimiko Date Krumm
201470,2174.281298,4,1,0,3,24,2007,Kristina Barrois
202359,2174.272524,4,1,0,3,39,2009,Chin Wei Chan
200036,2174.271263,45,21,0,24,7,2004,Nicole Pratt
200012,2174.26077,36,16,0,20,4,2000,Jana Nejedly
201334,2174.259222,2,0,0,2,15,2009,Zuzana Ondraskova
201380,2174.239739,6,2,0,4,7,2001,Claudine Schaul
200095,2174.234321,21,9,0,12,2,1990,Linda Wild
201555,2174.231543,2,0,0,2,7,2007,Polona Hercog
211768,2174.227896,2,0,0,2,7,2015,Naomi Osaka
212728,2174.217891,4,1,0,3,31,1998,Elizabeth Osborne
200707,2174.217056,2,0,0,2,36,1996,Romana Tedjakusuma
201385,2174.208605,2,0,0,2,7,2009,Yuliana Fedak
201438,2174.204859,4,1,0,3,7,2009,Ekaterina Bychkova
212080,2174.17653,2,0,0,2,39,1996,Branislava Ivanovic
201527,2174.162102,2,0,0,2,17,2006,Stefanie Voegele
200567,2174.133597,6,2,0,4,0,1991,Jennifer Santrock
202572,2174.129483,4,1,0,3,39,2009,I Hsuan Hwang
205158,2174.125608,4,1,0,3,26,2009,Rachael Dillon
202066,2174.120723,2,0,0,2,16,1995,Sandra Reichel
212492,2174.11533,2,0,0,2,33,1994,Rima Taki
201367,2174.109735,2,0,0,2,25,2007,Arantxa Parra Santonja
212111,2174.106803,4,1,0,3,33,2003,Zarah De Silva
204690,2174.106173,4,1,0,3,35,2004,Czarina Mae Arevalo
201281,2174.104471,2,0,0,2,41,2010,Laura Granville
201310,2174.098283,2,0,0,2,42,2000,Martina Muller
205908,2174.097475,4,1,0,3,31,2011,Menna El Nagdy
202685,2174.093121,4,1,0,3,14,2015,Misa Eguchi
202574,2174.089267,6,2,0,4,9,1999,Remi Tezuka
201305,2174.087868,2,0,0,2,19,2014,Eleni Daniilidou
212687,2174.086877,4,1,0,3,52,1998,Nida Waseem
200697,2174.086799,8,3,0,5,6,2000,Janette Husarova
206900,2174.086622,4,1,0,3,32,2010,Daysi Espinal
212298,2174.085875,2,0,0,2,28,2012,Michelle Kerubo Onyancha
201950,2174.079811,2,0,0,2,46,2000,Miriam Dagostini
201729,2174.076627,10,4,0,6,6,1999,Larissa Schaerer
212091,2174.06917,4,1,0,3,44,2001,Adriana Thaggard
212220,2174.068866,2,0,0,2,26,2008,Caitlin Gordon
200124,2174.068783,4,1,0,3,36,2013,Anne Kremer
206897,2174.067256,2,0,0,2,48,1995,Monika Pimentel
212546,2174.067256,2,0,0,2,48,1995,Jennifer Carter
212719,2174.067256,2,0,0,2,48,1995,Marianne Ward
206606,2174.067256,2,0,0,2,34,1998,Claudia Herbas
212176,2174.066594,2,0,0,2,33,2003,Andrea Brenes
212756,2174.066469,2,0,0,2,33,1998,Kim Brandford
212472,2174.062384,2,0,0,2,54,1999,Lilly Cal Fong
202562,2174.062384,2,0,0,2,40,2008,Hanne Skak Jensen
202217,2174.061103,4,1,0,3,44,2001,Kamila Dadakhodjaeva
200008,2174.053152,22,9,0,13,0,1999,Alicia Molik
201665,2174.052198,4,1,0,3,29,2003,Ipek Senoglu
206894,2174.050367,2,0,0,2,35,2003,Mette Iversen
206579,2174.05007,2,0,0,2,47,2000,Sarah Tami Masi
200639,2174.049811,7,2,0,5,23,1992,Claudine Toleafoa
206998,2174.048579,4,1,0,3,28,2001,Kadija Richards
202012,2174.047008,2,0,0,2,25,1991,Lee Chan
212795,2174.047008,2,0,0,2,25,1991,Macarena Miranda
206678,2174.047008,2,0,0,2,34,1994,Arati Ponnappa
212356,2174.047008,2,0,0,2,29,1995,Mette Sigmundstad
206481,2174.047008,2,0,0,2,38,1996,Viviana Valdovinos
204806,2174.047008,2,0,0,2,49,1997,Anna Barinova
206870,2174.047008,2,0,0,2,28,1998,Andria Hadjioannou
212538,2174.047008,2,0,0,2,32,1999,Shaila Ali
212776,2174.047008,2,0,0,2,54,1999,Stephanie Bernadel
212112,2174.047008,2,0,0,2,31,2001,Isoke Perry
212125,2174.047008,2,0,0,2,31,2001,Carol Cassar Torreggiani
202817,2174.047008,4,1,0,3,26,2005,Simona Iulia Matei
212182,2174.047008,2,0,0,2,33,2005,Hazar Sidki
210209,2174.047008,2,0,0,2,28,2008,Denise Atzinger
212178,2174.047008,2,0,0,2,27,2008,Ashley Brooks
212184,2174.047008,2,0,0,2,41,2008,Jenneta Halliyeva
212158,2174.047008,2,0,0,2,33,2010,Yeniseik Gomez
208067,2174.047008,2,0,0,2,32,2011,Assia Halo
212296,2174.047008,2,0,0,2,42,2012,Seyedeh Saadat
212305,2174.047008,2,0,0,2,30,2012,Joselyn Margarita Treyes Albarrac܍N
212307,2174.047008,2,0,0,2,30,2012,Luisanna Rodriguez
210439,2174.047008,2,0,0,2,27,2013,Ella Leivo
212317,2174.047008,2,0,0,2,40,2013,Sabina Korsunova
210271,2174.047008,2,0,0,2,27,2014,Anita Husaric
214638,2174.047008,2,0,0,2,31,2014,Melena Lopez
210046,2174.047008,2,0,0,2,27,2015,Anna Clarice Patrimonio
207247,2174.046797,4,1,0,3,45,2000,Lan Lan Tai
212192,2174.04229,2,0,0,2,31,2004,Meera Kantaria
207262,2174.034907,4,1,0,3,32,1992,Janaki Krishnamoorthy
201426,2174.034723,2,0,0,2,5,2006,Pauline Parmentier
201629,2174.03345,2,0,0,2,20,1992,Yael Segal
212092,2174.029034,4,1,0,3,53,1999,Archana Reddy
202339,2174.029004,4,1,0,3,41,2012,Ayu Fani Damayanti
212676,2174.028245,2,0,0,2,47,1993,Natalie Adsuar
202493,2174.028245,2,0,0,2,40,2008,Ekaterine Gorgodze
205700,2174.028245,2,0,0,2,31,2011,Emma Flood
211816,2174.028245,2,0,0,2,32,2011,Alina Soltanici
212681,2174.026757,2,0,0,2,46,1993,Gillian Carter
207138,2174.026757,2,0,0,2,59,1997,Jahnavi Parekh
201844,2174.026757,2,0,0,2,42,1998,Agnese Gustmane
203902,2174.025809,2,0,0,2,25,1991,Divya Merchant
212446,2174.02503,4,1,0,3,44,1994,Elizabeth Gibson
202628,2174.024598,4,1,0,3,3,2013,Maryna Zanevska
201298,2174.02282,6,2,0,4,31,2005,Zsofia Gubacsi
212735,2174.020549,2,0,0,2,48,1996,Mesenbete Shenkutee
203281,2174.0189,2,0,0,2,9,2014,Amandine Hesse
201298,2174.0109,4,1,0,3,16,2004,Zsofia Gubacsi
202930,2174.00939,2,0,0,2,36,2000,Jessica Roland Rosario
202520,2174.008664,4,1,0,3,48,1996,Julia Muir
210640,2174.008133,2,0,0,2,28,2012,Liniques Theron
205763,2174.007943,4,1,0,3,29,2004,Essi Laine
212611,2174.007699,2,0,0,2,44,1994,Jennifer Ligator
202399,2174.007487,4,1,0,3,31,2005,Margit Ruutel
212401,2174.007228,4,1,0,3,48,1996,Angelika Schadler
204391,2174.00609,2,0,0,2,37,2013,Sofia Kvatsabaia
205010,2174.00553,4,1,0,3,26,2007,Magy Aziz
201457,2173.994289,8,3,0,5,25,2013,Jarmila Gajdosova
200717,2173.991413,2,0,0,2,57,1994,Anne Miller
201754,2173.991084,2,0,0,2,33,2005,Leanne Baker
202012,2173.987315,2,0,0,2,45,2000,Lee Chan
206289,2173.96738,2,0,0,2,9,2015,Maria Sakkari
203939,2173.958775,4,1,0,3,40,1998,Maria Eugenia Rojas
201295,2173.946867,6,2,0,4,5,2005,Wynne Prakusya
200029,2173.936218,2,0,0,2,26,2000,Lisa Mcshea
201339,2173.935708,18,7,0,11,4,2010,Renata Voracova
202702,2173.933846,8,3,0,5,3,2014,Tereza Smitkova
203309,2173.931565,4,1,0,3,31,2005,Mariya Kovaleva
201697,2173.930182,7,2,0,5,6,2011,Kristyna Pliskova
201088,2173.926348,6,2,0,4,19,1995,Karen Cross
201194,2173.924276,2,0,0,2,18,1993,Tammy Whittington
204481,2173.909785,4,1,0,3,52,1999,Kylie Moulds
201443,2173.890439,4,1,0,3,8,2015,Alexa Glatch
201069,2173.879849,2,0,0,2,19,2001,Karolina Jagieniak
201410,2173.875867,2,0,0,2,8,2009,Monique Adamczak
205195,2173.856728,4,1,0,3,28,2002,Alanna Broderick
200059,2173.848896,4,1,0,3,43,2004,Ruxandra Dragomir Ilie
201952,2173.846607,2,0,0,2,33,1995,Elena Savoldi
212761,2173.846407,2,0,0,2,36,1993,Ande Tulp
207100,2173.842131,2,0,0,2,38,1994,Alexandra Rentzoula
200680,2173.840435,2,0,0,2,16,1995,Nadin Ercegovic
201568,2173.837728,4,1,0,3,7,2009,Kristina Kucova
200734,2173.835267,2,0,0,2,53,1997,Tatjana Jecmenica
211533,2173.833554,6,2,0,4,8,2014,Jelena Ostapenko
200107,2173.809901,13,5,0,8,10,1994,Paola Suarez
203552,2173.798185,2,0,0,2,4,2014,Risa Ozaki
201188,2173.7904,2,0,0,2,30,1991,Barbara Griffiths
200087,2173.78849,4,1,0,3,0,1997,Seda Noorlander
203501,2173.786709,4,1,0,3,12,2013,Taylor Townsend
207947,2173.77787,4,1,0,3,31,2005,Yamile Fors Guerra
200710,2173.777863,2,0,0,2,21,1994,Magdalena Feistel
201465,2173.773027,4,1,0,3,2,2005,Kirsten Flipkens
200553,2173.77012,4,1,0,3,21,1990,Carin Bakkum
201580,2173.76989,2,0,0,2,5,2013,Xinyun Han
201406,2173.756384,15,6,0,9,5,2005,Shikha Uberoi
201430,2173.756382,2,0,0,2,19,2008,Yulia Fedossova
200006,2173.755757,16,6,0,10,14,2001,Karina Habsudova
201433,2173.750476,2,0,0,2,1,2005,Sarah Borwell
201668,2173.74234,12,5,0,7,6,2015,Alexandra Panova
207956,2173.737612,4,1,0,3,45,2000,Yanet Nunez Mojarena
201369,2173.732273,2,0,0,2,37,2010,Carly Gullickson
204715,2173.727229,4,1,0,3,45,2000,Cecilia Guillenea
201373,2173.717312,49,23,0,26,2,2006,Maria Kirilenko
200025,2173.717237,26,11,0,15,1,2002,Ludmila Cervanova
201609,2173.709489,2,0,0,2,5,2010,Yi Miao Zhou
200776,2173.709165,2,0,0,2,12,2007,Angelika Bachmann
202369,2173.683925,4,1,0,3,7,2007,Tara Iyer
201680,2173.683,4,1,0,3,31,2005,Anna Gerasimou
201281,2173.662786,3,0,0,3,14,2001,Laura Granville
200750,2173.658312,4,1,0,3,10,1998,Karin Miller
201706,2173.652072,6,2,0,4,8,2011,Eirini Georgatou
201298,2173.649064,2,0,0,2,15,2006,Zsofia Gubacsi
202104,2173.643848,2,0,0,2,8,1995,Kazue Takuma
212098,2173.63799,4,1,0,3,45,2000,Farah Dayoub
205758,2173.636704,4,1,0,3,25,2008,Heini Salonen
206666,2173.633141,6,2,0,4,25,1997,Paula Umana
202078,2173.626214,2,0,0,2,41,1994,Rosabel Moyen
201532,2173.625652,2,0,0,2,38,2012,Anastasia Pivovarova
201538,2173.62384,2,0,0,2,47,2012,Isabella Holland
201691,2173.615969,4,1,0,3,39,2008,Dia Evtimova
202323,2173.614702,2,0,0,2,37,2003,Eden Marama
201048,2173.613489,2,0,0,2,3,1993,Leona Laskova
200715,2173.612414,2,0,0,2,50,2001,Mariaan De Swardt
202384,2173.606672,2,0,0,2,38,2013,Kyra Shroff
201348,2173.604417,4,1,0,3,37,2009,Casey Dellacqua
212106,2173.601065,4,1,0,3,28,2001,Lisa Fung Kee Fung
202659,2173.600825,2,0,0,2,42,2014,Tereza Mrdeza
200746,2173.592194,2,0,0,2,31,1997,Sandra Kloesel
200047,2173.585307,2,0,0,2,64,2002,Pavlina Nola
204899,2173.585088,4,1,0,3,26,1998,Evghenia Ablovatchi
200518,2173.582979,2,0,0,2,33,1992,Paulette Moreno
202289,2173.57367,4,1,0,3,31,2005,Jin Hee Kim
201273,2173.567702,2,0,0,2,26,1994,Shannan Mccarthy
203939,2173.56491,2,0,0,2,42,1995,Maria Eugenia Rojas
202119,2173.56491,2,0,0,2,46,2000,Olivia Fery
212213,2173.56491,2,0,0,2,26,2008,Jacklyn Lambert
210439,2173.56491,2,0,0,2,28,2012,Ella Leivo
212722,2173.563204,2,0,0,2,54,1999,Genevieve Etienne
209575,2173.563204,2,0,0,2,28,2009,Yasmine Alkema
202900,2173.562541,4,1,0,3,45,2010,Maria Fernanda Alvarez Teran
212278,2173.56182,2,0,0,2,41,2012,Sarah Al Balushi
201326,2173.561818,2,0,0,2,25,2005,Bahia Mouhtassine
206581,2173.560377,2,0,0,2,46,2000,Maria Alejandra Garcia
212156,2173.56004,2,0,0,2,27,2002,Yimara Figueroa
201646,2173.553942,2,0,0,2,24,2010,Maria Joao Koehler
212432,2173.545366,2,0,0,2,46,1993,Kim Cartwright
212125,2173.544634,2,0,0,2,27,1998,Carol Cassar Torreggiani
202387,2173.544634,2,0,0,2,35,2004,Vlada Ekshibarova
204327,2173.543169,2,0,0,2,39,2009,Mai Grage
203968,2173.542962,2,0,0,2,26,1995,Dalia El Sheikh
212115,2173.542962,2,0,0,2,54,1999,Tara Lambert
201664,2173.542962,2,0,0,2,29,2003,Pemra Ozgen
210132,2173.542962,2,0,0,2,48,2011,Maria Ines Deheza
201072,2173.541351,2,0,0,2,62,2000,Eva Bes Ostariz
201383,2173.529943,2,0,0,2,12,2001,Marie Eve Pelletier
212213,2173.524295,4,1,0,3,31,2007,Jacklyn Lambert
200221,2173.524294,2,0,0,2,41,1990,Dianne Balestrat
201802,2173.524294,4,1,0,3,12,1990,Ulrike Priller
200619,2173.524294,2,0,0,2,53,1991,Kate Mcdonald
206666,2173.524294,2,0,0,2,41,1992,Paula Umana
207166,2173.524294,2,0,0,2,49,1992,Ismet Duygu Aksit Oal
212391,2173.524294,2,0,0,2,41,1992,Paula Alvarez
212468,2173.524294,2,0,0,2,49,1992,Maria Jose Likibi
212476,2173.524294,2,0,0,2,34,1992,Tze May Lee
212609,2173.524294,2,0,0,2,48,1993,Rosanna Valerio
212499,2173.524294,2,0,0,2,33,1994,Sara Taweel
212120,2173.524294,2,0,0,2,48,1995,Kyla Hunte
212564,2173.524294,2,0,0,2,49,1995,Ann Simons
212149,2173.524294,2,0,0,2,50,1996,Jeannine Niedhardt
201059,2173.524294,2,0,0,2,50,1997,Misumi Miyauchi
203143,2173.524294,12,5,0,7,45,1998,Nicole Sewell
212523,2173.524294,2,0,0,2,32,1999,Joanna Rossi
201753,2173.524294,2,0,0,2,49,2000,Rewa Harriman
212129,2173.524294,2,0,0,2,31,2001,Caroline Oduor
202258,2173.524294,2,0,0,2,56,2002,Jaslyn Hewitt
204874,2173.524294,2,0,0,2,55,2002,Tracey Oconnor
203969,2173.524294,2,0,0,2,29,2003,Yomna Farid
212082,2173.524294,2,0,0,2,30,2003,Lisa Camenzuli
212181,2173.524294,2,0,0,2,37,2004,Bianca Gorbea
200071,2173.524294,2,0,0,2,43,2005,Lenka Nemeckova
201415,2173.524294,2,0,0,2,46,2005,Tiffany Welford
208207,2173.524294,2,0,0,2,28,2005,Ina Sartz
205276,2173.524294,2,0,0,2,28,2006,Alise Vaidere
212213,2173.524294,2,0,0,2,34,2006,Jacklyn Lambert
202498,2173.524294,2,0,0,2,17,2007,Julia Glushko
205763,2173.524294,2,0,0,2,34,2007,Essi Laine
201277,2173.524294,2,0,0,2,40,2008,Anne Mall
201281,2173.524294,2,0,0,2,43,2008,Laura Granville
203323,2173.524294,2,0,0,2,40,2008,Anna Koumantou
209982,2173.524294,2,0,0,2,41,2008,Ranim Mkahal
201411,2173.524294,2,0,0,2,18,2009,Aiko Nakamura
212232,2173.524294,2,0,0,2,27,2009,Carlista Mohammed
201682,2173.524294,2,0,0,2,44,2010,Nudnida Luangnam
212263,2173.524294,2,0,0,2,47,2010,Si Ying Julienne Keong
201388,2173.524294,2,0,0,2,51,2011,Sophie Ferguson
211267,2173.524294,2,0,0,2,33,2011,Daniela Ciobanu
206174,2173.524294,2,0,0,2,39,2013,Cecilia Costa Melgar
206332,2173.524294,2,0,0,2,37,2013,Camila Giangreco Campiz
212213,2173.524294,2,0,0,2,33,2014,Jacklyn Lambert
214625,2173.524294,2,0,0,2,45,2014,Eliza Omirou
214629,2173.524294,2,0,0,2,43,2014,Anna Soffia Gronholm
214636,2173.524294,2,0,0,2,31,2014,Daniela Diez
212198,2173.523503,2,0,0,2,26,2005,Selima Frioui
200618,2173.522779,2,0,0,2,39,1990,Eva Maria Schurhoff
212204,2173.522711,2,0,0,2,26,2009,Stephanie Sullivan
201365,2173.522132,2,0,0,2,17,2015,Edina Gallovits Hall
208549,2173.519274,2,0,0,2,29,2004,Aliaa Fakhry
204451,2173.513448,2,0,0,2,36,2004,Asimina Kaplani
202276,2173.511444,4,1,0,3,35,2004,Shelley Bryce
203944,2173.509896,2,0,0,2,41,1997,Candice De La Torre
201209,2173.509803,2,0,0,2,41,2007,Selima Sfar
206575,2173.506344,2,0,0,2,49,1992,Galina Misiuriova
212238,2173.50562,2,0,0,2,33,2007,Leyla Esther Cabrera
212469,2173.504669,2,0,0,2,49,1992,Michelle Likibi
201538,2173.503951,2,0,0,2,43,2009,Isabella Holland
206867,2173.503922,2,0,0,2,27,1995,Eleni Pilava Papanikolaou
212135,2173.503922,2,0,0,2,31,2001,Ina Sireteanu
202549,2173.503922,2,0,0,2,31,2007,Erika Clarke Magana
211296,2173.503308,2,0,0,2,26,2014,Dea Herdzelas
212303,2173.502524,4,1,0,3,25,2013,Justina Mikulskyte
204588,2173.50098,2,0,0,2,40,1994,Karen Nugent
201067,2173.499616,2,0,0,2,22,1995,Caroline Dhenin
200583,2173.497393,16,7,0,9,7,1995,Laxmi Poruri
202659,2173.494587,8,3,0,5,14,2013,Tereza Mrdeza
212111,2173.485975,4,1,0,3,28,2001,Zarah De Silva
212252,2173.48297,2,0,0,2,25,2008,Lee Anne Lingo
202339,2173.473697,4,1,0,3,45,2010,Ayu Fani Damayanti
200124,2173.473152,2,0,0,2,41,1994,Anne Kremer
202128,2173.466165,4,1,0,3,8,1996,Riei Kawamata
202589,2173.465071,4,1,0,3,25,2010,Christi Potgieter
212194,2173.464811,2,0,0,2,30,2004,Laone Botshoma
212674,2173.461801,2,0,0,2,25,1991,Natasha Villarroel
201945,2173.457391,4,1,0,3,41,1995,Patricia Segala
212697,2173.452264,4,1,0,3,35,1993,Marie Christine Goy
206869,2173.451231,4,1,0,3,31,1999,Stephanie Kamberi
201035,2173.450592,4,1,0,3,17,1990,Kate Gompert
201674,2173.442957,4,1,0,3,9,2012,Sabina Sharipova
203968,2173.442566,2,0,0,2,34,1997,Dalia El Sheikh
200109,2173.440055,2,0,0,2,22,1995,Nathalie Dechy
201478,2173.427212,39,17,0,22,3,2015,Varvara Lepchenko
212116,2173.425223,2,0,0,2,28,2001,Alexia Llysel Marquez
202302,2173.414473,2,0,0,2,33,2013,Maria Fernanda Alves
201288,2173.412558,4,1,0,3,33,1995,Maja Palaversic Cooper Smith
201075,2173.412266,2,0,0,2,5,2000,Liezel Huber
201830,2173.412007,2,0,0,2,24,1990,Katharina Duell
200089,2173.403683,20,8,0,12,12,1992,Miriam Oremans
200751,2173.39901,22,9,0,13,12,2003,Conchita Martinez Granados
201942,2173.394268,4,1,0,3,6,1999,Andreea Ehritt Vanc
201547,2173.381313,13,5,0,8,7,2013,Michelle Larcher De Brito
200008,2173.367229,43,18,0,25,2,2007,Alicia Molik
200498,2173.363931,37,16,0,21,9,1993,Michelle Jaggard Lai
201580,2173.358075,6,2,0,4,7,2011,Xinyun Han
201992,2173.33563,2,0,0,2,17,1993,Sabine Lohmann
200677,2173.332589,2,0,0,2,6,1990,Katja Oeljeklaus
201063,2173.324781,9,3,0,6,3,1993,Maria Francesca Bentivoglio
200611,2173.314139,2,0,0,2,24,1992,Tracey Morton Rodgers
201473,2173.312874,2,0,0,2,9,2008,Vasilisa Bardina
201882,2173.309828,4,1,0,3,31,2000,Katarzyna Straczy
201089,2173.308908,4,1,0,3,20,2003,Lucie Ahl
201920,2173.308719,2,0,0,2,12,2001,Renata Kolbovic
201416,2173.290038,2,0,0,2,3,2003,Alona Bondarenko
212780,2173.280859,2,0,0,2,36,1993,Myriam Berthe
206666,2173.259684,4,1,0,3,44,1994,Paula Umana
212125,2173.253988,2,0,0,2,39,1994,Carol Cassar Torreggiani
201203,2173.247165,2,0,0,2,15,1998,Alena Nesticka
202349,2173.231148,2,0,0,2,7,2006,Rushmi Chakravarthi
200100,2173.226309,30,14,0,16,10,2000,Amanda Hopmans
201488,2173.223295,2,0,0,2,31,2010,Jorgelina Cravero
207828,2173.205371,4,1,0,3,35,1993,Paula Iversen
201469,2173.197934,10,4,0,6,6,2008,Melanie South
202192,2173.197342,2,0,0,2,17,1999,Tzu Ting Weng
200583,2173.190824,2,0,0,2,36,1990,Laxmi Poruri
201302,2173.186273,36,16,0,20,12,2003,Clarisa Fernandez
206579,2173.177261,2,0,0,2,35,2003,Sarah Tami Masi
201860,2173.172271,2,0,0,2,49,2001,Mariam Ramon Climent
201038,2173.157105,2,0,0,2,31,1990,Karen Schimper
212167,2173.152476,2,0,0,2,35,2003,Si Nga Lee
201281,2173.150136,2,0,0,2,8,2009,Laura Granville
201743,2173.14835,2,0,0,2,3,1993,Laura Glitz
200007,2173.146589,24,10,0,14,6,2004,Silvija Talaja
212188,2173.144815,2,0,0,2,31,2005,Yun Ling Ng
201269,2173.136941,4,1,0,3,6,1995,Eleni Rossides
202302,2173.123277,4,1,0,3,13,2005,Maria Fernanda Alves
202434,2173.117268,34,15,0,19,3,2015,Aleksandra Krunic
201080,2173.114964,4,1,0,3,22,1999,Louise Latimer
201541,2173.113562,2,0,0,2,37,2004,Chanelle Scheepers
200083,2173.105448,4,1,0,3,21,2011,Alexandra Stevenson
200520,2173.095431,2,0,0,2,25,1992,Sarah Loosemore
207934,2173.088826,2,0,0,2,31,2000,Meryem Lahlou
202265,2173.084609,2,0,0,2,9,2001,Mirielle Dittmann
212130,2173.079793,2,0,0,2,30,2004,Evelyn Otula
212686,2173.078354,4,1,0,3,52,1998,Haleema Rahim
200057,2173.077469,6,2,0,4,3,1998,Erika De Lone
201399,2173.075614,2,0,0,2,19,2011,Emily Webley Smith
201211,2173.069941,6,2,0,4,5,2006,Kyra Nagy
201190,2173.062836,2,0,0,2,30,1991,Kaye Marfini Hand
204294,2173.061033,2,0,0,2,4,2015,Su Jeong Jang
212133,2173.05916,2,0,0,2,29,2001,Esther Mbugua
201086,2173.057952,2,0,0,2,49,2003,Greta Arn
206910,2173.056082,4,1,0,3,42,1997,Mari Toro
201682,2173.05301,4,1,0,3,38,2008,Nudnida Luangnam
200711,2173.051235,2,0,0,2,40,1996,Tatiana Ignatieva
211534,2173.046401,2,0,0,2,25,2013,Erika Hendsel
210920,2173.042927,2,0,0,2,39,2009,Kerrie Cartwright
201207,2173.040744,2,0,0,2,50,2004,Ansley Cargill
200120,2173.040744,2,0,0,2,45,2006,Jelena Dokic
212528,2173.040711,4,1,0,3,34,1997,Christine Njeuma
212205,2173.039663,2,0,0,2,25,2008,Sandra Kristjansdottir
208421,2173.039656,4,1,0,3,34,2003,Maria Teresa Salame
203323,2173.039105,2,0,0,2,31,2005,Anna Koumantou
201341,2173.038296,2,0,0,2,7,1998,Mi Ra Jeon
200727,2173.035856,4,1,0,3,13,1998,Adriana Serra Zanetti
212581,2173.035255,2,0,0,2,37,1995,Victoria Bakhtadze
200676,2173.02891,4,1,0,3,45,1998,Mana Endo
214623,2173.021127,2,0,0,2,43,2014,Lusine Chobanyan
212390,2173.020372,2,0,0,2,48,1995,Florea De Maria Urrea
212683,2173.020372,2,0,0,2,48,1995,Lily Aguirre
212693,2173.020372,2,0,0,2,48,1995,Natalia Garcia
203234,2173.020372,6,2,0,4,9,1999,Keiko Taguchi
212137,2173.020372,2,0,0,2,31,2001,Kago Phatshwane
202366,2173.020372,2,0,0,2,40,2009,Sanaa Bhambri
212295,2173.020372,2,0,0,2,39,2013,Sahar Najaei
207696,2173.02034,2,0,0,2,41,1994,Imen Ben Larbi
202276,2173.02034,2,0,0,2,36,1995,Shelley Bryce
200036,2173.02034,2,0,0,2,21,1996,Nicole Pratt
212459,2173.02034,2,0,0,2,36,1997,Tsedey Kifle
200719,2173.02034,2,0,0,2,60,1998,Siobhan Drake Brockman
212539,2173.02034,2,0,0,2,32,1999,Naheeda Noormohamed
201484,2173.02034,2,0,0,2,42,2007,Sandra Zahlavova
212288,2173.02034,2,0,0,2,42,2012,Gabrielle Moxey
212265,2173.020281,2,0,0,2,46,2010,Kett Sadi
209573,2173.020281,2,0,0,2,31,2011,Fatima Zorah Bouabdallah
214030,2173.020281,2,0,0,2,27,2014,Nikoleta Bulatovic
201700,2173.019639,2,0,0,2,40,2009,Nikola Hofmanova
201301,2173.010261,11,4,0,7,9,2009,Camille Pin
202468,2173.003903,2,0,0,2,9,2012,Jessica Pegula
212719,2173.002845,2,0,0,2,26,1991,Marianne Ward
208774,2173.000001,2,0,0,2,32,2005,Paola Doldan Gonzalez
212432,2173,2,0,0,2,26,1991,Kim Cartwright
212453,2173,2,0,0,2,26,1991,Henrietta Harris
212571,2173,2,0,0,2,26,1991,Chern Yi Chiew
212802,2173,2,0,0,2,25,1991,Louise Wekesa
207698,2173,2,0,0,2,38,1993,Aicha Ferjani
212392,2173,2,0,0,2,47,1993,Alejandra Gomez
200029,2173,2,0,0,2,61,1994,Lisa Mcshea
202105,2173,4,1,0,3,8,1996,Anori Fukuda
203008,2173,6,2,0,4,8,1996,Miyako Ataka
204173,2173,4,1,0,3,8,1996,Yuki Fujii
204478,2173,6,2,0,4,54,1996,Angie Marik
212499,2173,2,0,0,2,58,1996,Sara Taweel
200557,2173,2,0,0,2,63,1997,Katrina Adams
201847,2173,4,1,0,3,62,1997,Mareze Joubert
202128,2173,4,1,0,3,10,1997,Riei Kawamata
202957,2173,4,1,0,3,62,1997,Madoka Kuki
203182,2173,2,0,0,2,10,1997,Shizu Katsumi
204051,2173,2,0,0,2,10,1997,Chie Nagano
204174,2173,4,1,0,3,10,1997,Satoko Kurioka
204175,2173,4,1,0,3,10,1997,Akiko Gunji
204504,2173,6,2,0,4,62,1997,Denisa Sobotkova
207395,2173,2,0,0,2,10,1997,Shizuka Tokiwa
212070,2173,2,0,0,2,10,1997,Megumi Katakura
201959,2173,2,0,0,2,43,1998,Ana Catarina Nogueira
202752,2173,2,0,0,2,9,1998,Aurandrea Narvaez
202986,2173,2,0,0,2,9,1998,Kaori Aoyama
202993,2173,4,1,0,3,9,1998,Sachie Umehara
203006,2173,4,1,0,3,50,1998,Nikola Hubnerova
203091,2173,2,0,0,2,9,1998,Yumiko Kitamura
204179,2173,2,0,0,2,9,1998,Chiaki Nakajima
201708,2173,6,2,0,4,52,1999,Natalie Grandin
202250,2173,6,2,0,4,52,1999,Patty Murren
203143,2173,6,2,0,4,52,1999,Nicole Sewell
204121,2173,4,1,0,3,52,1999,Tu Dong
212112,2173,2,0,0,2,55,1999,Isoke Perry
212723,2173,2,0,0,2,55,1999,Jennifer Adrien
201289,2173,4,1,0,3,59,2000,Christina Wheeler
202192,2173,4,1,0,3,59,2000,Tzu Ting Weng
203033,2173,2,0,0,2,59,2000,Keiko Tameishi
203051,2173,4,1,0,3,59,2000,Satomi Kinjo
203143,2173,2,0,0,2,59,2000,Nicole Sewell
203184,2173,2,0,0,2,59,2000,Beti Sekulovski
204024,2173,2,0,0,2,59,2000,Natalie Dittmann
204474,2173,2,0,0,2,59,2000,Susan Cowan
204629,2173,4,1,0,3,59,2000,Emma Gott
204888,2173,4,1,0,3,59,2000,Ljiljana Nanusevic
201858,2173,2,0,0,2,52,2001,Kristina Triska
201859,2173,6,2,0,4,52,2001,Luciana Masante
202549,2173,2,0,0,2,52,2001,Erika Clarke Magana
202761,2173,2,0,0,2,52,2001,Michelle Faucher
202948,2173,2,0,0,2,52,2001,Elizabeth Schmidt
204208,2173,2,0,0,2,52,2001,Lauren Cheung
204450,2173,2,0,0,2,52,2001,Barbara Rosenberger
204555,2173,2,0,0,2,52,2001,Isabella Mitterlehner
204609,2173,4,1,0,3,52,2001,Giulia Meruzzi
204861,2173,6,2,0,4,52,2001,Ilona Vichnevskaya
204936,2173,2,0,0,2,52,2001,Candela Novoa
206917,2173,2,0,0,2,38,2001,Alexandra Guzman
212141,2173,2,0,0,2,33,2001,Meriem Zitouni
201350,2173,2,0,0,2,56,2002,Adriana Szili
201388,2173,2,0,0,2,56,2002,Sophie Ferguson
201410,2173,6,2,0,4,56,2002,Monique Adamczak
201862,2173,2,0,0,2,63,2002,Vanessa Menga
202350,2173,4,1,0,3,63,2002,Olena Antypina
203002,2173,2,0,0,2,63,2002,Karin Palme
203015,2173,4,1,0,3,56,2002,Amanda Augustus
203033,2173,2,0,0,2,56,2002,Keiko Tameishi
203087,2173,6,2,0,4,63,2002,Sabrina Eisenberg
203102,2173,2,0,0,2,63,2002,Maria Rosa Sitja Gibert
203117,2173,2,0,0,2,56,2002,Jenny Belobrajdic
203194,2173,6,2,0,4,63,2002,Leticia Sobral
204208,2173,6,2,0,4,56,2002,Lauren Cheung
204211,2173,2,0,0,2,56,2002,Lara Giltinan
204557,2173,6,2,0,4,63,2002,Silvia Hegedis
204570,2173,4,1,0,3,63,2002,Alejandra Rivero
204572,2173,4,1,0,3,63,2002,Maria Eugenia Brito
204861,2173,6,2,0,4,63,2002,Ilona Vichnevskaya
204895,2173,2,0,0,2,56,2002,Kim Coventry
205372,2173,2,0,0,2,56,2002,Sevvy Gallios
207763,2173,2,0,0,2,63,2002,Marta Simic
201201,2173,2,0,0,2,45,2003,Surina De Beer
202549,2173,4,1,0,3,45,2003,Erika Clarke Magana
203185,2173,4,1,0,3,45,2003,Arpi Kojian
203208,2173,4,1,0,3,45,2003,Karen Paterson
203216,2173,2,0,0,2,45,2003,Marcela Arroyo Vergara
204208,2173,2,0,0,2,45,2003,Lauren Cheung
204213,2173,2,0,0,2,45,2003,Chantal Coombs
204942,2173,4,1,0,3,45,2003,Madita Suer
204944,2173,2,0,0,2,45,2003,Darya Ivanov
204945,2173,6,2,0,4,45,2003,Deanna Roberts
205090,2173,2,0,0,2,45,2003,Lara Picone
205127,2173,2,0,0,2,45,2003,Ana Cecilia Trevino
205145,2173,2,0,0,2,45,2003,Kokoro Takehara
205213,2173,6,2,0,4,45,2003,Micaela Moran
207152,2173,2,0,0,2,45,2003,Bree Calderwood
208248,2173,2,0,0,2,45,2003,Christine Alford
208274,2173,2,0,0,2,45,2003,Alejandra Obregon
212077,2173,2,0,0,2,45,2003,Kelly Blanch
201405,2173,2,0,0,2,46,2005,Nan Nan Liu
208979,2173,2,0,0,2,34,2007,Idunn Hertzberg
201536,2173,2,0,0,2,43,2009,Monika Wejnert
209712,2173,2,0,0,2,29,2009,Elaine Genovese
201676,2173,2,0,0,2,50,2011,Ye Ra Lee
202818,2173,2,0,0,2,31,2011,Samia Medjahdi
206103,2173,2,0,0,2,50,2011,Ashvarya Shrivastava
210159,2173,2,0,0,2,50,2011,Anna Christine Patrimonio
212275,2173,2,0,0,2,50,2011,Alena Panfilova
212279,2173,2,0,0,2,50,2011,Maliha Al Awaidy
212148,2172.999208,2,0,0,2,25,1998,Nadia Kilani
201275,2172.995716,6,2,0,4,20,1995,Julie Steven
203140,2172.993118,2,0,0,2,21,2004,Bruna Colosio
200333,2172.989893,20,8,0,12,14,1990,Betsy Nagelsen
201747,2172.986791,4,1,0,3,33,1994,Lihini Weerasuriya
212319,2172.986506,4,1,0,3,37,2013,Arina Beliaeva
200384,2172.981209,2,0,0,2,60,1992,Eva Pfaff
212267,2172.980474,2,0,0,2,32,2010,Maria Clara Bernardez
212356,2172.979628,2,0,0,2,39,1996,Mette Sigmundstad
212268,2172.979628,2,0,0,2,23,2011,Camila Quesada
212470,2172.979047,2,0,0,2,30,1999,Florence Mbugua
200701,2172.978056,2,0,0,2,3,1991,Caroline Vis
201167,2172.977931,2,0,0,2,25,1991,Ellinore Lightbody
203309,2172.976553,2,0,0,2,31,2007,Mariya Kovaleva
200403,2172.974487,2,0,0,2,13,1993,Andrea Leand
202042,2172.974391,4,1,0,3,1,1994,Natalia Soetrisno
200428,2172.968593,2,0,0,2,50,1999,Lori Mcneil
206671,2172.968559,4,1,0,3,42,1999,Karem Harboe
201281,2172.967498,28,12,0,16,1,2006,Laura Granville
200093,2172.967188,2,0,0,2,18,1996,Amelie Cocheteux
212613,2172.963069,2,0,0,2,26,1991,Beverly Corbie
206183,2172.962411,2,0,0,2,14,2015,Cindy Burger
200425,2172.961041,2,0,0,2,28,1992,Sophie Amiach
202296,2172.956114,2,0,0,2,40,2002,Maria Jose Lopez Herrera
214620,2172.948059,4,1,0,3,44,2014,Sahar Amini Hajibashi
200099,2172.946754,2,0,0,2,13,1992,Sonya Jeyaseelan
200674,2172.943974,29,12,0,17,10,1992,Bettina Fulco Villella
207893,2172.93837,4,1,0,3,29,2004,Cigdem Duru
201457,2172.936438,20,8,0,12,3,2006,Jarmila Gajdosova
200053,2172.936409,2,0,0,2,18,1993,Lubomira Bacheva
206917,2172.930416,4,1,0,3,41,1998,Alexandra Guzman
207428,2172.929409,2,0,0,2,38,2001,Suzi Becvinovska
201926,2172.927709,2,0,0,2,2,1994,Stephanie Reece
201339,2172.90576,2,0,0,2,4,2014,Renata Voracova
200735,2172.904777,2,0,0,2,4,2003,Miho Saeki
212236,2172.897998,2,0,0,2,32,2007,Pamela Adom Mendez
200104,2172.896472,10,4,0,6,8,2000,Emilie Loit
202123,2172.892379,6,2,0,4,45,1998,Suvimol Duangchan
203898,2172.888672,2,0,0,2,40,1996,Tina Samara
202301,2172.886038,2,0,0,2,7,2006,Sunitha Rao
201344,2172.88461,36,16,0,20,4,2003,Klara Koukalova
201570,2172.88227,6,2,0,4,8,2014,Vesna Dolonc
201443,2172.879245,2,0,0,2,10,2008,Alexa Glatch
200448,2172.856321,2,0,0,2,14,1994,Sandy Collins
206626,2172.842529,2,0,0,2,44,1999,Nuria Niemes
204925,2172.822851,2,0,0,2,37,2001,Claudia Salgues
203996,2172.813608,2,0,0,2,39,1999,Cristina Correia
200006,2172.808436,23,9,0,14,2,1992,Karina Habsudova
201559,2172.803277,2,0,0,2,21,2009,Irena Pavlovic
204123,2172.799884,4,1,0,3,41,1992,Maria Dolores Campana
203125,2172.795482,10,4,0,6,33,1997,Rochelle Rosenfield
206862,2172.789015,6,2,0,4,32,1997,Daphne Nicolatou
201486,2172.775642,6,2,0,4,1,2005,Aleksandra Wozniak
201924,2172.775229,2,0,0,2,2,1994,Caroline Delisle
200027,2172.756641,48,20,0,28,2,1999,Magui Serna
201318,2172.749364,2,0,0,2,14,2001,Bethanie Mattek Sands
200010,2172.746056,29,12,0,17,3,1996,Rita Grande
204864,2172.743239,4,1,0,3,30,2004,Anzela Zguna
208427,2172.742601,2,0,0,2,35,2003,Amanda Melgarejo
200444,2172.740299,7,2,0,5,1,1992,Elise Burgin
201397,2172.739172,2,0,0,2,43,2003,Shuai Peng
202399,2172.737901,2,0,0,2,38,2001,Margit Ruutel
200612,2172.734999,2,0,0,2,37,1999,Natalia Medvedeva
202429,2172.734319,16,6,0,10,5,2012,Camila Giorgi
201632,2172.730214,2,0,0,2,7,2005,Ryoko Fuda
202481,2172.723792,2,0,0,2,14,2013,Chi Chi Scholl
201968,2172.719818,2,0,0,2,21,1994,Geraldine Dondit
200052,2172.708926,4,1,0,3,24,2002,Olga Barabanschikova
200659,2172.702273,2,0,0,2,29,1990,Rika Hiraki
200425,2172.691449,2,0,0,2,20,1995,Sophie Amiach
201509,2172.686164,2,0,0,2,8,2011,Ashley Weinhold
201443,2172.685137,2,0,0,2,16,2013,Alexa Glatch
201664,2172.681668,2,0,0,2,39,2013,Pemra Ozgen
200691,2172.669349,4,1,0,3,20,1999,Flora Perfetti
200686,2172.662853,5,1,0,4,16,1992,Sandra Dopfer
201370,2172.658793,2,0,0,2,19,2001,Anastasia Rodionova
201491,2172.651424,2,0,0,2,21,2009,Olivia Sanchez
200120,2172.64997,4,1,0,3,21,2008,Jelena Dokic
202453,2172.62433,2,0,0,2,5,2011,Saisai Zheng
200024,2172.622051,6,2,0,4,10,2002,Maria Vento Kabchi
202774,2172.617008,4,1,0,3,45,2000,Ka Po Tong
202372,2172.615234,2,0,0,2,30,2007,Lucia Batta
201667,2172.614569,2,0,0,2,4,2015,Ling Zhang
203010,2172.61047,4,1,0,3,8,1996,Ryoko Takemura
201882,2172.608602,2,0,0,2,37,2002,Katarzyna Straczy
201326,2172.59699,4,1,0,3,21,2002,Bahia Mouhtassine
201410,2172.595688,2,0,0,2,46,2005,Monique Adamczak
201524,2172.594601,30,13,0,17,3,2015,Urszula Radwanska
201442,2172.594574,19,7,0,12,4,2009,Yung Jan Chan
201082,2172.591185,4,1,0,3,54,1996,Lorna Woodroffe
201468,2172.583427,28,13,0,15,4,2015,Yaroslava Shvedova
201613,2172.583119,2,0,0,2,35,2015,Arina Rodionova
202043,2172.582687,2,0,0,2,1,1994,Mimma Chernovita
203244,2172.581672,4,1,0,3,31,2005,Estefania Craciun
202291,2172.575804,2,0,0,2,8,2004,Seiko Okamoto
206579,2172.574409,2,0,0,2,31,2005,Sarah Tami Masi
206620,2172.5726,2,0,0,2,38,1994,Diana Mills
201484,2172.568959,2,0,0,2,15,2013,Sandra Zahlavova
201598,2172.563359,4,1,0,3,18,2010,Noppawan Lertcheewakarn
211296,2172.556345,2,0,0,2,38,2013,Dea Herdzelas
201760,2172.547735,2,0,0,2,27,1992,Heidi Sprung
212733,2172.545163,2,0,0,2,26,1991,Su Peng Ng
203217,2172.543927,2,0,0,2,39,1996,Karoline Borgersen
201276,2172.537368,2,0,0,2,18,1993,Nicole London
212729,2172.537034,2,0,0,2,46,2000,Maral Khachik Awanes
212239,2172.53668,2,0,0,2,26,2007,Shukufa Abdullayeva
212552,2172.536003,4,1,0,3,26,1995,Amy Berthe
212546,2172.536002,2,0,0,2,47,1993,Jennifer Carter
201341,2172.534478,2,0,0,2,49,2003,Mi Ra Jeon
202419,2172.53438,2,0,0,2,42,2014,Barbara Luz
200579,2172.532607,24,9,0,15,9,1994,Karin Kschwendt
206871,2172.530135,2,0,0,2,35,2004,Maria Rasmussen
203433,2172.528889,2,0,0,2,37,2013,Rishika Sunkara
201191,2172.527848,3,0,0,3,29,1993,Shirli Ann Siddall
202337,2172.524055,2,0,0,2,16,2004,Klaudia Jans Ignacik
201858,2172.519436,2,0,0,2,17,1997,Kristina Triska
207429,2172.516482,2,0,0,2,30,1999,Ana Buraku
202071,2172.516355,2,0,0,2,42,1998,Dragana Zaric
212575,2172.516332,2,0,0,2,26,1995,Nicoletta Pericleous
212255,2172.516332,2,0,0,2,45,2014,Ghazaleh Torkaman
201659,2172.515371,2,0,0,2,17,2011,Melanie Klaffner
207956,2172.515087,4,1,0,3,30,2006,Yanet Nunez Mojarena
201323,2172.509306,2,0,0,2,0,1996,Saori Obata
203552,2172.505809,4,1,0,3,5,2013,Risa Ozaki
203431,2172.496928,2,0,0,2,45,2010,Keren Shlomo
212232,2172.496773,2,0,0,2,31,2007,Carlista Mohammed
212308,2172.496123,2,0,0,2,27,2012,Karla Portalatin
200577,2172.496078,2,0,0,2,60,1992,Louise Stacey
212391,2172.496049,2,0,0,2,47,1994,Paula Alvarez
201348,2172.496049,2,0,0,2,50,2004,Casey Dellacqua
204898,2172.496049,2,0,0,2,32,2004,Noha Mohsen
212203,2172.496049,2,0,0,2,27,2005,Rym Cherni
212208,2172.496049,2,0,0,2,26,2005,Rebekka Petursdottir
212229,2172.496049,4,1,0,3,25,2008,Raye Ann Sandy
214606,2172.496049,2,0,0,2,31,2014,Margot Mercier
204411,2172.496049,2,0,0,2,38,2015,Storm Sanders
212254,2172.496014,2,0,0,2,40,2009,Shadi Tabatabai
212156,2172.49529,2,0,0,2,36,2000,Yimara Figueroa
207702,2172.487669,2,0,0,2,40,1994,Stela Penciu
202417,2172.484597,2,0,0,2,38,2012,Tetiana Luzhanska
210624,2172.480668,2,0,0,2,29,2012,Kerstin Gressmann
201675,2172.476496,2,0,0,2,42,2012,So Jung Kim
200023,2172.475706,4,1,0,3,54,1996,Bryanne Stewart
200662,2172.475706,4,1,0,3,54,1996,Joanne Limmer
200741,2172.475706,4,1,0,3,54,1996,Renee Reid
207165,2172.475706,2,0,0,2,52,1997,Siobhan Munro
202082,2172.475706,2,0,0,2,45,1998,Niki Ninaus
204500,2172.475706,2,0,0,2,45,1998,Christine Silaghi
202574,2172.475706,4,1,0,3,59,2000,Remi Tezuka
203105,2172.475706,6,2,0,4,59,2000,I Ting Wang
204492,2172.475706,4,1,0,3,52,2001,Debby Haak
207152,2172.475706,2,0,0,2,52,2001,Bree Calderwood
201302,2172.475706,2,0,0,2,50,2004,Clarisa Fernandez
202501,2172.475706,2,0,0,2,50,2011,Hyun Hui Hong
212445,2172.474216,2,0,0,2,42,1998,Claudia Brause
212674,2172.468925,4,1,0,3,46,1993,Natasha Villarroel
202477,2172.467036,16,6,0,10,15,2014,Dinah Pfizenmaier
202273,2172.461682,4,1,0,3,30,2004,Liga Dekmeijere
202352,2172.458453,6,2,0,4,45,2003,Daniela Munoz Gallegos
202353,2172.458453,2,0,0,2,45,2003,Maria Jose Argeri
200019,2172.456624,2,0,0,2,10,1991,Alexandra Fusai
212803,2172.455706,2,0,0,2,25,1991,Anita Aggarwal
212160,2172.454697,2,0,0,2,35,2003,Karla Golfin
204520,2172.452681,2,0,0,2,40,1998,Ariana Rojas
201306,2172.436184,2,0,0,2,26,2010,Marie Gaiane Mikaelian
212781,2172.433118,2,0,0,2,35,1993,Kata Gyorke
212414,2172.3815,4,1,0,3,36,1995,Oksana Bushevitsa
200068,2172.377419,2,0,0,2,20,2003,Lilia Osterloh
201591,2172.375244,2,0,0,2,37,2002,Margalita Chakhnashvili
201668,2172.371055,10,4,0,6,3,2014,Alexandra Panova
201674,2172.370682,2,0,0,2,6,2015,Sabina Sharipova
201608,2172.359551,2,0,0,2,5,2006,Sheng Nan Sun
200333,2172.332841,2,0,0,2,30,1991,Betsy Nagelsen
202359,2172.325447,2,0,0,2,0,2012,Chin Wei Chan
201385,2172.320545,2,0,0,2,7,2010,Yuliana Fedak
201868,2172.317842,2,0,0,2,4,1999,Renata Kucerova
200765,2172.290839,4,1,0,3,15,2002,Katalin Marosi
208261,2172.281459,2,0,0,2,27,2008,Richele Le Saldo
201574,2172.262209,2,0,0,2,39,2002,Neuza Silva
206242,2172.21256,2,0,0,2,39,2014,Beatriz Haddad Maia
201726,2172.208419,4,1,0,3,18,1993,Rachel Ann Jensen
200023,2172.207581,2,0,0,2,19,2001,Bryanne Stewart
212487,2172.202554,2,0,0,2,41,1994,Linda Beate Andersen
201729,2172.202157,4,1,0,3,46,2000,Larissa Schaerer
200722,2172.198251,2,0,0,2,24,1999,Francesca Lubiani
200024,2172.195624,35,14,0,21,1,1998,Maria Vento Kabchi
200464,2172.184682,21,8,0,13,2,1991,Ann Henricksson
201298,2172.167769,2,0,0,2,40,2003,Zsofia Gubacsi
201854,2172.166193,2,0,0,2,6,1999,Mariana Mesa
201640,2172.165202,2,0,0,2,36,2011,Maria Teresa Torro Flor
200444,2172.149099,2,0,0,2,18,1993,Elise Burgin
201753,2172.148915,11,4,0,7,52,1997,Rewa Harriman
201417,2172.144443,2,0,0,2,20,2013,Marta Domachowska
200747,2172.136128,2,0,0,2,11,2001,Haruka Inoue
212237,2172.131786,2,0,0,2,32,2007,Katherine Hoepelman
200045,2172.127184,31,11,0,20,2,1999,Tara Snyder
201923,2172.12229,2,0,0,2,14,1994,Alix Creek
212153,2172.114582,2,0,0,2,38,2002,Karmelina Rivera
201183,2172.111803,2,0,0,2,19,1990,Anne Meredith
200751,2172.10155,6,2,0,4,16,2007,Conchita Martinez Granados
201723,2172.099808,2,0,0,2,57,1994,Angela Kerek
206105,2172.093697,2,0,0,2,37,2013,Rutuja Bhosale
200108,2172.091511,2,0,0,2,4,1998,Elena Dementieva
200642,2172.090822,10,4,0,6,2,1991,Denisa Szabova
201404,2172.085578,4,1,0,3,10,2006,Jessica Kirkland
200649,2172.081147,2,0,0,2,44,1996,Ginger Helgeson Nielsen
201502,2172.07729,16,6,0,10,3,2009,Tatjana Malek
212223,2172.076231,2,0,0,2,26,2006,Tshidiso Mosinyi
200440,2172.075784,2,0,0,2,0,1990,Shawn Foltz
200497,2172.073493,37,15,0,22,4,1997,Patricia Hy Boulais
212110,2172.073086,4,1,0,3,36,2000,Niki Williams
212567,2172.072507,2,0,0,2,52,2000,Stella Kristjansdottir
207695,2172.072408,2,0,0,2,35,1993,Issem Essaies
201668,2172.070158,8,3,0,5,4,2010,Alexandra Panova
201370,2172.066151,25,10,0,15,1,2006,Anastasia Rodionova
201386,2172.062971,17,7,0,10,21,2007,Jie Zheng
202324,2172.060671,2,0,0,2,7,2005,Neha Uberoi
210130,2172.053787,2,0,0,2,46,2011,Maria Paula Deheza
202431,2172.047317,2,0,0,2,15,2011,Tetyana Arefyeva
200080,2172.03501,28,11,0,17,0,1994,Dominique Monami
212155,2172.033006,2,0,0,2,28,1997,Danielle Paynter
203244,2172.032333,4,1,0,3,30,2006,Estefania Craciun
201060,2172.032229,2,0,0,2,32,1993,Carole Lucarelli
205918,2172.029581,2,0,0,2,27,2012,Ulrikke Eikeri
201689,2172.016465,2,0,0,2,39,2008,Magali De Lattre
201193,2172.016073,2,0,0,2,25,1992,Claire Wegink
205700,2172.014046,4,1,0,3,25,2010,Emma Flood
212154,2172.013416,2,0,0,2,35,2004,Maria Calbeto
212109,2172.012916,2,0,0,2,29,2001,Francine Harvey
212419,2172.001606,2,0,0,2,41,1993,Maya Hajjar
200009,2172.000508,4,1,0,3,40,1993,Tamarine Tanasugarn
210303,2172.000135,2,0,0,2,26,2010,Kathinka Von Deichmann
208207,2171.994056,2,0,0,2,30,2003,Ina Sartz
204815,2171.9935,2,0,0,2,33,1997,Yi Ching Wu
200416,2171.991726,4,1,0,3,14,1994,Robin White
201605,2171.991093,32,13,0,19,2,2013,Mandy Minella
201385,2171.984232,25,10,0,15,5,2007,Yuliana Fedak
207560,2171.973243,4,1,0,3,56,2002,Prariyawan Ratanakrong
201384,2171.964493,2,0,0,2,7,2006,Chia Jung Chuang
201366,2171.963109,8,3,0,5,18,2007,Barbora Zahlavova Strycova
202270,2171.962193,2,0,0,2,32,2000,Habiba Ifrakh
200543,2171.960571,2,0,0,2,18,1993,Jill Hetherington
202349,2171.956305,2,0,0,2,39,2009,Rushmi Chakravarthi
204474,2171.953024,4,1,0,3,52,1997,Susan Cowan
201387,2171.945751,36,17,0,19,1,2008,Sofia Arvidsson
201844,2171.942902,2,0,0,2,28,1991,Agnese Gustmane
201460,2171.938097,13,5,0,8,5,2007,Meng Yuan
206622,2171.934991,4,1,0,3,52,1997,Tracee Lee
201456,2171.934601,10,4,0,6,2,2005,Olga Savchuk
200768,2171.928369,5,1,0,4,25,1999,Laurence Andretto
200774,2171.920387,4,1,0,3,22,2003,Vanessa Webb
204051,2171.912502,2,0,0,2,8,1996,Chie Nagano
204059,2171.912502,6,2,0,4,8,1996,Futaba Kubota
204717,2171.912502,6,2,0,4,8,1996,Lana Scardigno
200719,2171.911631,4,1,0,3,21,1995,Siobhan Drake Brockman
201965,2171.910289,4,1,0,3,0,1991,Sabrina Giusto
212356,2171.906833,2,0,0,2,41,1994,Mette Sigmundstad
200646,2171.906095,4,1,0,3,16,1992,Francesca Romano
202335,2171.895579,2,0,0,2,6,2004,Antonia Matic
200743,2171.881896,2,0,0,2,50,1997,Nirupama Sanjeev
200014,2171.880909,11,4,0,7,3,2004,Tzipi Obziler
201615,2171.875698,4,1,0,3,7,2010,Lesia Tsurenko
201412,2171.859147,7,2,0,5,15,2010,Anastasia Yakimova
200464,2171.854113,11,4,0,7,14,1994,Ann Henricksson
204969,2171.836849,2,0,0,2,37,1993,Edita Liachoviciute
201919,2171.832987,2,0,0,2,4,1996,Christina Popescu
200118,2171.827947,29,12,0,17,4,2004,Virginia Ruano Pascual
201185,2171.825005,4,1,0,3,15,1990,Robyn Field
205143,2171.81704,2,0,0,2,48,2000,Valentina Castro
201435,2171.808164,2,0,0,2,6,2004,Kateryna Bondarenko
201869,2171.780491,2,0,0,2,33,1996,Radka Pelikanova
200772,2171.750161,2,0,0,2,21,2007,Anastasia Myskina
201619,2171.747409,5,1,0,4,12,2012,Madison Keys
200622,2171.73573,24,11,0,13,9,1990,Maya Kidowaki
210271,2171.728968,4,1,0,3,41,2012,Anita Husaric
200712,2171.719062,8,3,0,5,11,1995,Katerina Kroupova
201060,2171.714641,2,0,0,2,27,1994,Carole Lucarelli
201021,2171.714615,4,1,0,3,14,1996,Laura Garrone
203004,2171.696503,2,0,0,2,18,1997,Wukirasih Sawondari
201401,2171.692515,4,1,0,3,12,2001,Abigail Spears
201209,2171.689284,2,0,0,2,29,2010,Selima Sfar
200647,2171.686448,2,0,0,2,5,1996,Noelle Van Lottum
200752,2171.680405,16,7,0,9,0,1998,Raluca Sandu
201717,2171.678658,2,0,0,2,51,1992,Michelle Jackson Nobrega
200616,2171.668392,13,5,0,8,6,1990,Pascale Etchemendy
202017,2171.65248,2,0,0,2,45,1995,Stephanie Halsell
204124,2171.649697,6,2,0,4,52,1997,Jennifer Callen
204397,2171.637271,2,0,0,2,7,2013,Arina Folts
202015,2171.633563,2,0,0,2,33,1990,Nicoletta Iaccarino
201740,2171.632628,2,0,0,2,30,1992,Christiane Hofmann
201370,2171.617746,14,5,0,9,4,2009,Anastasia Rodionova
207699,2171.606351,2,0,0,2,37,2002,Merve Asimgil
200059,2171.598529,2,0,0,2,40,2003,Ruxandra Dragomir Ilie
201410,2171.586585,2,0,0,2,0,2012,Monique Adamczak
201378,2171.585305,2,0,0,2,28,2004,Stephanie Gehrlein
201082,2171.576885,2,0,0,2,19,1998,Lorna Woodroffe
213530,2171.539237,2,0,0,2,12,2013,Allie Kiick
201089,2171.501981,4,1,0,3,54,1996,Lucie Ahl
200707,2171.490628,2,0,0,2,30,2006,Romana Tedjakusuma
203147,2171.488079,2,0,0,2,38,2004,Wei Juan Liu
201204,2171.480886,4,1,0,3,0,1999,Iroda Tulyaganova
201383,2171.480547,2,0,0,2,8,2011,Marie Eve Pelletier
202292,2171.473756,6,2,0,4,10,1997,Ayami Takase
204177,2171.473756,6,2,0,4,10,1997,Akiko Kinebuchi
203323,2171.470265,4,1,0,3,26,2006,Anna Koumantou
201718,2171.467832,2,0,0,2,15,1991,Akiko Gooden
203051,2171.466185,6,2,0,4,10,1997,Satomi Kinjo
203462,2171.460373,4,1,0,3,7,2013,Kateryna Kozlova
200360,2171.43828,18,7,0,11,2,1995,Pam Shriver
200011,2171.436166,7,2,0,5,3,2009,Katarina Srebotnik
204173,2171.422374,2,0,0,2,9,1999,Yuki Fujii
200072,2171.418984,44,19,0,25,7,2001,Cara Black
200068,2171.401811,19,7,0,12,1,2007,Lilia Osterloh
201626,2171.386697,2,0,0,2,0,1994,Petra Winzenholler
212144,2171.38445,4,1,0,3,46,2000,Alissa Velts
200543,2171.370994,4,1,0,3,1,1992,Jill Hetherington
201404,2171.356195,8,3,0,5,10,2005,Jessica Kirkland
201551,2171.353013,25,10,0,15,4,2012,Arantxa Rus
201723,2171.345421,6,2,0,4,28,1991,Angela Kerek
200658,2171.333051,8,3,0,5,44,1996,Fang Li
201315,2171.325817,2,0,0,2,14,2001,Ashley Harkleroad
200118,2171.318827,5,1,0,4,7,1992,Virginia Ruano Pascual
201630,2171.316072,2,0,0,2,54,1992,Nicole Hummel
201361,2171.250443,2,0,0,2,14,2010,Julia Schruff
201674,2171.24359,2,0,0,2,7,2010,Sabina Sharipova
201503,2171.237702,18,6,0,12,5,2008,Ayumi Morita
200705,2171.213957,22,9,0,13,9,1991,Linda Ferrando
201469,2171.213425,2,0,0,2,18,2010,Melanie South
201498,2171.205306,3,0,0,3,3,2011,Karin Knapp
202497,2171.201889,9,3,0,6,17,2014,Victoria Duval
201470,2171.180701,2,0,0,2,15,2013,Kristina Barrois
201301,2171.169867,11,4,0,7,3,2004,Camille Pin
200078,2171.158896,2,0,0,2,17,2006,Barbara Schwartz
203435,2171.153386,4,1,0,3,36,2014,Dalila Jakupovic
201304,2171.150072,22,9,0,13,14,2012,Elena Baltacha
201379,2171.132975,2,0,0,2,12,2003,Mara Santangelo
201352,2171.122419,41,17,0,24,7,2004,Akiko Morigami
200552,2171.103574,2,0,0,2,21,1990,Maria Lindstrom
201302,2171.084204,5,1,0,4,10,2006,Clarisa Fernandez
204419,2171.082963,2,0,0,2,33,2015,Ana Sofia Sanchez
201299,2171.068228,2,0,0,2,23,2003,Celine Beigbeder
201387,2171.066947,36,17,0,19,3,2010,Sofia Arvidsson
200127,2171.056333,7,2,0,5,2,1994,Sarah Pitkowski Malcor
201577,2171.053128,2,0,0,2,9,2012,Heidi El Tabakh
201512,2171.052086,38,15,0,23,4,2012,Monica Niculescu
200736,2171.041876,3,0,0,3,15,1992,Li Ling Chen
201560,2171.036924,2,0,0,2,21,2009,Kinnie Laisne
203475,2171.021531,2,0,0,2,12,2015,Carol Zhao
202357,2170.99092,4,1,0,3,17,2011,Madalina Gojnea
200044,2170.96783,40,17,0,23,2,2001,Denisa Chladkova
201360,2170.952596,7,2,0,5,5,2001,Julia Vakulenko
201482,2170.951398,4,1,0,3,15,2010,Andreja Klepac
201325,2170.934845,44,21,0,23,1,2005,Samantha Stosur
201057,2170.921549,2,0,0,2,27,1994,Angelique Olivier
212763,2170.916927,2,0,0,2,35,1993,Vita Kaminskiate
201339,2170.90685,2,0,0,2,22,2015,Renata Voracova
201938,2170.869393,2,0,0,2,43,2000,Ainhoa Goni Blanco
201360,2170.843601,12,4,0,8,3,2003,Julia Vakulenko
200698,2170.825504,4,1,0,3,20,1999,Petra Begerow
200084,2170.794679,28,12,0,16,4,2000,Asa Svensson
202259,2170.791805,2,0,0,2,21,2002,Valentina Sassi
201604,2170.775061,21,8,0,13,4,2011,Irina Falconi
201641,2170.773174,6,2,0,4,26,2012,Nadia Lalami
202055,2170.771437,2,0,0,2,27,1990,Themis Zambrzycki
201624,2170.763343,2,0,0,2,5,2001,Eun Ha Kim
202325,2170.751158,4,1,0,3,34,2008,Isha Lakhani
201573,2170.744408,2,0,0,2,9,2015,Laura Robson
203500,2170.713465,7,2,0,5,4,2014,Sachia Vickery
201821,2170.69791,2,0,0,2,35,1992,Gorana Matic
200057,2170.694762,4,1,0,3,8,1997,Erika De Lone
200074,2170.670119,4,1,0,3,22,1997,Jane Chi
200555,2170.665389,2,0,0,2,0,1991,Valda Lake
200660,2170.624822,2,0,0,2,26,2000,Kimberly Po Messerli
200540,2170.613631,2,0,0,2,0,1991,Amy Schwartz
201383,2170.612088,12,5,0,7,3,2004,Marie Eve Pelletier
200093,2170.591921,18,7,0,11,10,1998,Amelie Cocheteux
201334,2170.584512,7,2,0,5,15,2002,Zuzana Ondraskova
200608,2170.583818,31,13,0,18,2,1990,Audra Keller
200568,2170.546632,4,1,0,3,13,1990,Andrea Farley
201847,2170.531285,2,0,0,2,26,1994,Mareze Joubert
202126,2170.513777,10,4,0,6,0,1997,Marissa Niroj
200746,2170.500143,5,1,0,4,5,1996,Sandra Kloesel
200766,2170.487424,2,0,0,2,40,2003,Jennifer Hopkins
204536,2170.46966,2,0,0,2,25,1993,Barbara Castro
201387,2170.463887,21,9,0,12,1,2007,Sofia Arvidsson
201203,2170.451714,2,0,0,2,11,1995,Alena Nesticka
200723,2170.423015,4,1,0,3,41,2004,Iva Majoli
200072,2170.396976,39,17,0,22,1,1999,Cara Black
201562,2170.394342,42,18,0,24,3,2014,Silvia Soler Espinosa
200028,2170.390558,27,12,0,15,2,1999,Maureen Drake
200010,2170.388034,2,0,0,2,36,1991,Rita Grande
202508,2170.364278,2,0,0,2,5,2013,Yuxuan Zhang
200056,2170.353973,35,16,0,19,7,2002,Jelena Kostanic Tosic
203125,2170.340717,10,4,0,6,45,1998,Rochelle Rosenfield
200674,2170.284696,15,6,0,9,11,1995,Bettina Fulco Villella
205925,2170.284248,2,0,0,2,27,2012,Aliaksandra Sasnovich
201408,2170.284107,7,2,0,5,10,2008,Jamea Jackson
200686,2170.272805,17,7,0,10,4,1994,Sandra Dopfer
202490,2170.269054,9,3,0,6,7,2015,Rebecca Peterson
201051,2170.250612,21,9,0,12,10,1990,Laura Lapi
204677,2170.202972,2,0,0,2,38,1999,Minna Rautajoki
200624,2170.200147,32,13,0,19,1,1993,Tami Whitlinger Jones
200659,2170.18989,11,4,0,7,6,1995,Rika Hiraki
200667,2170.132465,24,10,0,14,11,1997,Ines Gorrochategui
201308,2170.121351,5,1,0,4,17,2011,Maria Elena Camerin
200565,2170.120987,7,2,0,5,24,1992,Nathalie Guerree Spitzer
200587,2170.109046,24,10,0,14,1,1995,Silke Meier
202231,2170.05381,2,0,0,2,23,2005,Shiho Hisamatsu
201464,2170.047446,2,0,0,2,22,2001,Nathalie Vierin
201480,2170.047016,2,0,0,2,2,2005,Lioudmila Skavronskaia
200041,2170.006359,25,10,0,15,10,2006,Amy Frazier
212055,2170.004191,4,1,0,3,33,1997,Juliet Drew
200668,2169.992541,21,9,0,12,3,1994,Silke Frankl
202339,2169.978425,4,1,0,3,9,2008,Ayu Fani Damayanti
201051,2169.964929,2,0,0,2,23,1994,Laura Lapi
200702,2169.961712,27,10,0,17,9,1997,Naoko Kijimuta
201195,2169.94829,2,0,0,2,9,1994,Amanda Wainwright
204173,2169.947512,6,2,0,4,10,1997,Yuki Fujii
201085,2169.94037,14,5,0,9,1,2002,Shinobu Asagoe
200497,2169.921482,30,11,0,19,2,1996,Patricia Hy Boulais
201527,2169.914603,13,5,0,8,10,2012,Stefanie Voegele
201542,2169.897548,5,1,0,4,9,2009,Olivia Rogowska
200044,2169.85901,29,11,0,18,0,1997,Denisa Chladkova
201203,2169.822433,4,1,0,3,21,2002,Alena Nesticka
201435,2169.814137,16,6,0,10,1,2006,Kateryna Bondarenko
200121,2169.806473,5,1,0,4,1,2006,Alina Jidkova
200722,2169.753836,7,2,0,5,14,1995,Francesca Lubiani
200668,2169.745631,18,7,0,11,10,1991,Silke Frankl
202444,2169.738945,2,0,0,2,8,2011,Kamilla Farhad
200031,2169.728434,6,2,0,4,3,2004,Meilen Tu
200712,2169.727471,16,6,0,10,3,1993,Katerina Kroupova
201180,2169.722398,2,0,0,2,30,1991,Belinda Borneo
201718,2169.685778,6,2,0,4,0,1990,Akiko Gooden
200726,2169.678059,6,2,0,4,19,1997,Nancy Feber
201439,2169.676275,2,0,0,2,12,2001,Tiffany Dabek
200082,2169.676268,35,17,0,18,3,1994,Kristie Boogert
201278,2169.669188,4,1,0,3,10,1994,Angela Lettiere
201515,2169.668541,2,0,0,2,15,2006,Alisa Kleybanova
200462,2169.658446,25,11,0,14,13,1990,Belinda Cordwell
200057,2169.630716,10,4,0,6,2,1990,Erika De Lone
201523,2169.606556,40,19,0,21,10,2012,Marina Erakovic
200754,2169.591726,35,13,0,22,4,2009,Jill Craybas
200725,2169.579465,11,4,0,7,15,1997,Sandra Cecchini
200595,2169.577996,24,10,0,14,9,1996,Ann Wunderlich
201356,2169.575773,15,6,0,9,7,2006,Eva Birnerova
200026,2169.562952,35,14,0,21,10,1998,Florencia Labat
200646,2169.524211,8,3,0,5,29,1993,Francesca Romano
200005,2169.508397,22,8,0,14,3,1996,Jolene Watanabe Giltz
200428,2169.493559,22,8,0,14,1,1996,Lori Mcneil
200028,2169.484059,4,1,0,3,0,1991,Maureen Drake
200587,2169.458284,14,5,0,9,2,1994,Silke Meier
200611,2169.435448,5,1,0,4,16,1993,Tracey Morton Rodgers
201615,2169.43184,12,4,0,8,3,2014,Lesia Tsurenko
201702,2169.397126,2,0,0,2,13,2010,Malou Ejdesgaard
202345,2169.396972,2,0,0,2,15,2005,Katarina Kachlikova
201313,2169.370199,10,3,0,7,5,2001,Yoon Jeong Cho
202489,2169.34047,2,0,0,2,14,2013,Carina Witthoeft
201481,2169.318271,14,5,0,9,18,2009,Tamira Paszek
201358,2169.269924,3,0,0,3,21,2004,Natalia Gussoni
202331,2169.245351,12,5,0,7,1,2005,Vilmarie Castellvi
202422,2169.245028,2,0,0,2,4,2011,Shuko Aoyama
201501,2169.242447,20,8,0,12,3,2015,Olga Govortsova
200579,2169.232504,13,5,0,8,8,1990,Karin Kschwendt
201595,2169.230668,3,0,0,3,4,2010,Misaki Doi
200395,2169.214568,2,0,0,2,5,1993,Catherine Tanvier
201587,2169.083415,48,20,0,28,5,2014,Bojana Jovanovski
201339,2169.082675,7,2,0,5,7,2003,Renata Voracova
200734,2169.061541,18,7,0,11,11,1996,Tatjana Jecmenica
200098,2169.048504,5,1,0,4,39,2006,Henrieta Nagyova
200609,2169.037637,3,0,0,3,7,1990,Steffi Menning
200691,2169.023301,24,9,0,15,11,1997,Flora Perfetti
200476,2168.996313,11,4,0,7,32,1991,Cammy Macgregor
200661,2168.973016,8,2,0,6,6,1996,Samantha Smith
200589,2168.93606,31,14,0,17,2,1991,Halle Cioffi
200717,2168.927623,10,3,0,7,2,1995,Anne Miller
200094,2168.924488,22,8,0,14,5,2003,Barbara Rittner
201745,2168.815701,4,1,0,3,17,1993,Lupita Novelo
200119,2168.811148,38,17,0,21,8,2001,Rita Kuti Kis
203500,2168.792282,12,5,0,7,8,2015,Sachia Vickery
201843,2168.791952,5,1,0,4,19,1991,Suzanna Anggarkusuma
200014,2168.791215,7,2,0,5,26,2000,Tzipi Obziler
200026,2168.781312,9,3,0,6,6,1999,Florencia Labat
200094,2168.771358,38,17,0,21,2,2001,Barbara Rittner
201435,2168.7588,2,0,0,2,8,2014,Kateryna Bondarenko
202487,2168.694747,2,0,0,2,10,2012,Nastassja Burnett
200503,2168.693541,25,10,0,15,3,1991,Gretchen Magers
201313,2168.668475,9,3,0,6,7,2004,Yoon Jeong Cho
200091,2168.667981,11,4,0,7,12,1995,Janet Lee
200032,2168.646305,20,8,0,12,12,1995,Barbara Schett
201368,2168.635752,20,8,0,12,9,2010,Karolina Sprem
201451,2168.583537,3,0,0,3,17,2006,Kathrin Woerle
202500,2168.578206,9,3,0,6,7,2013,Maria Sanchez
201286,2168.540985,7,2,0,5,4,2000,Anabel Medina Garrigues
200584,2168.507529,26,10,0,16,3,1998,Laura Golarsa
201523,2168.495718,37,20,0,17,2,2008,Marina Erakovic
201535,2168.479101,3,0,0,3,10,2008,Coco Vandeweghe
200724,2168.468476,5,1,0,4,26,1993,Lea Ghirardi
201078,2168.443795,7,2,0,5,22,1999,Eugenia Kulikovskaya
200602,2168.430229,33,13,0,20,2,1995,Shaun Stafford
200027,2168.38084,29,11,0,18,11,2004,Magui Serna
201079,2168.295813,2,0,0,2,23,2001,Hannah Collin
201269,2168.291831,4,1,0,3,12,1993,Eleni Rossides
201293,2168.262887,19,8,0,11,2,2008,Catalina Castano
201444,2168.098066,3,0,0,3,4,2005,Su Wei Hsieh
201822,2168.09645,6,2,0,4,7,1992,Petra Holubova
201668,2168.059078,3,0,0,3,9,2011,Alexandra Panova
200464,2168.014969,14,5,0,9,1,1993,Ann Henricksson
201466,2168.004059,41,20,0,21,5,2009,Kaia Kanepi
200715,2167.964779,7,2,0,5,4,1997,Mariaan De Swardt
201284,2167.963106,9,3,0,6,5,2008,Tatiana Poutchek
202272,2167.926265,3,0,0,3,17,2007,Ana Timotic
200354,2167.902458,25,11,0,14,6,1992,Claudia Kohde Kilsch
200622,2167.89822,7,2,0,5,7,1993,Maya Kidowaki
201387,2167.896765,5,1,0,4,20,2002,Sofia Arvidsson
201325,2167.892306,7,2,0,5,18,2003,Samantha Stosur
200124,2167.890485,11,4,0,7,3,2011,Anne Kremer
201668,2167.883943,29,12,0,17,8,2012,Alexandra Panova
200011,2167.843669,36,14,0,22,7,2004,Katarina Srebotnik
200724,2167.829334,4,1,0,3,17,1997,Lea Ghirardi
200715,2167.810212,22,8,0,14,11,1996,Mariaan De Swardt
200009,2167.803496,21,8,0,13,0,1999,Tamarine Tanasugarn
201577,2167.747504,3,0,0,3,8,2010,Heidi El Tabakh
201412,2167.735017,6,2,0,4,6,2004,Anastasia Yakimova
201475,2167.698482,5,1,0,4,10,2006,Ahsha Rolle
201348,2167.682281,8,3,0,5,9,2011,Casey Dellacqua
200442,2167.658269,14,5,0,9,15,1996,Andrea Temesvari
200624,2167.652031,30,13,0,17,1,1992,Tami Whitlinger Jones
201304,2167.645547,7,2,0,5,16,2013,Elena Baltacha
200582,2167.632647,7,2,0,5,21,1996,Maria Strandlund Tomsvik
204536,2167.632473,7,2,0,5,17,1996,Barbara Castro
201452,2167.614854,39,17,0,22,4,2007,Lourdes Dominguez Lino
200740,2167.603374,5,1,0,4,22,2002,Elena Tatarkova
200724,2167.593274,15,6,0,9,10,1998,Lea Ghirardi
202376,2167.581362,2,0,0,2,6,2007,Raquel Kops Jones
200096,2167.578544,14,6,0,8,27,2001,Mary Pierce
201363,2167.564584,7,2,0,5,35,2012,Gisela Dulko
201047,2167.54034,11,4,0,7,3,1993,Andrea Vieira
200722,2167.53632,30,13,0,17,4,1997,Francesca Lubiani
201381,2167.525242,5,1,0,4,7,2008,Tian Tian Sun
200740,2167.501037,7,2,0,5,3,2003,Elena Tatarkova
200076,2167.49396,18,7,0,11,22,2000,Laurence Courtois
201423,2167.480151,7,2,0,5,2,2005,Yvonne Meusburger
200059,2167.469539,45,20,0,25,6,2000,Ruxandra Dragomir Ilie
200569,2167.457745,19,8,0,11,11,1995,Petra Pichalova Langrova
200117,2167.430553,23,10,0,13,3,1998,Kveta Peschke
200700,2167.415865,15,5,0,10,16,1992,Silvia Farina Elia
201586,2167.409073,30,13,0,17,4,2014,Heather Watson
200774,2167.401806,7,2,0,5,7,2002,Vanessa Webb
200417,2167.333211,19,7,0,12,1,1996,Gigi Fernandez
201616,2167.306082,31,13,0,18,3,2013,Lauren Davis
201554,2167.298838,7,2,0,5,7,2009,Vitalia Diatchenko
200729,2167.272575,9,3,0,6,11,1997,Lindsay Lee Waters
200100,2167.263558,10,3,0,7,14,2001,Amanda Hopmans
200658,2167.24703,2,0,0,2,4,2000,Fang Li
200496,2167.241648,28,12,0,16,13,1990,Terry Phelps
201363,2167.231447,12,5,0,7,4,2003,Gisela Dulko
200481,2167.217279,25,10,0,15,12,1995,Elna Reinach
200115,2167.138687,19,8,0,11,10,1999,Brie Rippner
200498,2167.129771,9,3,0,6,32,1991,Michelle Jaggard Lai
200697,2167.093423,3,0,0,3,6,1999,Janette Husarova
200062,2167.092294,14,5,0,9,11,1997,Kristina Brandi
201339,2167.090252,12,4,0,8,1,2007,Renata Voracova
200082,2167.086922,11,4,0,7,20,2002,Kristie Boogert
200088,2167.007138,28,12,0,16,4,2000,Adriana Gersi
200118,2166.984902,16,6,0,10,3,1993,Virginia Ruano Pascual
200770,2166.944026,5,1,0,4,21,2010,Stephanie Cohen Aloro
200764,2166.911245,5,1,0,4,8,2011,Elena Bovina
201453,2166.898811,21,8,0,13,5,2006,Hana Sromova
201321,2166.897894,22,9,0,13,4,2004,Antonella Serra Zanetti
201541,2166.850266,7,2,0,5,30,2015,Chanelle Scheepers
200620,2166.832321,5,1,0,4,7,1993,Kirrily Sharpe
201373,2166.770025,3,0,0,3,1,2002,Maria Kirilenko
200742,2166.765197,7,2,0,5,1,1995,Olga Lugina
201453,2166.755325,9,3,0,6,1,2005,Hana Sromova
200745,2166.68137,5,1,0,4,23,2002,Andrea Glass
200681,2166.680969,26,11,0,15,6,1993,Natalia Baudone Furlan
200576,2166.60579,33,12,0,21,9,1991,Nathalie Herreman
201486,2166.601733,35,16,0,19,9,2010,Aleksandra Wozniak
201423,2166.59523,7,2,0,5,4,2009,Yvonne Meusburger
200419,2166.576978,25,10,0,15,1,1992,Kathy Rinaldi Stunkel
200678,2166.572483,3,0,0,3,14,2001,Gloria Pizzichini
200048,2166.542797,3,0,0,3,32,2008,Elena Likhovtseva
201541,2166.539173,12,4,0,8,4,2009,Chanelle Scheepers
201465,2166.533855,3,0,0,3,1,2003,Kirsten Flipkens
200473,2166.52237,7,2,0,5,15,1991,Beverly Bowes Hackney
200076,2166.503808,30,13,0,17,0,1999,Laurence Courtois
200014,2166.49624,5,1,0,4,26,2009,Tzipi Obziler
201309,2166.480632,9,3,0,6,14,2001,Tatiana Perebiynis
200075,2166.414404,7,2,0,5,11,2001,Jing Qian Yi
201429,2166.392477,5,1,0,4,5,2008,Rika Fujiwara
200042,2166.385568,19,8,0,11,3,1995,Els Callens
201604,2166.359433,29,12,0,17,4,2015,Irina Falconi
201369,2166.358375,3,0,0,3,4,2004,Carly Gullickson
200732,2166.356209,9,3,0,6,3,1995,Magdalena Grzybowska
201429,2166.350173,9,3,0,6,7,2002,Rika Fujiwara
200765,2166.347166,7,2,0,5,25,2001,Katalin Marosi
201406,2166.336507,8,3,0,5,5,2006,Shikha Uberoi
201209,2166.335651,3,0,0,3,20,2003,Selima Sfar
201600,2166.322151,3,0,0,3,9,2010,Jamie Hampton
200121,2166.295726,3,0,0,3,14,2008,Alina Jidkova
200744,2166.281642,5,1,0,4,15,1998,Svetlana Krivencheva
200648,2166.198058,3,0,0,3,10,1990,Marketa Kochta
201498,2166.187771,9,3,0,6,17,2009,Karin Knapp
200126,2166.158676,11,4,0,7,7,2000,Marissa Gould
201398,2166.098539,3,0,0,3,19,2005,Amanda Keen
200009,2166.060842,11,4,0,7,1,1995,Tamarine Tanasugarn
201469,2166.005481,9,3,0,6,18,2009,Melanie South
200106,2165.996627,5,1,0,4,23,1997,Angeles Montolio
200643,2165.993357,12,4,0,8,16,1996,Petra Kamstra
200721,2165.985064,5,1,0,4,21,1995,Hiromi Nagano
201287,2165.956538,19,6,0,13,5,2012,Maria Jose Martinez Sanchez
202415,2165.928811,3,0,0,3,30,2013,Ximena Hermoso
201596,2165.928216,24,9,0,15,3,2014,Johanna Larsson
200293,2165.919191,5,1,0,4,22,2004,Martina Navratilova
201412,2165.872006,24,10,0,14,5,2006,Anastasia Yakimova
200567,2165.865406,15,5,0,10,17,1993,Jennifer Santrock
200025,2165.851183,27,11,0,16,8,2001,Ludmila Cervanova
201376,2165.76873,7,2,0,5,7,2009,Angela Haynes
200659,2165.760235,23,8,0,15,9,1992,Rika Hiraki
201354,2165.752966,5,1,0,4,16,2003,Libuse Prusova
201420,2165.667494,7,2,0,5,35,2004,Sania Mirza
200008,2165.659533,22,9,0,13,8,2010,Alicia Molik
204480,2165.638274,3,0,0,3,33,1997,Kym Hazzard
201846,2165.626366,3,0,0,3,5,1993,Katarzyna Teodorowicz Lisowska
201664,2165.604623,3,0,0,3,30,2014,Pemra Ozgen
200589,2165.591441,23,9,0,14,2,1990,Halle Cioffi
201428,2165.557874,3,0,0,3,21,2010,Mathilde Johansson
201414,2165.520359,5,1,0,4,7,2013,Michaella Krajicek
201579,2165.511284,3,0,0,3,7,2009,Yurika Sema
201402,2165.503444,5,1,0,4,17,2011,Sesil Karatantcheva
202257,2165.481166,5,1,0,4,22,1993,Carmina Giraldo
212573,2165.462341,5,1,0,4,52,2000,Pavlina Akritas
200005,2165.432857,5,1,0,4,22,1999,Jolene Watanabe Giltz
201388,2165.311071,3,0,0,3,4,2009,Sophie Ferguson
201478,2165.287014,18,6,0,12,8,2011,Varvara Lepchenko
200697,2165.272368,14,5,0,9,7,1998,Janette Husarova
200480,2165.255053,11,4,0,7,1,1995,Claudia Porwik
201640,2165.224069,31,13,0,18,3,2014,Maria Teresa Torro Flor
201334,2165.222623,3,0,0,3,8,2001,Zuzana Ondraskova
201444,2165.147127,18,6,0,12,4,2014,Su Wei Hsieh
202459,2165.144521,3,0,0,3,44,2013,Bojana Bobusic
200480,2165.142988,30,12,0,18,5,1992,Claudia Porwik
201693,2165.13794,33,12,0,21,4,2015,Timea Babos
201523,2165.136167,15,6,0,9,33,2009,Marina Erakovic
200610,2165.129238,7,2,0,5,29,1992,Stacey Martin
201177,2165.128923,3,0,0,3,29,1993,Amanda Grunfeld
200084,2165.128556,25,10,0,15,10,1998,Asa Svensson
201059,2165.124224,5,1,0,4,10,1995,Misumi Miyauchi
201678,2165.09781,5,1,0,4,39,2008,Sacha Jones
201315,2165.054587,24,9,0,15,1,2006,Ashley Harkleroad
200544,2165.036608,5,1,0,4,38,1991,Celine Cohen
201477,2165.016352,8,2,0,6,1,2007,Stephanie Dubois
200030,2165.0136,27,11,0,16,10,2000,Miroslava Vavrinec
200469,2164.989488,7,2,0,5,10,1994,Nicole Bradtke
201393,2164.98939,7,2,0,5,3,2004,Kelly Mccain
201392,2164.951463,14,5,0,9,11,2004,Severine Beltrame
201531,2164.949631,16,7,0,9,8,2013,Mariana Duque Marino
208261,2164.913614,7,2,0,5,31,1998,Richele Le Saldo
201428,2164.883833,7,2,0,5,5,2007,Mathilde Johansson
202324,2164.881382,7,2,0,5,12,2006,Neha Uberoi
201494,2164.873294,3,0,0,3,1,2006,Raluca Olaru
201288,2164.851336,5,1,0,4,22,2001,Maja Palaversic Cooper Smith
200514,2164.845629,3,0,0,3,24,1994,Monique Javer
200057,2164.808014,23,9,0,14,12,1991,Erika De Lone
200765,2164.807334,9,3,0,6,15,2003,Katalin Marosi
200578,2164.805324,9,3,0,6,14,1994,Rennae Stubbs
200045,2164.802899,5,1,0,4,13,2001,Tara Snyder
200024,2164.790046,11,4,0,7,21,1996,Maria Vento Kabchi
200700,2164.787566,19,8,0,11,13,1993,Silvia Farina Elia
201414,2164.787144,11,4,0,7,13,2009,Michaella Krajicek
201562,2164.779895,3,0,0,3,23,2009,Silvia Soler Espinosa
202443,2164.774904,9,3,0,6,17,2012,Valeria Savinykh
201193,2164.770201,11,4,0,7,7,1993,Claire Wegink
200058,2164.752831,5,1,0,4,32,1993,Anna Foldenyi Dicker
200010,2164.752297,38,16,0,22,10,2000,Rita Grande
201456,2164.741804,9,3,0,6,8,2009,Olga Savchuk
201567,2164.739556,16,6,0,10,5,2013,Alexandra Dulgheru
201377,2164.727432,7,2,0,5,21,2007,Yuliya Beygelzimer
200472,2164.701429,21,8,0,13,1,1992,Helen Kelesi
201546,2164.699298,8,2,0,6,4,2008,Anna Lapushchenkova
200083,2164.688649,10,3,0,7,3,1998,Alexandra Stevenson
202192,2164.656838,5,1,0,4,9,1998,Tzu Ting Weng
200773,2164.586029,8,2,0,6,4,2011,Stephanie Foretz Gacon
201396,2164.56653,3,0,0,3,18,2006,Katie Obrien
201274,2164.564668,5,1,0,4,11,1992,Viktoria Milvidskaia
201487,2164.545294,3,0,0,3,10,2007,Jessica Moore
200582,2164.532803,5,1,0,4,47,1997,Maria Strandlund Tomsvik
200675,2164.515735,16,6,0,10,5,1991,Eugenia Maniokova
206756,2164.511861,5,1,0,4,27,2002,Carolina Aravena
202470,2164.489879,7,2,0,5,4,2012,Annika Beck
212605,2164.481985,5,1,0,4,31,1994,Amanda Trail
202450,2164.470904,15,5,0,10,3,2015,Jana Cepelova
200056,2164.453342,26,11,0,15,4,2000,Jelena Kostanic Tosic
201331,2164.448112,39,17,0,22,4,2006,Iveta Benesova
212082,2164.435624,5,1,0,4,25,1998,Lisa Camenzuli
206404,2164.427201,5,1,0,4,4,2014,Elizaveta Kulichkova
202126,2164.418376,3,0,0,3,45,1998,Marissa Niroj
201464,2164.407482,3,0,0,3,15,2009,Nathalie Vierin
200649,2164.401405,7,2,0,5,19,1998,Ginger Helgeson Nielsen
201541,2164.39756,36,15,0,21,3,2013,Chanelle Scheepers
201303,2164.389297,5,1,0,4,16,2013,Anne Keothavong
212155,2164.371093,5,1,0,4,27,2002,Danielle Paynter
200698,2164.362962,24,9,0,15,3,1996,Petra Begerow
201694,2164.317325,3,0,0,3,17,2010,Silvia Njiric
200124,2164.316935,3,0,0,3,48,1992,Anne Kremer
200040,2164.302667,5,1,0,4,20,1992,Anna Smashnova
201334,2164.292506,19,7,0,12,7,2006,Zuzana Ondraskova
201429,2164.287743,3,0,0,3,43,2006,Rika Fujiwara
200066,2164.284549,34,14,0,20,8,2000,Cristina Torrens Valero
201850,2164.243778,9,3,0,6,2,1994,Nino Louarsabishvili
200773,2164.243647,7,2,0,5,19,2013,Stephanie Foretz Gacon
200749,2164.238631,22,8,0,14,9,2002,Samantha Reeves
200599,2164.20814,3,0,0,3,10,1994,Carrie Cunningham
201361,2164.206704,5,1,0,4,31,2009,Julia Schruff
200010,2164.187963,30,12,0,18,11,2004,Rita Grande
200082,2164.186087,16,6,0,10,11,1997,Kristie Boogert
201304,2164.180989,5,1,0,4,17,2008,Elena Baltacha
200036,2164.166892,44,17,0,27,5,2000,Nicole Pratt
200773,2164.130244,8,2,0,6,1,2007,Stephanie Foretz Gacon
200101,2164.10287,23,9,0,14,4,1996,Jana Kandarr
200389,2164.093674,8,2,0,6,13,1990,Kathy Jordan
200569,2164.092175,18,7,0,11,5,1993,Petra Pichalova Langrova
201338,2164.077231,3,0,0,3,12,2003,Bea Bielik
201440,2164.072336,15,6,0,9,15,2012,Laura Pous Tio
200085,2164.061274,5,1,0,4,8,1992,Ai Sugiyama
200647,2164.046807,19,7,0,12,10,1994,Noelle Van Lottum
200011,2164.034604,30,15,0,15,0,1999,Katarina Srebotnik
200010,2164.033114,19,7,0,12,0,1994,Rita Grande
212120,2164.029043,5,1,0,4,27,1997,Kyla Hunte
201269,2164.022633,5,1,0,4,13,1990,Eleni Rossides
200053,2164.010384,17,7,0,10,4,1999,Lubomira Bacheva
212432,2164.007159,5,1,0,4,27,1996,Kim Cartwright
200766,2164.00446,5,1,0,4,23,2005,Jennifer Hopkins
212209,2163.989156,5,1,0,4,26,2006,Suzelle Davin
202201,2163.929143,3,0,0,3,9,1999,Kiyoko Yazawa
200036,2163.924182,7,2,0,5,26,1994,Nicole Pratt
201378,2163.92319,3,0,0,3,1,2005,Stephanie Gehrlein
200574,2163.891979,5,1,0,4,36,1994,Eva Sviglerova
200107,2163.885461,10,3,0,7,22,2005,Paola Suarez
200773,2163.88048,3,0,0,3,8,2010,Stephanie Foretz Gacon
201850,2163.872035,3,0,0,3,38,1999,Nino Louarsabishvili
200054,2163.860517,3,0,0,3,15,1994,Sylvia Plischke
202120,2163.842802,3,0,0,3,17,1993,Kirstin Freye
200708,2163.727294,18,7,0,11,1,1997,Sandra Cacic
201315,2163.694061,20,8,0,12,18,2004,Ashley Harkleroad
201568,2163.678215,5,1,0,4,4,2015,Kristina Kucova
201343,2163.651947,7,2,0,5,12,2002,Maret Ani
204784,2163.633152,7,2,0,5,9,1998,Saori Honda
212432,2163.601862,5,1,0,4,31,1998,Kim Cartwright
200098,2163.576749,17,6,0,11,11,2004,Henrieta Nagyova
200084,2163.571385,13,5,0,8,3,1993,Asa Svensson
202440,2163.564988,7,2,0,5,14,2015,Paula Ormaechea
201308,2163.5442,17,6,0,11,7,2010,Maria Elena Camerin
212176,2163.543067,5,1,0,4,23,2011,Andrea Brenes
205010,2163.540324,3,0,0,3,30,2011,Magy Aziz
212158,2163.525813,3,0,0,3,27,2002,Yeniseik Gomez
200366,2163.506899,14,5,0,9,13,1990,Sylvia Hanika
212513,2163.482984,3,0,0,3,26,1995,Mehry Shawki
201390,2163.477258,3,0,0,3,37,2002,Mervana Jugic Salkic
201365,2163.449514,3,0,0,3,22,2004,Edina Gallovits Hall
200735,2163.418801,10,3,0,7,0,1996,Miho Saeki
201391,2163.372802,9,3,0,6,14,2008,Sanda Mamic
200606,2163.368332,3,0,0,3,57,1999,Nana Smith
200124,2163.366662,6,1,0,5,4,1997,Anne Kremer
202370,2163.356109,3,0,0,3,31,2007,Jenifer Widjaja
201571,2163.344798,3,0,0,3,21,2008,Masa Zec Peskiric
201689,2163.342741,5,1,0,4,25,2006,Magali De Lattre
200530,2163.326447,17,6,0,11,11,1997,Radomira Zrubakova
200720,2163.318632,5,1,0,4,18,2001,Dally Randriantefy
200706,2163.255549,19,7,0,12,1,1995,Catalina Cristea
200071,2163.25301,5,1,0,4,57,2000,Lenka Nemeckova
201960,2163.208365,3,0,0,3,17,1990,Rosa Bielsa Hierro
201180,2163.194624,3,0,0,3,4,1990,Belinda Borneo
202410,2163.161795,5,1,0,4,15,2011,Sofia Shapatava
201211,2163.161376,5,1,0,4,34,2004,Kyra Nagy
200066,2163.147411,5,1,0,4,33,1995,Cristina Torrens Valero
200566,2163.143523,34,15,0,19,0,1991,Donna Faber
202194,2163.137289,5,1,0,4,45,1998,Anna Klim
200060,2163.135496,32,13,0,19,17,2001,Tathiana Garbin
201435,2163.110826,22,8,0,14,4,2015,Kateryna Bondarenko
200753,2163.110602,9,3,0,6,8,1996,Cindy Watson
202461,2163.108464,12,5,0,7,5,2012,Julia Cohen
200398,2163.094743,10,3,0,7,12,1990,Iva Budarova
207291,2163.086453,5,1,0,4,52,2000,Iris Staub
207461,2163.078316,3,0,0,3,44,1994,Kaisaran Siewrattan
208982,2163.074099,5,1,0,4,26,2006,Sevil Aliyeva
203069,2163.0733,3,0,0,3,32,2000,Elena Krutko
202717,2163.047401,5,1,0,4,37,2002,Katarina Misic
212559,2163.03754,5,1,0,4,25,1997,Kim Simmons
212438,2163.023465,5,1,0,4,33,1997,Gaobolae Seleka
212700,2163.016657,5,1,0,4,31,1998,Tamara Davis
201517,2163.015879,40,16,0,24,4,2015,Magdalena Rybarikova
201311,2163.008782,12,4,0,8,11,2004,Roberta Vinci
206626,2163.003974,3,0,0,3,46,1993,Nuria Niemes
212316,2162.993299,5,1,0,4,37,2013,Rheeya Doshi
201408,2162.974555,7,2,0,5,11,2004,Jamea Jackson
200084,2162.955407,40,18,0,22,0,1997,Asa Svensson
200720,2162.931971,9,3,0,6,12,1995,Dally Randriantefy
202269,2162.931527,3,0,0,3,42,1999,Erika Valdes
201290,2162.929239,35,16,0,19,6,2015,Daniela Hantuchova
200123,2162.919163,5,1,0,4,5,1995,Marlene Weingartner
200076,2162.900052,22,9,0,13,2,1994,Laurence Courtois
201624,2162.899905,3,0,0,3,16,1998,Eun Ha Kim
201606,2162.884367,37,16,0,21,3,2011,Rebecca Marino
200028,2162.878504,17,7,0,10,4,2003,Maureen Drake
200611,2162.827242,5,1,0,4,26,1990,Tracey Morton Rodgers
200560,2162.795408,19,8,0,11,4,1997,Rene Collins
200504,2162.788472,3,0,0,3,15,1991,Julie Salmon
201401,2162.762657,10,3,0,7,1,2007,Abigail Spears
200574,2162.75544,3,0,0,3,7,1993,Eva Sviglerova
202073,2162.747047,7,2,0,5,33,1997,Chin Bee Khoo
202789,2162.708282,5,1,0,4,29,2004,Salome Devidze
200043,2162.689473,24,9,0,15,3,2010,Virginie Razzano
212314,2162.671663,5,1,0,4,37,2013,Jahana Bayramova
200076,2162.660947,13,4,0,9,0,1997,Laurence Courtois
204945,2162.642605,7,2,0,5,45,1998,Deanna Roberts
211816,2162.617837,5,1,0,4,27,2012,Alina Soltanici
200120,2162.605141,7,2,0,5,24,2005,Jelena Dokic
200560,2162.594198,13,4,0,9,13,1993,Rene Collins
212290,2162.584996,5,1,0,4,41,2012,Hannah En Xin Chew
202103,2162.58416,3,0,0,3,9,1999,Keiko Ishida
207202,2162.57462,3,0,0,3,47,1996,Irena Mihailova
202504,2162.574288,7,2,0,5,4,2014,Ying Ying Duan
200082,2162.5584,25,10,0,15,10,1998,Kristie Boogert
212310,2162.556478,3,0,0,3,28,2012,Mariela Haug
206997,2162.55399,7,2,0,5,25,1997,Annette Falkenberg
202302,2162.548825,3,0,0,3,31,2007,Maria Fernanda Alves
206870,2162.544729,3,0,0,3,47,1996,Andria Hadjioannou
200737,2162.541828,5,1,0,4,20,1999,Aleksandra Olsza
206575,2162.536161,5,1,0,4,34,1997,Galina Misiuriova
212677,2162.534414,3,0,0,3,46,1993,Claudia Harrison
200691,2162.522877,10,3,0,7,11,1995,Flora Perfetti
201486,2162.517523,9,2,0,7,3,2013,Aleksandra Wozniak
212291,2162.499551,5,1,0,4,41,2012,Geraldine Ang
201754,2162.487692,7,2,0,5,22,2007,Leanne Baker
201191,2162.483406,3,0,0,3,19,1995,Shirli Ann Siddall
201487,2162.46688,5,1,0,4,26,2009,Jessica Moore
212431,2162.463277,3,0,0,3,26,1997,Chris Anne Aston
201608,2162.454287,3,0,0,3,6,2007,Sheng Nan Sun
201595,2162.449649,25,9,0,16,3,2013,Misaki Doi
200718,2162.442991,25,9,0,16,6,1996,Ludmila Richterova
200060,2162.441907,33,13,0,20,4,2005,Tathiana Garbin
200694,2162.44108,3,0,0,3,51,1995,Elly Hakami
206601,2162.438098,5,1,0,4,40,1997,Nanely Vallejo
201542,2162.435459,3,0,0,3,18,2011,Olivia Rogowska
200395,2162.42934,17,7,0,10,5,1991,Catherine Tanvier
200582,2162.415926,3,0,0,3,16,1992,Maria Strandlund Tomsvik
200730,2162.408916,3,0,0,3,42,1996,Min Tang
201877,2162.408339,3,0,0,3,31,1990,Karen Shin
201428,2162.347432,10,3,0,7,1,2008,Mathilde Johansson
201545,2162.332412,30,12,0,18,3,2011,Anastasija Sevastova
201364,2162.330604,5,1,0,4,23,2003,Tatiana Golovin
201537,2162.310006,3,0,0,3,15,2015,Patricia Mayr Achleitner
201451,2162.308712,5,1,0,4,8,2011,Kathrin Woerle
202317,2162.29894,7,2,0,5,3,2003,Ilke Gers
212200,2162.28533,3,0,0,3,31,2005,Shao Fang Ong
203071,2162.245183,9,3,0,6,45,1998,Jenny Ann Fetch
201552,2162.236243,3,0,0,3,8,2009,Mallory Cecil
201348,2162.232811,19,7,0,12,4,2007,Casey Dellacqua
201445,2162.205102,3,0,0,3,15,2008,Viktoria Kutuzova
212110,2162.147473,5,1,0,4,31,1998,Niki Williams
201402,2162.122489,15,5,0,10,2,2013,Sesil Karatantcheva
202900,2162.121938,5,1,0,4,31,2007,Maria Fernanda Alvarez Teran
202393,2162.112832,5,1,0,4,35,2004,Andrea Koch Benvenuto
212574,2162.109725,3,0,0,3,47,1996,Anna Anastasiou
202021,2162.107405,3,0,0,3,10,1992,Estefania Bottini
208378,2162.095883,5,1,0,4,56,1997,Sobhini De Silva
203033,2162.09028,3,0,0,3,9,1999,Keiko Tameishi
203051,2162.09028,3,0,0,3,9,1999,Satomi Kinjo
201491,2162.086328,3,0,0,3,7,2007,Olivia Sanchez
212097,2162.085898,3,0,0,3,54,1999,Shaza Tinawi
206344,2162.073443,3,0,0,3,38,2013,Fernanda Brito
212195,2162.054892,3,0,0,3,30,2004,Elna De Villiers
214419,2162.053066,3,0,0,3,26,2014,Nina Kalezic
206124,2162.046736,3,0,0,3,8,2014,Tereza Martincova
212529,2162.03815,5,1,0,4,34,1997,Nathalie Sienkob
204897,2162.033588,3,0,0,3,44,2002,Dina Khalil
210539,2162.031867,3,0,0,3,44,2002,Tapiwa Marobela
201388,2162.026227,3,0,0,3,45,2006,Sophie Ferguson
202266,2162.020882,5,1,0,4,12,2001,Kelly Liggan
212142,2162.018554,3,0,0,3,30,2001,Azza Abbou
201017,2162.011674,18,7,0,11,11,1990,Angelika Kanellopoulou
200060,2162.006195,5,1,0,4,17,1998,Tathiana Garbin
200122,2161.994964,26,10,0,16,15,2000,Tina Pisnik
200024,2161.973616,16,6,0,10,12,2001,Maria Vento Kabchi
200476,2161.955504,8,2,0,6,8,1992,Cammy Macgregor
206897,2161.938538,3,0,0,3,32,1998,Monika Pimentel
200595,2161.924108,31,12,0,19,2,1991,Ann Wunderlich
200510,2161.909266,3,0,0,3,50,1991,Julie Richardson
201295,2161.905807,23,9,0,14,8,2002,Wynne Prakusya
200103,2161.901265,14,5,0,9,8,2003,Evie Dominikovic
204420,2161.896913,3,0,0,3,36,2014,Marcela Zacarias
202022,2161.869131,3,0,0,3,28,1991,Sabrina Lucchi
212416,2161.859299,3,0,0,3,19,1991,Ljudmila Pavlov
200012,2161.842836,29,11,0,18,12,2001,Jana Nejedly
201516,2161.834217,14,5,0,9,10,2008,Evgeniya Rodina
201307,2161.813857,3,0,0,3,11,2004,Amber Liu
201478,2161.812685,8,2,0,6,1,2006,Varvara Lepchenko
201390,2161.777612,5,1,0,4,31,2009,Mervana Jugic Salkic
201514,2161.754536,5,1,0,4,16,2015,Sorana Cirstea
200718,2161.750683,12,4,0,8,11,1997,Ludmila Richterova
201380,2161.685168,39,18,0,21,3,2004,Claudine Schaul
200346,2161.68239,3,0,0,3,53,1993,Anne Minter
203235,2161.67396,5,1,0,4,52,2002,Po Kuen Lam
201418,2161.666975,3,0,0,3,6,2006,Ting Li
201675,2161.664281,5,1,0,4,7,2010,So Jung Kim
201324,2161.661865,3,0,0,3,29,1999,Irina Selyutina
201466,2161.660486,3,0,0,3,15,2004,Kaia Kanepi
200775,2161.652835,3,0,0,3,26,2000,Tatiana Kovaltchouk
203816,2161.632442,5,1,0,4,22,1991,Siobhan Nicholson
201678,2161.620098,7,2,0,5,15,2012,Sacha Jones
200635,2161.605709,3,0,0,3,10,1991,Ingelise Driehuis
212472,2161.594017,3,0,0,3,38,2000,Lilly Cal Fong
201679,2161.590001,5,1,0,4,0,2012,Varatchaya Wongteanchai
203886,2161.581497,3,0,0,3,41,1992,Joni Van Ryck De Groot
207695,2161.581497,3,0,0,3,48,1992,Issem Essaies
202275,2161.581497,3,0,0,3,53,1995,Tagifano Soonalole
212385,2161.581497,3,0,0,3,47,1996,Stefania Stefansdottir
202519,2161.581497,3,0,0,3,36,1997,Ouarda Bouchabou
212117,2161.581497,3,0,0,3,37,2004,Lucia Henkle Gomez
205532,2161.581497,3,0,0,3,33,2007,Karoline Steiro
203235,2161.580302,3,0,0,3,35,2003,Po Kuen Lam
212168,2161.580096,5,1,0,4,35,2003,Marina Spakova
200035,2161.576728,7,2,0,5,21,2002,Maria Sanchez Lorenzo
212444,2161.573826,3,0,0,3,33,1992,Cheah Sui Kim
212244,2161.573826,3,0,0,3,40,2008,Amreetha Muttiah
200626,2161.571365,3,0,0,3,51,1995,Emanuela Zardo
204605,2161.570776,3,0,0,3,36,1993,Joana Pedroso
201407,2161.570776,3,0,0,3,45,2006,Evgenia Linetskaya
209753,2161.569695,3,0,0,3,26,2007,Ecaterina Vasenina
200569,2161.56542,15,5,0,10,2,1994,Petra Pichalova Langrova
206904,2161.55993,3,0,0,3,45,2000,Yoannis Montesino
200073,2161.55619,7,2,0,5,24,2000,Julie Pullin
208297,2161.555788,3,0,0,3,36,2004,Natalia Baez
200695,2161.555071,5,1,0,4,23,2000,Tina Krizan
201574,2161.554357,3,0,0,3,45,2010,Neuza Silva
212091,2161.55357,3,0,0,3,53,1995,Adriana Thaggard
206940,2161.55357,3,0,0,3,36,1997,Yasmin Attia Abdalla
207076,2161.55357,3,0,0,3,26,2013,Julia Matojan
212442,2161.552433,3,0,0,3,32,1999,Valisoa Rafolomanantsiatosika
209983,2161.551503,3,0,0,3,39,2008,Line Al Ghannam
202115,2161.550668,3,0,0,3,47,1992,Cathrine Instebo
212318,2161.550668,3,0,0,3,44,2014,Aslina Chua
212148,2161.549888,3,0,0,3,44,2002,Nadia Kilani
205883,2161.54908,3,0,0,3,31,2007,Anett Schutting
212725,2161.535531,3,0,0,3,34,1998,Cheryl Lewis
212730,2161.535531,3,0,0,3,45,2000,Alaa A A Ali
212247,2161.531114,3,0,0,3,26,2008,Charlene Tsangamwe
202153,2161.530007,3,0,0,3,4,2003,Melanie Marois
212475,2161.524467,5,1,0,4,34,1997,Laura Gatti
202509,2161.518623,3,0,0,3,38,2001,Joelle Schad
201591,2161.516866,3,0,0,3,38,2013,Margalita Chakhnashvili
209331,2161.511024,3,0,0,3,31,2010,Julia Helbet
200415,2161.510821,10,3,0,7,4,1990,Catherine Suire
201562,2161.507467,35,14,0,21,4,2012,Silvia Soler Espinosa
201410,2161.501829,5,1,0,4,13,2008,Monique Adamczak
212686,2161.495917,3,0,0,3,45,2000,Haleema Rahim
212133,2161.494843,3,0,0,3,52,2000,Esther Mbugua
200727,2161.494423,3,0,0,3,26,2000,Adriana Serra Zanetti
201445,2161.464872,15,5,0,10,10,2006,Viktoria Kutuzova
201328,2161.463854,5,1,0,4,10,2002,Milagros Sequera
207803,2161.461232,3,0,0,3,31,2005,Avel Romaly Coronado
200125,2161.437419,12,4,0,8,4,1996,Corina Morariu
201582,2161.388023,5,1,0,4,7,2011,Jing Jing Lu
202317,2161.348555,7,2,0,5,53,2002,Ilke Gers
200767,2161.342962,7,2,0,5,54,2001,Holly Parkinson
201080,2161.337325,5,1,0,4,23,2001,Louise Latimer
204740,2161.326112,3,0,0,3,37,2002,Maria Pavlidou
212518,2161.304728,3,0,0,3,40,1993,Dionne Lim
206178,2161.291508,3,0,0,3,14,2015,Susanne Celik
200072,2161.2359,43,18,0,25,4,2003,Cara Black
212739,2161.233804,3,0,0,3,45,2000,Mehvish Chishtie
203297,2161.221063,3,0,0,3,4,2015,Nadiya Kichenok
200059,2161.217436,43,18,0,25,2,1998,Ruxandra Dragomir Ilie
204044,2161.209646,3,0,0,3,48,1997,Natalia Nemchinova
201328,2161.202737,14,5,0,9,12,2008,Milagros Sequera
200713,2161.196338,3,0,0,3,25,2001,Yuka Yoshida
201591,2161.195286,3,0,0,3,36,2003,Margalita Chakhnashvili
212363,2161.193736,5,1,0,4,34,1997,Christine Vogt
201349,2161.162208,21,9,0,12,4,2005,Melinda Czink
201194,2161.153901,8,3,0,5,11,1992,Tammy Whittington
212541,2161.143984,3,0,0,3,27,1996,Camille Walter
204304,2161.143474,3,0,0,3,45,2010,Jawairiah Noordin
201044,2161.130381,13,4,0,9,10,1991,Catherine Mothes Jobkel
206529,2161.122777,3,0,0,3,48,1997,Hanna Katri Aalto
200604,2161.116918,12,4,0,8,10,1992,Barbara Paulus
201452,2161.113158,18,7,0,11,17,2014,Lourdes Dominguez Lino
212174,2161.112738,3,0,0,3,36,2003,Kunykei Koichumananova
201061,2161.109227,6,1,0,5,11,1997,Eva Martincova
212302,2161.103647,3,0,0,3,43,2014,Lesedi Sheya Jacobs
201462,2161.103513,3,0,0,3,14,2008,Alberta Brianti
212173,2161.090936,3,0,0,3,36,2003,Yulia Klimchenko
214471,2161.089249,3,0,0,3,44,2014,Alina Lazareva
212190,2161.088224,3,0,0,3,33,2005,Almira Hallyeva
212568,2161.08708,3,0,0,3,53,2000,Lisa Gebert
212393,2161.086678,3,0,0,3,41,1992,Monica Aguero
212097,2161.086678,3,0,0,3,53,2002,Shaza Tinawi
200050,2161.074344,16,5,0,11,5,2001,Sandra Kleinova
212499,2161.071213,3,0,0,3,53,1998,Sara Taweel
207681,2161.068997,3,0,0,3,56,1997,Busrin Boontemleaw
212206,2161.068997,3,0,0,3,53,2000,Sigurlaug Sigurdardottir
214628,2161.068997,3,0,0,3,43,2014,Katrina Sammut
212161,2161.066584,3,0,0,3,41,1992,Saira Sanchinelli
206869,2161.066584,3,0,0,3,25,1998,Stephanie Kamberi
203217,2161.066584,3,0,0,3,26,2005,Karoline Borgersen
202420,2161.061841,5,1,0,4,18,2014,An Sophie Mestach
206130,2161.057085,3,0,0,3,37,2013,Tjasa Srimpf
212450,2161.053769,3,0,0,3,24,1991,Patricia Rodriguez
202278,2161.05238,3,0,0,3,38,2001,Romy Farah
212301,2161.051074,3,0,0,3,29,2012,Carita Moolman
212351,2161.05105,3,0,0,3,34,1997,Metasebeya Temesgen
212147,2161.05105,3,0,0,3,44,2002,Rosanne Dimech
205294,2161.05105,3,0,0,3,33,2006,Katariina Tuohimaa
212218,2161.05105,3,0,0,3,39,2008,Vanessa Boey
212252,2161.05105,3,0,0,3,28,2009,Lee Anne Lingo
204800,2161.051021,3,0,0,3,48,1997,Sofia Managadze
212157,2161.051021,3,0,0,3,26,2009,Anabelle Espinosa Rodriguez
212206,2161.050138,3,0,0,3,26,2005,Sigurlaug Sigurdardottir
207617,2161.048713,3,0,0,3,39,2008,Tarryn Rudman
213980,2161.03459,3,0,0,3,43,2014,Sandra Andriamarosoa
212134,2161.030794,3,0,0,3,44,2002,Razalia Phethu
201959,2161.030794,3,0,0,3,26,2006,Ana Catarina Nogueira
212450,2161.030676,3,0,0,3,41,1992,Patricia Rodriguez
207495,2161.030676,3,0,0,3,31,1999,Zdenka Videnova
200562,2161.030232,7,2,0,5,22,1990,Martina Pawlik
207166,2161.027212,3,0,0,3,26,1995,Ismet Duygu Aksit Oal
212194,2161.025544,3,0,0,3,26,2006,Laone Botshoma
212147,2161.012625,3,0,0,3,27,2012,Rosanne Dimech
212131,2160.993932,5,1,0,4,52,2000,Tankiso Letseka
201284,2160.986245,36,13,0,23,5,2001,Tatiana Poutchek
201959,2160.968754,11,4,0,7,30,2001,Ana Catarina Nogueira
202348,2160.967603,3,0,0,3,35,2004,Lina Stanciute
200569,2160.952524,33,14,0,19,2,1991,Petra Pichalova Langrova
212201,2160.946243,3,0,0,3,31,2005,Tatyana Ignatchenko
201477,2160.927912,16,6,0,10,8,2009,Stephanie Dubois
201429,2160.917841,9,3,0,6,9,2001,Rika Fujiwara
201051,2160.914441,5,1,0,4,37,1991,Laura Lapi
201021,2160.908867,7,2,0,5,11,1995,Laura Garrone
205700,2160.908737,3,0,0,3,28,2012,Emma Flood
200105,2160.894567,32,13,0,19,1,1995,Rachel Mcquillan
200959,2160.89317,25,10,0,15,2,1990,Mareen Louie Harper
204024,2160.862809,11,4,0,7,33,1997,Natalie Dittmann
200107,2160.848653,8,2,0,6,12,1995,Paola Suarez
201289,2160.812801,3,0,0,3,22,2004,Christina Wheeler
208426,2160.799561,3,0,0,3,30,2004,Carina Bjornstrom
200712,2160.793823,10,3,0,7,27,1994,Katerina Kroupova
200538,2160.788974,3,0,0,3,28,1991,Akemi Nishiya
204655,2160.774317,3,0,0,3,48,1992,Gulberk Gultekin
200089,2160.770929,3,0,0,3,34,2003,Miriam Oremans
201726,2160.750755,3,0,0,3,51,1992,Rachel Ann Jensen
202386,2160.74805,5,1,0,4,6,2013,Sung Hee Han
201322,2160.746961,3,0,0,3,38,1999,Eva Dyrberg
202714,2160.729555,3,0,0,3,48,1996,Marina Lazarovska
201356,2160.722265,16,6,0,10,0,2012,Eva Birnerova
200073,2160.720158,3,0,0,3,23,2001,Julie Pullin
201681,2160.704659,5,1,0,4,44,2010,Suchanun Viratprasert
200028,2160.672792,6,1,0,5,0,1990,Maureen Drake
200484,2160.654638,5,1,0,4,25,1992,Ann Devries
200639,2160.646735,3,0,0,3,36,1995,Claudine Toleafoa
210886,2160.624769,3,0,0,3,27,2014,Mayar Sherif
201078,2160.609972,5,1,0,4,19,2002,Eugenia Kulikovskaya
201198,2160.60871,3,0,0,3,19,1995,Lizzy Jelfs
212745,2160.599161,3,0,0,3,45,2000,Salima Esmat Salman
200013,2160.595414,25,9,0,16,2,1994,Angelica Gavaldon
200751,2160.588428,13,5,0,8,19,2004,Conchita Martinez Granados
212293,2160.587628,3,0,0,3,42,2012,Roshenka Fernando
201339,2160.586285,7,2,0,5,1,2002,Renata Voracova
200667,2160.580637,3,0,0,3,19,1998,Ines Gorrochategui
212098,2160.569527,5,1,0,4,56,1997,Farah Dayoub
203262,2160.568866,3,0,0,3,39,2008,Valeria Pulido Velasco
200662,2160.566563,5,1,0,4,62,1993,Joanne Limmer
200682,2160.565764,5,1,0,4,60,2002,Joannette Kruger
212226,2160.552372,3,0,0,3,31,2007,Marisela Aviles
212517,2160.549032,3,0,0,3,40,1993,Norzahara Zainal
200104,2160.548991,35,15,0,20,2,2005,Emilie Loit
208978,2160.547885,3,0,0,3,44,2002,Annette Aksdal
212432,2160.547795,3,0,0,3,46,1994,Kim Cartwright
212384,2160.54767,3,0,0,3,31,1999,Rakel Petursdottir
206997,2160.547008,3,0,0,3,41,1992,Annette Falkenberg
206897,2160.547008,3,0,0,3,47,1994,Monika Pimentel
212379,2160.547008,3,0,0,3,47,1994,Maribel Amadeo
207554,2160.547008,3,0,0,3,58,1996,Cristina Bengzon
212589,2160.547008,3,0,0,3,58,1996,Tatiana Babina
203044,2160.547008,3,0,0,3,45,1998,Maria Boboedova
212121,2160.547008,3,0,0,3,54,1999,Mariola Prado
209992,2160.547008,3,0,0,3,53,2002,Lara Alsamman
212217,2160.547008,3,0,0,3,31,2006,Sybille Khayat
205467,2160.547008,3,0,0,3,40,2008,Maria Eugenia Roca Recarey
209712,2160.547008,3,0,0,3,32,2010,Elaine Genovese
209984,2160.547008,3,0,0,3,46,2010,Kim Sadi
212313,2160.547008,3,0,0,3,27,2012,Hedda Odegaard
210113,2160.547008,3,0,0,3,38,2013,Katherine Gabriela Miranda Chang
212692,2160.542429,3,0,0,3,58,1996,Fiona Keasberry
202085,2160.540945,3,0,0,3,5,2002,Galina Fokina
201574,2160.532443,3,0,0,3,30,2008,Neuza Silva
206987,2160.531334,3,0,0,3,47,1994,Renate Wachtler
207986,2160.528308,3,0,0,3,31,2005,Madelaine Madelaire
212279,2160.528245,3,0,0,3,43,2012,Maliha Al Awaidy
210207,2160.527451,3,0,0,3,26,2008,Stacey Lock
212445,2160.526698,3,0,0,3,37,1996,Claudia Brause
200560,2160.524283,7,2,0,5,4,1996,Rene Collins
201456,2160.518532,6,1,0,5,8,2014,Olga Savchuk
208287,2160.516734,3,0,0,3,26,2009,Nihal Tarek Saleh
212734,2160.505993,3,0,0,3,31,1998,Marisa Howell
201445,2160.499402,5,1,0,4,15,2007,Viktoria Kutuzova
205348,2160.498003,5,1,0,4,31,2007,Wei Ping Lee
206289,2160.495075,3,0,0,3,42,2012,Maria Sakkari
200124,2160.494138,24,10,0,14,1,2007,Anne Kremer
202471,2160.488635,3,0,0,3,46,2011,Karen Barbat
200538,2160.483584,3,0,0,3,40,1990,Akemi Nishiya
206447,2160.477379,3,0,0,3,41,1992,Ingrid Gonzalez
201641,2160.476124,3,0,0,3,25,2009,Nadia Lalami
201508,2160.459653,8,2,0,6,9,2015,Petra Cetkovska
202545,2160.432736,3,0,0,3,46,2011,Irina Kuzmina
200645,2160.423667,3,0,0,3,10,1991,Maja Zivec Skulj
203082,2160.409785,3,0,0,3,52,1999,Nicole Melch
201445,2160.390355,19,7,0,12,4,2009,Viktoria Kutuzova
200689,2160.372586,16,6,0,10,10,1994,Tessa Price
201587,2160.354475,20,7,0,13,5,2010,Bojana Jovanovski
201485,2160.353961,33,12,0,21,5,2009,Alla Kudryavtseva
200439,2160.342731,29,11,0,18,8,1992,Jenny Byrne
202389,2160.340967,3,0,0,3,37,2002,Sandra Martinovic
201959,2160.336021,3,0,0,3,37,2002,Ana Catarina Nogueira
209836,2160.330081,3,0,0,3,35,2003,Nikkita Fountain
203004,2160.318907,5,1,0,4,50,1998,Wukirasih Sawondari
200055,2160.31673,12,4,0,8,23,2000,Mariana Diaz Oliva
201085,2160.261964,3,0,0,3,0,1998,Shinobu Asagoe
200606,2160.256406,12,4,0,8,10,1998,Nana Smith
203290,2160.254474,3,0,0,3,30,2006,Piia Suomalainen
204655,2160.246686,3,0,0,3,32,2000,Gulberk Gultekin
201663,2160.241985,5,1,0,4,15,2010,Ekaterina Dzehalevich
200705,2160.236943,20,8,0,12,10,1994,Linda Ferrando
200007,2160.236287,3,0,0,3,16,1995,Silvija Talaja
200057,2160.236127,5,1,0,4,3,1992,Erika De Lone
201595,2160.194296,19,7,0,12,4,2011,Misaki Doi
201597,2160.194257,5,1,0,4,4,2011,Kurumi Nara
200069,2160.168024,22,9,0,13,8,2013,Nadia Petrova
207933,2160.160324,3,0,0,3,30,2001,Sana Ben Salah
200658,2160.153301,3,0,0,3,50,2001,Fang Li
200005,2160.130903,3,0,0,3,48,1998,Jolene Watanabe Giltz
212201,2160.118696,5,1,0,4,31,2007,Tatyana Ignatchenko
200052,2160.102883,33,15,0,18,4,2000,Olga Barabanschikova
201690,2160.090351,3,0,0,3,7,2010,Nina Bratchikova
201303,2160.089646,7,2,0,5,1,2005,Anne Keothavong
200078,2160.082073,3,0,0,3,14,1996,Barbara Schwartz
212565,2160.081653,3,0,0,3,27,1997,Sharon Green
212204,2160.081459,3,0,0,3,26,2007,Stephanie Sullivan
201524,2160.077919,12,4,0,8,1,2008,Urszula Radwanska
201672,2160.072094,5,1,0,4,6,2015,Nigina Abduraimova
213994,2160.067908,3,0,0,3,26,2014,Tamara Bojanic
200095,2160.06638,3,0,0,3,51,2000,Linda Wild
210521,2160.063418,3,0,0,3,41,2012,Nabila Farah
212255,2160.062727,3,0,0,3,40,2009,Ghazaleh Torkaman
208844,2160.052468,3,0,0,3,30,2006,Elze Potgieter
201963,2160.050113,5,1,0,4,20,1991,Sofia Prazeres
201209,2160.047319,3,0,0,3,48,1992,Selima Sfar
212750,2160.04661,3,0,0,3,54,1998,Ishraq Salman
204059,2160.046212,3,0,0,3,10,1997,Futaba Kubota
212709,2160.044948,3,0,0,3,33,1998,Jodi Saunders
212183,2160.044666,3,0,0,3,35,2004,Ummarahmat Hummetova
212213,2160.042962,3,0,0,3,31,2010,Jacklyn Lambert
200483,2160.039792,9,3,0,6,9,1990,Kumiko Okamoto
201963,2160.030918,3,0,0,3,39,1996,Sofia Prazeres
212111,2160.025053,5,1,0,4,36,2000,Zarah De Silva
214618,2160.025019,3,0,0,3,44,2014,Halla Alajeely
205009,2160.024324,3,0,0,3,38,1999,Borka Majstorovic
212083,2160.024294,3,0,0,3,58,1996,Lynn Yin Tan
212691,2160.024294,3,0,0,3,58,1996,Pauline Chan
204970,2160.024294,3,0,0,3,38,2001,Karina Ildor Jacobsgaard
212210,2160.024294,3,0,0,3,26,2005,Ilina Kroushovski
212211,2160.024294,3,0,0,3,26,2005,Irina Letseva
214635,2160.024294,3,0,0,3,31,2014,Karla Contreras
200615,2160.008211,3,0,0,3,36,2003,Kristin Godridge
207552,2160.008148,3,0,0,3,53,1998,Pamela Floro
204638,2160.007611,3,0,0,3,32,2006,Valeria Bondarenko
202266,2160.006872,3,0,0,3,40,2008,Kelly Liggan
201570,2160.006742,16,6,0,10,8,2011,Vesna Dolonc
202073,2160.006258,3,0,0,3,58,1996,Chin Bee Khoo
208245,2160.003195,3,0,0,3,31,2005,Maria Irene Squillaci Sandoval
211516,2160.0025,3,0,0,3,25,2008,Alyssa Fuentes
201448,2159.991553,36,15,0,21,4,2012,Galina Voskoboeva
200092,2159.985353,3,0,0,3,39,1996,Sandra Nacuk
202946,2159.963265,3,0,0,3,47,1997,Christina Zachariadou
200749,2159.952951,5,1,0,4,18,2000,Samantha Reeves
200506,2159.947958,18,7,0,11,16,1995,Wiltrud Probst
202387,2159.940018,3,0,0,3,5,2008,Vlada Ekshibarova
200754,2159.939357,38,16,0,22,4,2003,Jill Craybas
212552,2159.933219,3,0,0,3,36,1993,Amy Berthe
200770,2159.932268,5,1,0,4,13,2006,Stephanie Cohen Aloro
207518,2159.930987,3,0,0,3,36,1995,Marisue Jacutin
202195,2159.924102,3,0,0,3,42,1998,Petra Gaspar
201551,2159.901215,17,7,0,10,15,2010,Arantxa Rus
200663,2159.889314,3,0,0,3,48,1997,Nanne Dahlman
202946,2159.873992,3,0,0,3,39,1996,Christina Zachariadou
201546,2159.860704,3,0,0,3,16,2009,Anna Lapushchenkova
201573,2159.805703,6,1,0,5,4,2010,Laura Robson
203501,2159.755706,7,2,0,5,13,2015,Taylor Townsend
202479,2159.699528,3,0,0,3,9,2012,Grace Min
201356,2159.645567,3,0,0,3,16,2003,Eva Birnerova
201561,2159.645503,5,1,0,4,19,2013,Claire Feuerstein
201517,2159.641246,3,0,0,3,4,2007,Magdalena Rybarikova
202436,2159.640954,3,0,0,3,9,2011,Reka Luca Jani
200713,2159.638001,6,1,0,5,8,1995,Yuka Yoshida
212518,2159.633101,3,0,0,3,33,1994,Dionne Lim
201309,2159.618426,14,5,0,9,15,2002,Tatiana Perebiynis
212391,2159.598766,3,0,0,3,46,1993,Paula Alvarez
209628,2159.597529,3,0,0,3,26,2007,Daniela Cociorba
200650,2159.593,18,7,0,11,0,1991,Isabel Cueto
212284,2159.579841,3,0,0,3,24,2011,Dania Navarro
212442,2159.579709,3,0,0,3,52,2000,Valisoa Rafolomanantsiatosika
200547,2159.566981,12,4,0,8,36,1994,Sandra Wasserman
207583,2159.566819,3,0,0,3,32,2000,Katrina Bandere
202275,2159.56151,3,0,0,3,54,1999,Tagifano Soonalole
214613,2159.560176,3,0,0,3,43,2014,Iesha Shepherd
200019,2159.556297,18,6,0,12,11,1995,Alexandra Fusai
206908,2159.543706,3,0,0,3,31,2010,Diana Espinal
212098,2159.540678,3,0,0,3,53,1998,Farah Dayoub
202078,2159.540468,3,0,0,3,48,1992,Rosabel Moyen
203913,2159.536118,11,4,0,7,9,1999,Niki Tippins
202309,2159.52754,3,0,0,3,31,2005,Ana Lucia Migliarini De Leon
202467,2159.525586,3,0,0,3,39,2009,Elitsa Kostova
200442,2159.519551,9,2,0,7,10,1994,Andrea Temesvari
201021,2159.514331,3,0,0,3,28,1993,Laura Garrone
206904,2159.511346,3,0,0,3,42,1995,Yoannis Montesino
201367,2159.502173,35,14,0,21,5,2005,Arantxa Parra Santonja
202231,2159.5,3,0,0,3,8,1996,Shiho Hisamatsu
204056,2159.5,3,0,0,3,8,1996,Kaori Kuki
204481,2159.5,3,0,0,3,8,1996,Kylie Moulds
204811,2159.5,3,0,0,3,54,1996,Sofia Finer
207395,2159.5,3,0,0,3,8,1996,Shizuka Tokiwa
207565,2159.5,3,0,0,3,54,1996,Nicole Oomens
201182,2159.5,3,0,0,3,62,1997,Jane Wood
202105,2159.5,3,0,0,3,10,1997,Anori Fukuda
204761,2159.5,3,0,0,3,9,1998,Rurika Maruse
201289,2159.5,5,1,0,4,52,1999,Christina Wheeler
202575,2159.5,3,0,0,3,9,1999,Kumiko Iijima
202963,2159.5,3,0,0,3,52,1999,Nina Nittinger
202993,2159.5,3,0,0,3,9,1999,Sachie Umehara
204175,2159.5,3,0,0,3,9,1999,Akiko Gunji
204479,2159.5,3,0,0,3,52,1999,Vanessa Kendall
204465,2159.5,3,0,0,3,59,2000,Susanne Filipp
202128,2159.5,3,0,0,3,52,2001,Riei Kawamata
202743,2159.5,3,0,0,3,52,2001,Sai Jayalakshmy Jayaram
203044,2159.5,3,0,0,3,52,2001,Maria Boboedova
203132,2159.5,3,0,0,3,52,2001,Jolanda Mens
203156,2159.5,5,1,0,4,52,2001,Jennifer Schmidt
203859,2159.5,3,0,0,3,52,2001,Nicola Payne
204570,2159.5,5,1,0,4,52,2001,Alejandra Rivero
204572,2159.5,3,0,0,3,52,2001,Maria Eugenia Brito
204575,2159.5,5,1,0,4,52,2001,Helga Vieira
202549,2159.5,3,0,0,3,63,2002,Erika Clarke Magana
203105,2159.5,3,0,0,3,56,2002,I Ting Wang
204691,2159.5,3,0,0,3,63,2002,Marcela Evangelista
204944,2159.5,3,0,0,3,56,2002,Darya Ivanov
205044,2159.5,3,0,0,3,56,2002,Karin Ionesco
203194,2159.5,3,0,0,3,45,2003,Leticia Sobral
204691,2159.5,3,0,0,3,45,2003,Marcela Evangelista
200036,2159.5,3,0,0,3,43,2008,Nicole Pratt
203388,2159.5,3,0,0,3,50,2011,Poojashree Venkatesha
212274,2159.5,3,0,0,3,50,2011,Emilia Tenizbaeva
212277,2159.5,3,0,0,3,50,2011,Amangul Mollayeva
201447,2159.493596,34,15,0,19,6,2012,Vania King
202922,2159.449364,3,0,0,3,14,2013,Michaela Honcova
200621,2159.447541,14,5,0,9,9,1995,Isabelle Demongeot
200749,2159.408875,12,4,0,8,10,1999,Samantha Reeves
200019,2159.388705,26,10,0,16,0,1994,Alexandra Fusai
201440,2159.386169,9,3,0,6,15,2007,Laura Pous Tio
200615,2159.384546,6,1,0,5,18,1996,Kristin Godridge
211796,2159.372166,4,0,0,4,8,2014,Francoise Abanda
201414,2159.370382,7,2,0,5,8,2010,Michaella Krajicek
201606,2159.355221,3,0,0,3,38,2012,Rebecca Marino
201476,2159.328312,3,0,0,3,10,2007,Lauren Albanese
201524,2159.311738,40,16,0,24,3,2009,Urszula Radwanska
201571,2159.295146,3,0,0,3,42,2014,Masa Zec Peskiric
201642,2159.283492,3,0,0,3,25,2009,Fatima El Allami
202173,2159.28263,5,1,0,4,45,2000,Joana Cortez
200735,2159.275582,26,11,0,15,0,1998,Miho Saeki
201567,2159.269529,29,12,0,17,3,2015,Alexandra Dulgheru
201211,2159.24452,3,0,0,3,19,2001,Kyra Nagy
200555,2159.23169,3,0,0,3,25,1992,Valda Lake
201542,2159.217712,3,0,0,3,29,2010,Olivia Rogowska
201310,2159.21543,3,0,0,3,6,2004,Martina Muller
201308,2159.214042,34,11,0,23,2,2005,Maria Elena Camerin
201663,2159.212998,5,1,0,4,5,2007,Ekaterina Dzehalevich
201480,2159.195705,5,1,0,4,5,2006,Lioudmila Skavronskaia
201589,2159.188321,3,0,0,3,15,2009,Sharon Fichman
200124,2159.172604,15,5,0,10,1,2006,Anne Kremer
201388,2159.158316,3,0,0,3,5,2007,Sophie Ferguson
202349,2159.145351,3,0,0,3,54,2002,Rushmi Chakravarthi
204969,2159.136949,3,0,0,3,35,2004,Edita Liachoviciute
200115,2159.130866,6,1,0,5,9,2002,Brie Rippner
212302,2159.093888,3,0,0,3,28,2012,Lesedi Sheya Jacobs
202748,2159.091185,3,0,0,3,54,1996,Tomoe Hotta
212184,2159.074876,3,0,0,3,35,2004,Jenneta Halliyeva
207551,2159.074855,3,0,0,3,35,2004,Anna Patricia Santos
212378,2159.07455,3,0,0,3,37,1996,Joanna Bauza
212309,2159.072944,3,0,0,3,27,2012,Maria Jose Pintos
206447,2159.059104,3,0,0,3,47,1994,Ingrid Gonzalez
203105,2159.054595,3,0,0,3,35,2004,I Ting Wang
203913,2159.03789,5,1,0,4,9,1998,Niki Tippins
212175,2159.03676,3,0,0,3,35,2003,Jessica Sweeting
212496,2159.036496,3,0,0,3,36,2000,Asha Jaja
200095,2159.020653,3,0,0,3,2,1999,Linda Wild
202365,2159.000423,3,0,0,3,43,2014,Lavinia Tananta
204020,2158.975706,3,0,0,3,8,1996,Masami Nakai
202250,2158.975706,3,0,0,3,9,1998,Patty Murren
200468,2158.888122,19,7,0,12,15,1990,Hu Na
200444,2158.878537,3,0,0,3,12,1991,Elise Burgin
201662,2158.863757,3,0,0,3,6,2011,Karolina Pliskova
200668,2158.841876,23,9,0,14,7,1992,Silke Frankl
201676,2158.817066,5,1,0,4,7,2009,Ye Ra Lee
200703,2158.798057,32,10,0,22,4,1997,Katarina Studenikova
201079,2158.78951,5,1,0,4,8,2000,Hannah Collin
200724,2158.788094,7,2,0,5,2,1994,Lea Ghirardi
200722,2158.78239,15,5,0,10,5,1996,Francesca Lubiani
202288,2158.766096,3,0,0,3,8,2002,Elke Clijsters
201535,2158.734186,21,8,0,13,4,2011,Coco Vandeweghe
210166,2158.687603,3,0,0,3,45,2014,Sara Mansoor
202981,2158.68237,3,0,0,3,54,1996,Melissa Beadman
200082,2158.680224,5,1,0,4,3,1992,Kristie Boogert
201675,2158.675407,3,0,0,3,6,2006,So Jung Kim
201380,2158.66559,3,0,0,3,42,2014,Claudine Schaul
201451,2158.646534,3,0,0,3,20,2012,Kathrin Woerle
200514,2158.627759,29,11,0,18,3,1991,Monique Javer
201741,2158.626664,4,0,0,4,3,1990,Alysia May
204970,2158.577568,3,0,0,3,35,2004,Karina Ildor Jacobsgaard
200022,2158.567779,3,0,0,3,6,1995,Emmanuelle Gagliardi
201483,2158.563514,3,0,0,3,20,2008,Madison Brengle
209836,2158.531964,3,0,0,3,39,2009,Nikkita Fountain
200022,2158.527432,27,11,0,16,2,1999,Emmanuelle Gagliardi
207166,2158.515972,3,0,0,3,32,2000,Ismet Duygu Aksit Oal
201693,2158.498033,30,12,0,18,5,2013,Timea Babos
200012,2158.468149,3,0,0,3,4,1993,Jana Nejedly
204073,2158.456821,5,1,0,4,52,2001,Branka Bojovic
200770,2158.40109,17,6,0,11,10,2008,Stephanie Cohen Aloro
200074,2158.362612,22,9,0,13,2,1999,Jane Chi
201311,2158.354129,26,10,0,16,1,2006,Roberta Vinci
201408,2158.332016,24,10,0,14,1,2005,Jamea Jackson
200022,2158.33055,27,10,0,17,9,2001,Emmanuelle Gagliardi
200031,2158.313905,13,4,0,9,2,2005,Meilen Tu
201532,2158.301593,6,1,0,5,6,2008,Anastasia Pivovarova
200638,2158.268031,10,3,0,7,12,1991,Stephanie Rottier
200708,2158.266576,19,7,0,12,12,1995,Sandra Cacic
201488,2158.187362,3,0,0,3,8,2009,Jorgelina Cravero
200660,2158.185346,19,6,0,13,2,1999,Kimberly Po Messerli
202365,2158.175059,3,0,0,3,45,2010,Lavinia Tananta
203944,2158.145148,3,0,0,3,37,2001,Candice De La Torre
207565,2158.144074,5,1,0,4,33,1997,Nicole Oomens
200725,2158.139703,12,4,0,8,15,1998,Sandra Cecchini
200416,2158.082238,21,7,0,14,3,1991,Robin White
200019,2158.07068,29,12,0,17,6,1996,Alexandra Fusai
201376,2158.060306,5,1,0,4,13,2006,Angela Haynes
200016,2158.049945,28,11,0,17,10,1992,Sandrine Testud
200060,2158.034388,29,12,0,17,4,2003,Tathiana Garbin
202562,2158.012313,3,0,0,3,31,2007,Hanne Skak Jensen
200063,2157.994285,22,8,0,14,3,2004,Tatiana Panova
206219,2157.935231,8,2,0,6,3,2015,Oceane Dodin
200035,2157.884886,24,9,0,15,14,2000,Maria Sanchez Lorenzo
200123,2157.868833,21,7,0,14,7,1999,Marlene Weingartner
202065,2157.835324,3,0,0,3,11,1990,Henrike Kadzidroga
203456,2157.812066,3,0,0,3,36,2013,Jelena Simic
200040,2157.79783,3,0,0,3,18,2007,Anna Smashnova
201349,2157.784818,25,9,0,16,8,2012,Melinda Czink
201682,2157.783793,7,2,0,5,0,2012,Nudnida Luangnam
200068,2157.766475,22,9,0,13,2,1999,Lilia Osterloh
201657,2157.723552,3,0,0,3,27,2012,Nastja Kolar
200407,2157.699631,6,1,0,5,11,1992,Camille Benjamin
200124,2157.69932,3,0,0,3,42,2014,Anne Kremer
201511,2157.681424,9,3,0,6,7,2010,Ekaterina Ivanova
202389,2157.674705,3,0,0,3,45,2010,Sandra Martinovic
201485,2157.672934,38,15,0,23,3,2011,Alla Kudryavtseva
201299,2157.66865,21,8,0,13,21,2002,Celine Beigbeder
200066,2157.643555,29,12,0,17,8,1997,Cristina Torrens Valero
200495,2157.620509,31,13,0,18,11,1991,Akiko Kijimuta
200666,2157.586539,5,1,0,4,0,1990,Marion Maruska
203518,2157.5785,4,0,0,4,8,2014,Paula Kania
200501,2157.548217,26,8,0,18,1,1996,Marianne Werdel Witmeyer
201437,2157.483756,3,0,0,3,25,2007,Ivana Lisjak
200109,2157.483671,17,6,0,11,4,1997,Nathalie Dechy
200624,2157.480951,28,12,0,16,3,1990,Tami Whitlinger Jones
203080,2157.474147,3,0,0,3,52,1997,Nadia Johnston
200578,2157.397109,6,1,0,5,30,1991,Rennae Stubbs
200008,2157.371312,33,12,0,21,1,2002,Alicia Molik
200656,2157.352692,8,2,0,6,4,1991,Jessica Emmons
200002,2157.347716,19,7,0,12,5,2012,Mirjana Lucic
202288,2157.34112,4,0,0,4,1,2003,Elke Clijsters
201423,2157.29317,38,15,0,23,9,2014,Yvonne Meusburger
201497,2157.278934,3,0,0,3,10,2012,Agnes Szavay
201690,2157.245883,5,1,0,4,18,2011,Nina Bratchikova
201502,2157.24571,6,1,0,5,30,2013,Tatjana Malek
201395,2157.236817,3,0,0,3,4,2003,Teryn Ashley
201316,2157.232575,4,0,0,4,5,2001,Lenka Dlhopolcova
200036,2157.231772,7,2,0,5,12,1993,Nicole Pratt
201087,2157.230218,36,13,0,23,1,2005,Mashona Washington
202102,2157.227527,5,1,0,4,1,1995,Kaoru Shibata
200666,2157.151604,3,0,0,3,36,2001,Marion Maruska
201703,2157.141318,4,0,0,4,7,2015,Yi Fan Xu
200062,2157.116363,14,4,0,10,0,1998,Kristina Brandi
201502,2157.085752,18,7,0,11,5,2007,Tatjana Malek
200674,2157.074232,14,5,0,9,10,1994,Bettina Fulco Villella
202714,2157.060706,3,0,0,3,38,2001,Marina Lazarovska
201389,2157.056369,13,4,0,9,4,2011,Zuzana Kucova
201375,2156.984483,23,9,0,14,3,2004,Shenay Perry
201478,2156.96315,43,18,0,25,2,2013,Varvara Lepchenko
200360,2156.962938,13,4,0,9,2,1996,Pam Shriver
212215,2156.924648,3,0,0,3,32,2006,Nicole Arosemena
201448,2156.916296,8,2,0,6,5,2007,Galina Voskoboeva
200469,2156.908223,19,7,0,12,11,1996,Nicole Bradtke
204204,2156.881689,3,0,0,3,45,1998,Diane Asensio
200060,2156.851488,14,5,0,9,6,1999,Tathiana Garbin
201057,2156.828565,5,1,0,4,32,1993,Angelique Olivier
201030,2156.825008,3,0,0,3,11,1991,Mariana Perez Roldan
201812,2156.744687,4,0,0,4,1,1995,Hiroko Mochizuki
200648,2156.719994,7,2,0,5,8,1997,Marketa Kochta
211635,2156.680016,11,3,0,8,8,2015,Louisa Chirico
201815,2156.635387,8,2,0,6,9,2012,Petra Rampre
201929,2156.633029,3,0,0,3,24,1997,Laura Pena
201616,2156.630625,3,0,0,3,9,2011,Lauren Davis
200687,2156.630625,3,0,0,3,11,1990,Katarzyna Nowak
200665,2156.623532,13,4,0,9,9,1993,Yone Kamio
200706,2156.579359,30,11,0,19,0,1997,Catalina Cristea
201508,2156.503077,19,7,0,12,18,2009,Petra Cetkovska
201533,2156.493548,11,3,0,8,5,2010,Shuai Zhang
201599,2156.466368,17,6,0,11,8,2011,Andrea Hlavackova
200697,2156.460224,25,10,0,15,8,2001,Janette Husarova
201323,2156.449759,13,4,0,9,4,2005,Saori Obata
200716,2156.422665,8,2,0,6,7,1993,Sung Hee Park
201594,2156.407188,38,16,0,22,3,2011,Simona Halep
200704,2156.402242,4,0,0,4,17,1997,Maria Jose Gaidano
200663,2156.356449,8,2,0,6,9,1994,Nanne Dahlman
201550,2156.281673,3,0,0,3,22,2012,Tamaryn Hendler
201047,2156.260836,6,1,0,5,28,1994,Andrea Vieira
201293,2156.254711,14,5,0,9,8,2004,Catalina Castano
201368,2156.252909,11,3,0,8,16,2009,Karolina Sprem
200425,2156.188146,8,2,0,6,19,1990,Sophie Amiach
201557,2156.158559,6,1,0,5,17,2011,Corinna Dentoni
201620,2156.146854,38,15,0,23,4,2015,Monica Puig
201377,2156.145317,8,2,0,6,20,2002,Yuliya Beygelzimer
201086,2156.11486,13,4,0,9,8,2001,Greta Arn
200709,2155.985358,37,14,0,23,1,2002,Rosana De Los Rios
201542,2155.924455,10,3,0,7,10,2012,Olivia Rogowska
201624,2155.912787,7,2,0,5,18,1997,Eun Ha Kim
201339,2155.907819,8,2,0,6,16,2008,Renata Voracova
201598,2155.892685,14,5,0,9,4,2011,Noppawan Lertcheewakarn
200084,2155.840006,33,12,0,21,5,2001,Asa Svensson
200061,2155.831775,12,4,0,8,22,2004,Gala Leon Garcia
200746,2155.813516,11,3,0,8,1,2005,Sandra Kloesel
201293,2155.808519,8,2,0,6,12,2003,Catalina Castano
200106,2155.806606,13,4,0,9,9,1996,Angeles Montolio
200644,2155.796581,32,12,0,20,7,1998,Naoko Sawamatsu
200009,2155.769706,14,4,0,10,4,2011,Tamarine Tanasugarn
201348,2155.753644,27,10,0,17,5,2015,Casey Dellacqua
200439,2155.741551,3,0,0,3,23,1990,Jenny Byrne
201087,2155.713996,6,1,0,5,4,2003,Mashona Washington
202276,2155.694993,12,4,0,8,9,1998,Shelley Bryce
202355,2155.61546,6,1,0,5,5,2006,Sanja Ancic
201321,2155.588967,17,6,0,11,4,2002,Antonella Serra Zanetti
201637,2155.552628,4,0,0,4,34,2003,Melissa Torres Sandoval
200614,2155.54542,26,10,0,16,10,1999,Elena Pampoulova
200088,2155.537721,24,9,0,15,0,1999,Adriana Gersi
202430,2155.393302,6,1,0,5,8,2014,Alize Lim
200060,2155.370606,31,12,0,19,4,2004,Tathiana Garbin
200606,2155.321056,20,7,0,13,1,1995,Nana Smith
200127,2155.319796,19,7,0,12,6,1995,Sarah Pitkowski Malcor
200587,2155.29325,13,4,0,9,11,1991,Silke Meier
200057,2155.249144,14,5,0,9,2,1993,Erika De Lone
201351,2155.18876,11,3,0,8,4,2003,Eva Fislova
201335,2155.186839,3,0,0,3,18,2005,Myriam Casanova
202115,2155.179748,6,1,0,5,22,1991,Cathrine Instebo
200080,2155.178207,25,9,0,16,7,1992,Dominique Monami
200560,2155.174488,16,5,0,11,6,1991,Rene Collins
200711,2155.125651,18,6,0,12,11,1995,Tatiana Ignatieva
200085,2155.055822,11,3,0,8,9,1993,Ai Sugiyama
202460,2155.017069,6,1,0,5,4,2015,Ons Jabeur
200776,2154.981735,4,0,0,4,16,2000,Angelika Bachmann
202421,2154.915934,29,12,0,17,3,2014,Alison Van Uytvanck
200055,2154.915926,40,18,0,22,11,2001,Mariana Diaz Oliva
202458,2154.914446,4,0,0,4,18,2012,Ashleigh Barty
200649,2154.90777,11,3,0,8,19,1997,Ginger Helgeson Nielsen
201084,2154.903193,8,2,0,6,5,2001,Nadejda Ostrovskaya
200601,2154.887695,4,0,0,4,3,1996,Leila Meskhi
201319,2154.858676,4,0,0,4,16,2003,Evelyn Fauth
200522,2154.793717,25,9,0,16,7,1992,Nicole Krijger Jagerman
201481,2154.769878,6,1,0,5,17,2014,Tamira Paszek
200453,2154.767951,32,14,0,18,11,1992,Catarina Lindqvist Ryan
200057,2154.732892,13,4,0,9,3,1995,Erika De Lone
201343,2154.71035,17,7,0,10,7,2009,Maret Ani
201424,2154.696079,31,12,0,19,4,2014,Shahar Peer
200746,2154.692216,15,4,0,11,1,2006,Sandra Kloesel
201590,2154.689131,11,3,0,8,8,2011,Alison Riske
200535,2154.681739,10,3,0,7,8,1992,Jo Anne Faull
200707,2154.669165,6,1,0,5,17,1995,Romana Tedjakusuma
200002,2154.666282,7,1,0,6,12,2002,Mirjana Lucic
201086,2154.647651,4,0,0,4,5,2000,Greta Arn
200123,2154.619325,12,4,0,8,1,1997,Marlene Weingartner
200675,2154.599363,12,3,0,9,6,1993,Eugenia Maniokova
201553,2154.588609,8,2,0,6,7,2009,Lenka Wienerova
200090,2154.542055,10,3,0,7,6,1999,Anca Barna
200498,2154.533606,25,9,0,16,0,1994,Michelle Jaggard Lai
201472,2154.465957,23,9,0,14,4,2014,Romina Oprandi
201666,2154.460043,12,4,0,8,4,2014,Cagla Buyukakcay
200467,2154.456829,8,2,0,6,21,1990,Janine Tremelling
201291,2154.432887,12,3,0,9,7,2011,Nuria Llagostera Vives
201300,2154.428871,14,5,0,9,20,2008,Maria Emilia Salerni
201209,2154.421864,20,8,0,12,14,2001,Selima Sfar
201491,2154.394414,10,3,0,7,10,2008,Olivia Sanchez
200706,2154.388112,27,11,0,16,10,1999,Catalina Cristea
201431,2154.261323,31,14,0,17,7,2008,Aravane Rezai
200615,2154.250715,21,8,0,13,8,1990,Kristin Godridge
200584,2154.240751,15,5,0,10,19,1995,Laura Golarsa
201308,2154.231653,16,5,0,11,10,2008,Maria Elena Camerin
200726,2154.228891,13,4,0,9,0,1994,Nancy Feber
201550,2154.136566,4,0,0,4,26,2009,Tamaryn Hendler
200664,2154.114708,17,5,0,12,3,1991,Stephanie Rehe
200087,2154.11395,24,9,0,15,1,1999,Seda Noorlander
200754,2154.057778,10,3,0,7,16,2012,Jill Craybas
201518,2154.040066,43,18,0,25,2,2013,Yanina Wickmayer
202446,2154.025036,31,12,0,19,5,2015,Eugenie Bouchard
200114,2154.006152,10,3,0,7,25,2001,Patricia Wartusch
200576,2153.957276,6,1,0,5,11,1994,Nathalie Herreman
202941,2153.916259,8,2,0,6,52,1997,Susie Starrett
200092,2153.90907,14,4,0,10,10,1999,Sandra Nacuk
200702,2153.891605,9,2,0,7,0,1994,Naoko Kijimuta
200559,2153.887629,6,1,0,5,21,1998,Kristine Kunce
200121,2153.869355,20,7,0,13,4,2003,Alina Jidkova
201533,2153.869008,4,0,0,4,5,2007,Shuai Zhang
200100,2153.854793,24,9,0,15,3,1999,Amanda Hopmans
200740,2153.84588,3,0,0,3,16,1997,Elena Tatarkova
200535,2153.839404,6,1,0,5,7,1993,Jo Anne Faull
200764,2153.810907,36,16,0,20,4,2001,Elena Bovina
200586,2153.800354,6,1,0,5,15,1994,Federica Bonsignori
200718,2153.756023,22,9,0,13,0,1994,Ludmila Richterova
200082,2153.754121,4,0,0,4,8,1991,Kristie Boogert
201275,2153.72694,12,4,0,8,2,1994,Julie Steven
204426,2153.724306,4,0,0,4,38,2011,Anett Kontaveit
201557,2153.722302,6,1,0,5,4,2010,Corinna Dentoni
200629,2153.605654,12,4,0,8,25,1992,Cristina Tessi
201293,2153.538436,47,22,0,25,4,2006,Catalina Castano
200557,2153.536175,11,3,0,8,3,1995,Katrina Adams
201284,2153.502023,4,0,0,4,1,2005,Tatiana Poutchek
201614,2153.46423,22,8,0,14,2,2013,Caroline Garcia
200671,2153.447491,6,1,0,5,8,2000,Meike Babel
200746,2153.386039,8,2,0,6,2,1998,Sandra Kloesel
201554,2153.375455,6,1,0,5,4,2011,Vitalia Diatchenko
200754,2153.346455,4,0,0,4,1,1999,Jill Craybas
200721,2153.292781,4,0,0,4,0,1994,Hiromi Nagano
201297,2153.281232,6,1,0,5,13,2005,Maja Matevzic
201535,2153.253774,16,5,0,11,8,2013,Coco Vandeweghe
200078,2153.229868,10,3,0,7,16,2004,Barbara Schwartz
201087,2153.223988,16,5,0,11,17,2006,Mashona Washington
200419,2153.191214,6,1,0,5,50,1994,Kathy Rinaldi Stunkel
201482,2153.125088,8,2,0,6,32,2009,Andreja Klepac
201360,2153.089549,6,1,0,5,1,2002,Julia Vakulenko
200062,2153.061347,33,13,0,20,1,2005,Kristina Brandi
211796,2153.043443,6,1,0,5,8,2015,Francoise Abanda
200002,2153.031208,22,8,0,14,8,2011,Mirjana Lucic
201501,2153.01549,21,8,0,13,3,2014,Olga Govortsova
200028,2152.967319,4,0,0,4,11,2004,Maureen Drake
200450,2152.958241,11,3,0,8,22,1999,Larisa Savchenko
203462,2152.94267,16,6,0,10,4,2015,Kateryna Kozlova
200050,2152.939306,8,2,0,6,1,2002,Sandra Kleinova
200703,2152.923673,10,3,0,7,22,1999,Katarina Studenikova
201403,2152.889819,11,3,0,8,19,2011,Anna Chakvetadze
201287,2152.877939,26,10,0,16,13,2001,Maria Jose Martinez Sanchez
200614,2152.829998,5,1,0,4,5,1993,Elena Pampoulova
200007,2152.82522,55,25,0,30,4,2000,Silvija Talaja
201369,2152.81478,4,0,0,4,6,2005,Carly Gullickson
212155,2152.811308,6,1,0,5,31,1998,Danielle Paynter
201672,2152.802495,6,1,0,5,8,2011,Nigina Abduraimova
201365,2152.7649,4,0,0,4,5,2005,Edina Gallovits Hall
200357,2152.755333,4,0,0,4,2,1994,Rosalyn Nideffer
200448,2152.748182,6,1,0,5,9,1991,Sandy Collins
200061,2152.73194,17,5,0,12,3,1996,Gala Leon Garcia
201481,2152.715633,5,1,0,4,4,2015,Tamira Paszek
200697,2152.687124,6,1,0,5,1,1995,Janette Husarova
201444,2152.66401,6,1,0,5,4,2006,Su Wei Hsieh
200060,2152.6318,34,14,0,20,2,2008,Tathiana Garbin
200357,2152.627343,33,14,0,19,2,1991,Rosalyn Nideffer
201448,2152.608037,13,4,0,9,5,2005,Galina Voskoboeva
201315,2152.597169,4,0,0,4,1,2005,Ashley Harkleroad
200004,2152.593279,6,1,0,5,6,1996,Kerry Anne Guse
201850,2152.573092,6,1,0,5,15,1997,Nino Louarsabishvili
201611,2152.523602,8,2,0,6,5,2013,Daria Gavrilova
200567,2152.506212,13,4,0,9,1,1992,Jennifer Santrock
200038,2152.495959,4,0,0,4,41,2000,Annabel Ellwood
201614,2152.491788,9,2,0,7,2,2012,Caroline Garcia
200054,2152.488139,46,20,0,26,4,2000,Sylvia Plischke
200008,2152.486051,21,7,0,14,3,2006,Alicia Molik
202276,2152.473778,10,3,0,7,36,2003,Shelley Bryce
200686,2152.446823,11,3,0,8,10,1991,Sandra Dopfer
201455,2152.442331,28,11,0,17,3,2015,Elena Vesnina
200042,2152.436544,7,1,0,6,2,2005,Els Callens
201087,2152.383407,6,1,0,5,12,2002,Mashona Washington
200125,2152.353588,8,2,0,6,11,2003,Corina Morariu
201431,2152.335827,34,13,0,21,7,2011,Aravane Rezai
200450,2152.18953,24,9,0,15,3,1997,Larisa Savchenko
201377,2152.147995,7,1,0,6,6,2006,Yuliya Beygelzimer
201273,2152.099428,8,2,0,6,1,1992,Shannan Mccarthy
201284,2152.073072,10,3,0,7,5,2006,Tatiana Poutchek
200120,2152.06291,6,1,0,5,21,2010,Jelena Dokic
201212,2152.043162,39,14,0,25,4,2014,Francesca Schiavone
200118,2152.008841,28,10,0,18,4,2005,Virginia Ruano Pascual
200613,2151.995243,4,0,0,4,10,1990,Lise Gregory
209794,2151.975636,4,0,0,4,23,2011,Leticia Demichelli
201656,2151.961781,8,2,0,6,30,2014,Tadeja Majeric
212385,2151.95865,4,0,0,4,34,1997,Stefania Stefansdottir
201485,2151.957781,8,2,0,6,10,2012,Alla Kudryavtseva
200067,2151.930556,17,6,0,11,22,2011,Patty Schnyder
200770,2151.917959,21,8,0,13,10,2005,Stephanie Cohen Aloro
201365,2151.899164,25,10,0,15,9,2009,Edina Gallovits Hall
200695,2151.891683,10,3,0,7,0,1999,Tina Krizan
201354,2151.823359,4,0,0,4,7,2005,Libuse Prusova
200643,2151.79723,13,4,0,9,3,1994,Petra Kamstra
200678,2151.765542,14,4,0,10,13,1993,Gloria Pizzichini
200581,2151.762319,16,6,0,10,15,1991,Tamaka Takagi
200582,2151.761168,20,7,0,13,6,1991,Maria Strandlund Tomsvik
201365,2151.731112,4,0,0,4,23,2003,Edina Gallovits Hall
200047,2151.630892,13,5,0,8,2,1999,Pavlina Nola
200614,2151.626637,15,5,0,10,10,1991,Elena Pampoulova
204599,2151.59675,4,0,0,4,30,2006,Alicia Pillay
200008,2151.567661,17,6,0,11,15,2000,Alicia Molik
200090,2151.561411,37,15,0,22,1,2002,Anca Barna
212555,2151.523354,6,1,0,5,25,1997,Debra Darrell
200724,2151.49759,13,4,0,9,22,1996,Lea Ghirardi
200043,2151.466525,28,10,0,18,10,2006,Virginie Razzano
202399,2151.420058,4,0,0,4,31,2007,Margit Ruutel
201444,2151.416918,4,0,0,4,35,2003,Su Wei Hsieh
201435,2151.404591,21,7,0,14,10,2012,Kateryna Bondarenko
200754,2151.371731,35,12,0,23,3,2010,Jill Craybas
202268,2151.35917,4,0,0,4,17,2006,Montinee Tangphong
200084,2151.357705,6,1,0,5,17,2004,Asa Svensson
200123,2151.342453,47,21,0,26,9,2001,Marlene Weingartner
201465,2151.331173,4,0,0,4,31,2007,Kirsten Flipkens
200680,2151.321379,8,2,0,6,21,1994,Nadin Ercegovic
201605,2151.277392,6,1,0,5,3,2015,Mandy Minella
201531,2151.25762,12,4,0,8,15,2014,Mariana Duque Marino
201310,2151.257428,38,16,0,22,5,2002,Martina Muller
201586,2151.173782,6,1,0,5,18,2010,Heather Watson
201376,2151.144018,6,1,0,5,4,2003,Angela Haynes
201503,2151.143968,43,20,0,23,3,2013,Ayumi Morita
200056,2151.13256,4,0,0,4,9,2010,Jelena Kostanic Tosic
200621,2151.132155,15,5,0,10,17,1993,Isabelle Demongeot
201414,2151.123831,19,7,0,12,10,2012,Michaella Krajicek
212084,2151.083025,4,0,0,4,44,2001,Nicole Angat
212577,2151.068175,4,0,0,4,53,2000,Annita Stylianidou
200615,2151.055954,8,2,0,6,1,1994,Kristin Godridge
200028,2151.050098,6,1,0,5,4,1996,Maureen Drake
212150,2151.038398,4,0,0,4,44,2002,Sabrina Vogt
204543,2150.985734,4,0,0,4,37,2002,Mariela Salinas
201211,2150.972495,9,2,0,7,10,2007,Kyra Nagy
201448,2150.960179,6,1,0,5,42,2010,Galina Voskoboeva
200697,2150.954679,21,7,0,14,0,1994,Janette Husarova
200118,2150.90844,4,0,0,4,30,1994,Virginia Ruano Pascual
201450,2150.884669,26,8,0,18,10,2007,Tsvetana Pironkova
201448,2150.8812,8,2,0,6,37,2014,Galina Voskoboeva
201590,2150.837046,4,0,0,4,9,2012,Alison Riske
201289,2150.747757,6,1,0,5,21,2002,Christina Wheeler
201549,2150.73471,20,7,0,13,5,2013,Petra Martic
201318,2150.728945,23,7,0,16,8,2009,Bethanie Mattek Sands
200126,2150.72385,27,9,0,18,10,2002,Marissa Gould
200083,2150.663664,4,0,0,4,13,2006,Alexandra Stevenson
200004,2150.653464,8,2,0,6,0,1994,Kerry Anne Guse
200333,2150.646084,6,1,0,5,1,1992,Betsy Nagelsen
200731,2150.640865,12,4,0,8,8,1996,Gail Biggs
200640,2150.633022,12,4,0,8,21,1995,Mercedes Paz
202486,2150.596221,16,5,0,11,7,2013,Mallory Burdette
201459,2150.592473,4,0,0,4,8,2004,Zi Yan
200413,2150.586086,8,2,0,6,15,1990,Heather Ludloff
207078,2150.574669,4,0,0,4,26,1995,Helina Lill
206903,2150.546768,4,0,0,4,53,1999,Glenny Cepeda
200069,2150.543332,6,1,0,5,36,2014,Nadia Petrova
201441,2150.542912,8,2,0,6,14,2007,Emma Laine
200078,2150.533818,10,3,0,7,10,1998,Barbara Schwartz
206594,2150.52282,6,1,0,5,31,1998,Morya Peres
210641,2150.510139,4,0,0,4,53,2000,Mamotebang Molise
200610,2150.50976,28,11,0,17,2,1990,Stacey Martin
201959,2150.507204,4,0,0,4,39,2008,Ana Catarina Nogueira
212103,2150.500288,4,0,0,4,32,1998,Alexandra Chong
202125,2150.488248,4,0,0,4,56,1997,Phorhathai Suksamran
200101,2150.381695,23,8,0,15,19,2002,Jana Kandarr
201493,2150.380024,18,6,0,12,1,2007,Angelique Kerber
200720,2150.354044,14,4,0,10,12,2003,Dally Randriantefy
200530,2150.316604,18,6,0,12,1,1996,Radomira Zrubakova
201578,2150.227013,8,2,0,6,33,2013,Kai Chen Chang
201627,2150.202989,10,3,0,7,7,1995,Kim De Weille
201344,2150.200717,36,14,0,22,3,2015,Klara Koukalova
200103,2150.181042,16,6,0,10,6,2005,Evie Dominikovic
201292,2150.178281,41,15,0,26,1,2005,Martina Sucha
201959,2150.1739,4,0,0,4,38,1999,Ana Catarina Nogueira
202352,2150.122205,6,1,0,5,30,2006,Daniela Munoz Gallegos
202415,2150.103881,6,1,0,5,42,2011,Ximena Hermoso
207696,2150.099341,4,0,0,4,26,1995,Imen Ben Larbi
200615,2150.097448,25,9,0,16,7,1992,Kristin Godridge
200544,2150.094913,11,3,0,8,0,1990,Celine Cohen
207166,2150.079841,4,0,0,4,34,1993,Ismet Duygu Aksit Oal
212564,2150.063622,4,0,0,4,27,1996,Ann Simons
201605,2150.025891,6,1,0,5,3,2014,Mandy Minella
200441,2150.024217,14,5,0,9,8,1992,Louise Field
205604,2150.023885,4,0,0,4,26,2008,Andjela Kankaras
212385,2150.019901,4,0,0,4,31,1999,Stefania Stefansdottir
202273,2150.011707,4,0,0,4,46,2011,Liga Dekmeijere
206484,2150.005239,4,0,0,4,37,2002,Monica Acosta
200542,2149.961331,16,5,0,11,4,1990,Clare Wood
201303,2149.942709,4,0,0,4,23,2001,Anne Keothavong
200063,2149.921967,4,0,0,4,24,2006,Tatiana Panova
200022,2149.914785,25,10,0,15,4,2005,Emmanuelle Gagliardi
200105,2149.867807,30,12,0,18,2,2001,Rachel Mcquillan
200007,2149.844027,8,2,0,6,13,2005,Silvija Talaja
201273,2149.831296,10,3,0,7,2,1993,Shannan Mccarthy
200013,2149.764378,7,1,0,6,4,1991,Angelica Gavaldon
200559,2149.759818,4,0,0,4,40,1990,Kristine Kunce
201348,2149.716538,8,2,0,6,18,2010,Casey Dellacqua
201537,2149.710827,24,9,0,15,5,2012,Patricia Mayr Achleitner
200043,2149.685469,13,4,0,9,9,2014,Virginie Razzano
201640,2149.683729,4,0,0,4,6,2012,Maria Teresa Torro Flor
200076,2149.662417,13,4,0,9,0,1998,Laurence Courtois
208982,2149.626162,4,0,0,4,26,2007,Sevil Aliyeva
208261,2149.598081,4,0,0,4,53,1999,Richele Le Saldo
201304,2149.596053,4,0,0,4,20,2003,Elena Baltacha
212149,2149.59281,4,0,0,4,44,2002,Jeannine Niedhardt
201375,2149.58361,4,0,0,4,4,2003,Shenay Perry
200774,2149.582159,13,4,0,9,4,2000,Vanessa Webb
212177,2149.581556,4,0,0,4,33,2003,Danielle Cosgrove
210130,2149.580809,4,0,0,4,45,2010,Maria Paula Deheza
202298,2149.579278,4,0,0,4,53,2000,Feriel Esseghir
209573,2149.578431,4,0,0,4,31,2010,Fatima Zorah Bouabdallah
201390,2149.576002,8,2,0,6,15,2004,Mervana Jugic Salkic
212255,2149.572343,4,0,0,4,41,2012,Ghazaleh Torkaman
200709,2149.570668,18,6,0,12,13,2010,Rosana De Los Rios
200764,2149.565042,4,0,0,4,7,2010,Elena Bovina
209192,2149.559758,4,0,0,4,45,2010,Misleydis Diaz Gonzalez
211516,2149.52755,4,0,0,4,32,2007,Alyssa Fuentes
212130,2149.520827,4,0,0,4,29,2001,Evelyn Otula
212130,2149.516731,4,0,0,4,52,2000,Evelyn Otula
200115,2149.492887,13,4,0,9,7,2000,Brie Rippner
200015,2149.484891,30,12,0,18,11,2004,Petra Mandula
201402,2149.446938,18,7,0,11,8,2015,Sesil Karatantcheva
200643,2149.436287,4,0,0,4,56,1992,Petra Kamstra
201571,2149.417858,16,6,0,10,9,2009,Masa Zec Peskiric
202123,2149.364572,4,0,0,4,40,1993,Suvimol Duangchan
201443,2149.360855,20,7,0,13,0,2009,Alexa Glatch
200028,2149.308299,19,7,0,12,21,2000,Maureen Drake
201426,2149.308145,18,6,0,12,15,2009,Pauline Parmentier
200681,2149.289436,4,0,0,4,33,1991,Natalia Baudone Furlan
202619,2149.273924,4,0,0,4,45,2010,Ema Burgic
200031,2149.198641,40,16,0,24,5,2002,Meilen Tu
200607,2149.176755,22,9,0,13,2,1994,Beate Reinstadler
206678,2149.145116,4,0,0,4,57,1997,Arati Ponnappa
200075,2149.135709,4,0,0,4,52,1998,Jing Qian Yi
212120,2149.127737,4,0,0,4,27,1996,Kyla Hunte
203910,2149.122411,4,0,0,4,53,1999,Paiao Asinata Short
212551,2149.092408,4,0,0,4,26,1995,Assa Berthe
200498,2149.08448,17,6,0,11,9,1990,Michelle Jaggard Lai
207291,2149.082672,4,0,0,4,26,2006,Iris Staub
212283,2149.06963,4,0,0,4,28,2012,Ximena Mino
212746,2149.060113,4,0,0,4,53,1999,Hamidan Bibi
201659,2149.058177,4,0,0,4,15,2009,Melanie Klaffner
210078,2149.048077,4,0,0,4,26,2005,Olfa Dhaoui
212749,2149.039314,4,0,0,4,52,1998,Mina Abdul Rahman
208194,2149.010296,4,0,0,4,33,2003,Julia Roca Valverde
201663,2148.931956,4,0,0,4,5,2008,Ekaterina Dzehalevich
201589,2148.90113,16,6,0,10,3,2013,Sharon Fichman
204058,2148.892315,10,3,0,7,10,1997,Nami Urabe
200087,2148.891804,11,3,0,8,14,1998,Seda Noorlander
201456,2148.878475,8,2,0,6,3,2011,Olga Savchuk
201209,2148.861744,4,0,0,4,35,1993,Selima Sfar
204419,2148.85521,4,0,0,4,39,2014,Ana Sofia Sanchez
200686,2148.840827,6,1,0,5,10,1998,Sandra Dopfer
202480,2148.833484,9,2,0,7,3,2015,Richel Hogenkamp
202479,2148.820933,6,1,0,5,16,2015,Grace Min
202715,2148.751835,6,1,0,5,33,1997,Alena Paulenkova
200714,2148.747709,4,0,0,4,23,2001,Yvette Basting
206329,2148.731422,4,0,0,4,27,2015,Montserrat Gonzalez
200747,2148.67946,10,3,0,7,0,1998,Haruka Inoue
202181,2148.666364,4,0,0,4,33,1994,Lela Zainal
212162,2148.654628,4,0,0,4,27,2002,Masika Williams
200621,2148.629,24,7,0,17,7,1992,Isabelle Demongeot
212299,2148.613457,4,0,0,4,27,2012,Veronica Osogo Nabwire
212087,2148.608287,4,0,0,4,46,2000,Valeria Khazova
212120,2148.603977,4,0,0,4,29,2001,Kyla Hunte
212087,2148.593502,4,0,0,4,44,2001,Valeria Khazova
212542,2148.589407,6,1,0,5,25,1997,Lorena Porras
200038,2148.581488,6,1,0,5,9,2001,Annabel Ellwood
212428,2148.578589,4,0,0,4,26,1995,Mmaphala Letsatle
201489,2148.5771,16,5,0,11,3,2010,Mariya Koryttseva
212100,2148.572687,4,0,0,4,45,2000,Tina Jacob
201370,2148.570177,31,11,0,20,4,2007,Anastasia Rodionova
201287,2148.567809,4,0,0,4,24,2002,Maria Jose Martinez Sanchez
212574,2148.558366,4,0,0,4,26,1995,Anna Anastasiou
212231,2148.557608,4,0,0,4,32,2007,Kristen Lopez
206910,2148.553968,4,0,0,4,43,1999,Mari Toro
207290,2148.546635,4,0,0,4,47,1996,Hrafuhildur Hannesdotter
201664,2148.53867,4,0,0,4,21,2008,Pemra Ozgen
201484,2148.536611,4,0,0,4,7,2009,Sandra Zahlavova
212086,2148.535061,4,0,0,4,44,2001,Olga Dzuba
212341,2148.533587,4,0,0,4,26,1998,Rediet Kefyalew
212106,2148.526103,4,0,0,4,33,2003,Lisa Fung Kee Fung
207518,2148.523151,4,0,0,4,53,1998,Marisue Jacutin
201059,2148.5226,14,5,0,9,0,1994,Misumi Miyauchi
200105,2148.504982,4,0,0,4,16,2000,Rachel Mcquillan
204970,2148.503988,4,0,0,4,31,2005,Karina Ildor Jacobsgaard
202352,2148.498721,4,0,0,4,35,2008,Daniela Munoz Gallegos
202462,2148.497014,4,0,0,4,35,2004,Karen Castiblanco
201570,2148.470979,4,0,0,4,29,2010,Vesna Dolonc
200039,2148.421828,8,1,0,7,1,2006,Chanda Rubin
202300,2148.411194,4,0,0,4,31,2000,Meryem El Haddad
200690,2148.403262,16,5,0,11,9,1993,Kyoko Nagatsuka
201709,2148.401543,17,5,0,12,16,2013,Yulia Putintseva
201523,2148.381881,6,1,0,5,1,2007,Marina Erakovic
201500,2148.355079,5,0,0,5,14,2008,Nika Ozegovic
200115,2148.283127,6,1,0,5,50,2001,Brie Rippner
202669,2148.281665,4,0,0,4,37,2013,Cristina Dinu
202711,2148.280049,4,0,0,4,37,2001,Antoaneta Pandjerova
201327,2148.27471,11,3,0,8,6,2006,Angelique Widjaja
200114,2148.253166,29,10,0,19,7,2003,Patricia Wartusch
201568,2148.1921,4,0,0,4,17,2010,Kristina Kucova
202611,2148.189935,4,0,0,4,39,2008,Oksana Kalashnikova
203068,2148.183619,4,0,0,4,53,1999,Natalia Nikitina
202700,2148.182627,4,0,0,4,41,2012,Simone Pratt
203083,2148.178936,4,0,0,4,20,2001,Stephanie Schaer
200111,2148.175187,20,7,0,13,17,2004,Lina Krasnoroutskaya
200092,2148.141079,18,6,0,12,6,2000,Sandra Nacuk
212438,2148.13672,4,0,0,4,26,1995,Gaobolae Seleka
202394,2148.134445,4,0,0,4,46,2011,Camila Silva
201286,2148.123595,4,0,0,4,23,2014,Anabel Medina Garrigues
200020,2148.119922,25,9,0,16,5,2006,Lisa Raymond
212255,2148.119093,4,0,0,4,39,2013,Ghazaleh Torkaman
201042,2148.117792,4,0,0,4,0,1990,Andrea Tiezzi
212144,2148.117169,4,0,0,4,57,1997,Alissa Velts
202460,2148.105802,9,2,0,7,3,2014,Ons Jabeur
200666,2148.097085,4,0,0,4,57,1992,Marion Maruska
204690,2148.085735,4,0,0,4,30,2006,Czarina Mae Arevalo
201365,2148.076612,21,9,0,12,4,2007,Edina Gallovits Hall
207176,2148.073826,4,0,0,4,53,2000,Sona Saringulyan
212115,2148.072784,4,0,0,4,31,2010,Tara Lambert
212137,2148.06665,4,0,0,4,30,1999,Kago Phatshwane
212098,2148.040572,4,0,0,4,44,2001,Farah Dayoub
212428,2148.035587,4,0,0,4,25,1998,Mmaphala Letsatle
202536,2148.023974,7,1,0,6,3,2015,Ana Bogdan
200091,2148.011801,11,3,0,8,11,2002,Janet Lee
201622,2147.970147,4,0,0,4,33,2012,Iryna Bremond
201080,2147.95356,11,3,0,8,14,2000,Louise Latimer
201081,2147.950597,4,0,0,4,20,1997,Joanne Ward
202440,2147.829798,4,0,0,4,31,2010,Paula Ormaechea
200362,2147.766018,25,9,0,16,2,1991,Liz Smylie
200016,2147.760461,29,11,0,18,5,1993,Sandrine Testud
201387,2147.75829,10,3,0,7,16,2004,Sofia Arvidsson
200407,2147.752291,28,10,0,18,3,1990,Camille Benjamin
200552,2147.733855,4,0,0,4,15,1991,Maria Lindstrom
200746,2147.709546,6,1,0,5,16,2008,Sandra Kloesel
200113,2147.672449,6,1,0,5,41,2003,Anna Kournikova
212085,2147.667221,4,0,0,4,44,2001,Davilyn Godinet
202645,2147.662175,4,0,0,4,41,2012,Jessy Rompies
201588,2147.652587,6,1,0,5,16,2007,Anna Tatishvili
202281,2147.650726,6,1,0,5,24,2002,Ivanna Israilova
204338,2147.63123,4,0,0,4,46,2011,Nazari Urbina
200560,2147.611178,17,6,0,11,0,1994,Rene Collins
206621,2147.610237,4,0,0,4,25,1998,Kelesitse Makgale
202326,2147.602711,4,0,0,4,39,2009,Ankita Bhambri
201505,2147.599106,38,15,0,23,3,2011,Ekaterina Makarova
206289,2147.598411,4,0,0,4,25,2013,Maria Sakkari
200715,2147.595355,4,0,0,4,24,2000,Mariaan De Swardt
212118,2147.586435,4,0,0,4,36,2000,Elena Branker
200024,2147.580605,36,13,0,23,4,2005,Maria Vento Kabchi
201584,2147.579526,36,14,0,22,4,2012,Ksenia Pervak
201350,2147.572882,4,0,0,4,45,2003,Adriana Szili
201311,2147.571793,28,11,0,17,10,2007,Roberta Vinci
207165,2147.571302,4,0,0,4,45,1998,Siobhan Munro
209836,2147.566591,4,0,0,4,43,2014,Nikkita Fountain
212546,2147.565189,4,0,0,4,28,1996,Jennifer Carter
200050,2147.527201,13,4,0,9,5,1996,Sandra Kleinova
200584,2147.517586,35,13,0,22,9,1994,Laura Golarsa
201291,2147.514207,26,9,0,17,3,2009,Nuria Llagostera Vives
210173,2147.45498,6,1,0,5,37,2013,Ushna Suhail
200042,2147.369962,8,2,0,6,12,2001,Els Callens
201456,2147.352101,13,4,0,9,3,2010,Olga Savchuk
200119,2147.336573,4,0,0,4,15,2003,Rita Kuti Kis
201456,2147.306962,18,6,0,12,1,2006,Olga Savchuk
201490,2147.279662,11,3,0,8,6,2012,Timea Bacsinszky
212708,2147.269202,6,1,0,5,31,1998,Janelle Watson
201663,2147.244927,6,1,0,5,5,2006,Ekaterina Dzehalevich
200032,2147.237241,26,11,0,15,0,1994,Barbara Schett
200683,2147.229522,7,1,0,6,26,1993,Monique Kiene
201446,2147.179686,5,0,0,5,3,2004,Sybille Bammer
201274,2147.158089,4,0,0,4,9,1991,Viktoria Milvidskaia
201642,2147.151144,4,0,0,4,30,2011,Fatima El Allami
212111,2147.126343,4,0,0,4,28,2002,Zarah De Silva
200591,2147.122234,4,0,0,4,34,1990,Ronni Reis
201668,2147.119211,10,3,0,7,7,2013,Alexandra Panova
207956,2147.108459,4,0,0,4,36,2004,Yanet Nunez Mojarena
212206,2147.102895,4,0,0,4,26,2006,Sigurlaug Sigurdardottir
205918,2147.091972,4,0,0,4,25,2010,Ulrikke Eikeri
200419,2147.081254,11,3,0,8,11,1996,Kathy Rinaldi Stunkel
201906,2147.051663,4,0,0,4,34,1997,Marwa El Wany
202498,2147.047681,6,1,0,5,0,2012,Julia Glushko
200462,2147.007522,13,4,0,9,10,1991,Belinda Cordwell
200473,2147.003036,11,3,0,8,1,1992,Beverly Bowes Hackney
202930,2146.989137,4,0,0,4,45,2010,Jessica Roland Rosario
201708,2146.980323,4,0,0,4,6,2006,Natalie Grandin
200054,2146.908601,42,16,0,26,0,1999,Sylvia Plischke
201366,2146.902905,34,13,0,21,4,2012,Barbora Zahlavova Strycova
200022,2146.896498,36,15,0,21,8,2000,Emmanuelle Gagliardi
201428,2146.799331,23,8,0,15,8,2013,Mathilde Johansson
200055,2146.753367,11,3,0,8,11,1997,Mariana Diaz Oliva
201599,2146.743624,25,8,0,17,7,2013,Andrea Hlavackova
201454,2146.740321,4,0,0,4,6,2004,Akgul Amanmuradova
202305,2146.690424,4,0,0,4,52,2002,Manisha Malhotra
201402,2146.685042,8,2,0,6,15,2009,Sesil Karatantcheva
200764,2146.65392,7,1,0,6,13,2007,Elena Bovina
201542,2146.651829,4,0,0,4,21,2015,Olivia Rogowska
203584,2146.636457,4,0,0,4,33,2013,Adriana Perez
201588,2146.630431,21,7,0,14,3,2011,Anna Tatishvili
200021,2146.603038,29,11,0,18,7,1999,Alexia Dechaume Balleret
201366,2146.598741,33,13,0,20,3,2009,Barbora Zahlavova Strycova
207947,2146.544063,4,0,0,4,30,2006,Yamile Fors Guerra
200579,2146.496438,33,15,0,18,5,1991,Karin Kschwendt
204056,2146.461913,4,0,0,4,33,1997,Kaori Kuki
201540,2146.459963,47,21,0,26,2,2013,Kristina Mladenovic
200611,2146.409746,4,0,0,4,15,1991,Tracey Morton Rodgers
202261,2146.403663,4,0,0,4,31,2005,Joanna Sakowicz Kostecka
206575,2146.388665,4,0,0,4,35,1993,Galina Misiuriova
204783,2146.364145,4,0,0,4,31,2000,Petra Puheloinen
201475,2146.346168,10,2,0,8,10,2008,Ahsha Rolle
200578,2146.327116,6,1,0,5,19,1990,Rennae Stubbs
201944,2146.324045,4,0,0,4,34,1999,Zuzana Hejdova
200582,2146.296802,21,6,0,15,5,1990,Maria Strandlund Tomsvik
200441,2146.278902,26,9,0,17,8,1990,Louise Field
201048,2146.249134,4,0,0,4,33,1991,Leona Laskova
200484,2146.24088,9,2,0,7,4,1990,Ann Devries
201548,2146.235844,9,2,0,7,8,2011,Ajla Tomljanovic
212129,2146.191878,4,0,0,4,27,2012,Caroline Oduor
200362,2146.184524,9,2,0,7,2,1994,Liz Smylie
200777,2146.184048,36,13,0,23,7,2002,Marta Marrero
201540,2146.172541,4,0,0,4,9,2009,Kristina Mladenovic
200709,2146.146224,25,9,0,16,1,2008,Rosana De Los Rios
204536,2146.145155,4,0,0,4,46,2000,Barbara Castro
201412,2146.065031,18,6,0,12,9,2009,Anastasia Yakimova
200070,2146.05169,31,10,0,21,2,1998,Anne Gaelle Sidot
200724,2146.023302,20,7,0,13,6,1995,Lea Ghirardi
200403,2146.013417,13,4,0,9,3,1991,Andrea Leand
201367,2146.001587,28,9,0,19,3,2011,Arantxa Parra Santonja
210174,2146,4,0,0,4,50,2011,Sarah Mahboob Khan
201313,2145.954694,33,15,0,18,10,2003,Yoon Jeong Cho
202331,2145.934808,4,0,0,4,43,1999,Vilmarie Castellvi
200647,2145.832453,31,11,0,20,9,1993,Noelle Van Lottum
200333,2145.799768,4,0,0,4,6,1993,Betsy Nagelsen
202454,2145.746166,7,1,0,6,2,2012,Erika Sema
201508,2145.705259,29,12,0,17,5,2008,Petra Cetkovska
202458,2145.660566,7,1,0,6,9,2014,Ashleigh Barty
203969,2145.640232,4,0,0,4,29,2004,Yomna Farid
201490,2145.597658,9,2,0,7,3,2007,Timea Bacsinszky
201443,2145.591027,4,0,0,4,10,2006,Alexa Glatch
200506,2145.531231,28,10,0,18,3,1993,Wiltrud Probst
200092,2145.462603,8,2,0,6,22,2001,Sandra Nacuk
202421,2145.349078,7,1,0,6,15,2013,Alison Van Uytvanck
201604,2145.334308,19,6,0,13,9,2012,Irina Falconi
201640,2145.256652,12,3,0,9,14,2015,Maria Teresa Torro Flor
200640,2145.224797,32,11,0,21,1,1992,Mercedes Paz
200500,2145.169454,15,5,0,10,0,1990,Pilar Vasquez
200557,2145.122196,12,3,0,9,2,1993,Katrina Adams
200486,2145.017303,15,5,0,10,12,1991,Csilla Cserepy
200542,2144.946105,20,7,0,13,5,1991,Clare Wood
201589,2144.933004,11,3,0,8,9,2014,Sharon Fichman
201513,2144.91917,13,4,0,9,8,2010,Sabine Lisicki
200663,2144.848293,27,9,0,18,3,1993,Nanne Dahlman
200702,2144.830081,7,1,0,6,7,1998,Naoko Kijimuta
201431,2144.821264,7,1,0,6,13,2012,Aravane Rezai
200082,2144.724589,18,6,0,12,19,2001,Kristie Boogert
205329,2144.697042,4,0,0,4,31,2007,Julija Gotovskyte
200021,2144.686677,28,9,0,19,3,1998,Alexia Dechaume Balleret
200684,2144.682478,23,9,0,14,10,1999,Shi Ting Wang
211701,2144.679644,33,13,0,20,3,2015,Katerina Siniakova
200413,2144.646428,7,1,0,6,26,1992,Heather Ludloff
200088,2144.638633,26,9,0,17,0,1998,Adriana Gersi
201423,2144.635937,21,7,0,14,2,2008,Yvonne Meusburger
201072,2144.612975,8,2,0,6,6,1999,Eva Bes Ostariz
201428,2144.590032,21,8,0,13,4,2009,Mathilde Johansson
200021,2144.564365,20,7,0,13,6,1996,Alexia Dechaume Balleret
200602,2144.562884,27,10,0,17,2,1991,Shaun Stafford
201662,2144.487115,7,1,0,6,14,2012,Karolina Pliskova
202434,2144.478327,4,0,0,4,3,2013,Aleksandra Krunic
200726,2144.470546,18,6,0,12,0,1996,Nancy Feber
201741,2144.463153,9,2,0,7,4,1991,Alysia May
201292,2144.428573,13,4,0,9,18,2007,Martina Sucha
201542,2144.384878,5,0,0,5,8,2013,Olivia Rogowska
200052,2144.377796,39,15,0,24,0,1999,Olga Barabanschikova
201286,2144.342384,30,10,0,20,3,2013,Anabel Medina Garrigues
201446,2144.328361,47,19,0,28,1,2006,Sybille Bammer
201518,2144.293779,36,15,0,21,7,2014,Yanina Wickmayer
200118,2144.270562,30,12,0,18,10,1999,Virginia Ruano Pascual
200030,2144.254588,27,10,0,17,8,2001,Miroslava Vavrinec
200061,2144.241011,14,5,0,9,12,2003,Gala Leon Garcia
200376,2144.225584,4,0,0,4,17,2005,Katerina Bohmova
200106,2144.192977,9,2,0,7,10,1994,Angeles Montolio
200035,2144.18569,13,4,0,9,26,2001,Maria Sanchez Lorenzo
201377,2144.16054,7,1,0,6,4,2015,Yuliya Beygelzimer
201290,2144.147205,41,16,0,25,3,2014,Daniela Hantuchova
200766,2144.144735,9,2,0,7,3,2004,Jennifer Hopkins
201595,2144.119536,17,5,0,12,4,2014,Misaki Doi
201435,2144.113367,25,8,0,17,3,2010,Kateryna Bondarenko
200608,2144.023196,15,5,0,10,2,1993,Audra Keller
201551,2143.988996,13,4,0,9,9,2009,Arantxa Rus
200627,2143.979716,7,1,0,6,25,1996,Petra Schwarz
200765,2143.971478,13,4,0,9,10,2000,Katalin Marosi
201662,2143.969499,27,11,0,16,2,2013,Karolina Pliskova
200506,2143.917994,7,1,0,6,14,1996,Wiltrud Probst
201386,2143.899806,28,10,0,18,8,2004,Jie Zheng
200464,2143.82713,30,11,0,19,2,1990,Ann Henricksson
200569,2143.818236,22,8,0,14,7,1992,Petra Pichalova Langrova
200621,2143.792763,12,3,0,9,2,1994,Isabelle Demongeot
200641,2143.79252,22,7,0,15,10,1994,Patricia Tarabini
201356,2143.776426,9,2,0,7,7,2013,Eva Birnerova
201471,2143.744827,7,1,0,6,7,2007,Naomi Cavaday
200726,2143.708802,16,5,0,11,4,1993,Nancy Feber
201452,2143.683261,18,6,0,12,10,2008,Lourdes Dominguez Lino
200658,2143.672842,18,6,0,12,10,1999,Fang Li
200035,2143.660494,25,10,0,15,10,2006,Maria Sanchez Lorenzo
201666,2143.625459,5,0,0,5,33,2013,Cagla Buyukakcay
200407,2143.585017,10,2,0,8,6,1991,Camille Benjamin
201193,2143.564558,9,2,0,7,24,1994,Claire Wegink
202671,2143.546123,25,10,0,15,3,2015,Cristina Andreea Mitu
200542,2143.532858,25,9,0,16,4,1994,Clare Wood
200657,2143.521892,4,0,0,4,4,2000,Radka Bobkova
201328,2143.513017,23,8,0,15,7,2004,Milagros Sequera
200679,2143.477134,9,2,0,7,6,1991,Caroline Kuhlman
200047,2143.461754,12,3,0,9,10,1998,Pavlina Nola
201478,2143.36461,14,4,0,10,8,2010,Varvara Lepchenko
201318,2143.331024,5,0,0,5,12,2003,Bethanie Mattek Sands
200698,2143.305107,7,1,0,6,1,1993,Petra Begerow
201343,2143.303791,16,6,0,10,10,2008,Maret Ani
201046,2143.276574,9,2,0,7,0,1990,Silvia La Fratta
200421,2143.198405,12,3,0,9,6,1990,Pascale Paradis Mangon
201379,2143.185929,19,6,0,13,2,2005,Mara Santangelo
202628,2143.108164,7,1,0,6,8,2014,Maryna Zanevska
200671,2143.0364,25,9,0,16,10,1998,Meike Babel
201494,2143.031798,19,6,0,13,1,2008,Raluca Olaru
200547,2143.031674,11,3,0,8,7,1992,Sandra Wasserman
200118,2143.004279,25,9,0,16,1,1996,Virginia Ruano Pascual
201300,2142.988218,11,3,0,8,4,2002,Maria Emilia Salerni
200682,2142.964977,5,0,0,5,23,2003,Joannette Kruger
200109,2142.861256,17,6,0,11,3,1996,Nathalie Dechy
200716,2142.860916,7,1,0,6,7,1999,Sung Hee Park
201754,2142.819503,13,4,0,9,45,2000,Leanne Baker
200614,2142.808271,15,4,0,11,3,1996,Elena Pampoulova
201693,2142.805214,18,6,0,12,4,2014,Timea Babos
200086,2142.773956,15,5,0,10,42,1998,Magdalena Maleeva
200729,2142.708707,15,5,0,10,10,2005,Lindsay Lee Waters
201086,2142.708237,7,1,0,6,17,2009,Greta Arn
200091,2142.701247,22,8,0,14,0,1998,Janet Lee
201349,2142.693291,35,15,0,20,1,2006,Melinda Czink
200503,2142.647292,5,0,0,5,12,1992,Gretchen Magers
201352,2142.615654,13,4,0,9,20,2008,Akiko Morigami
200732,2142.574234,9,2,0,7,0,1999,Magdalena Grzybowska
201334,2142.552485,9,2,0,7,16,2004,Zuzana Ondraskova
200532,2142.480365,9,2,0,7,29,1991,Maider Laval
201562,2142.458483,34,14,0,20,3,2013,Silvia Soler Espinosa
206049,2142.436398,12,4,0,8,4,2014,Jovana Jaksic
200402,2142.401092,12,3,0,9,5,1990,Wendy Prausa
201392,2142.220632,14,4,0,10,8,2009,Severine Beltrame
201477,2142.213455,24,8,0,16,1,2008,Stephanie Dubois
200703,2142.168524,18,5,0,13,4,1998,Katarina Studenikova
201315,2142.126643,21,7,0,14,1,2007,Ashley Harkleroad
201417,2142.08048,17,5,0,12,9,2009,Marta Domachowska
200036,2142.012954,25,8,0,17,6,2005,Nicole Pratt
200627,2141.996562,20,7,0,13,1,1995,Petra Schwarz
200616,2141.883496,7,1,0,6,10,1991,Pascale Etchemendy
200035,2141.876518,31,10,0,21,10,1998,Maria Sanchez Lorenzo
201597,2141.821575,8,1,0,7,4,2010,Kurumi Nara
204076,2141.63973,4,0,0,4,33,1997,Lara Howes
200606,2141.604603,20,7,0,13,2,1991,Nana Smith
200068,2141.597955,7,1,0,6,4,2010,Lilia Osterloh
200701,2141.589766,7,1,0,6,2,1995,Caroline Vis
200063,2141.514667,7,1,0,6,9,1995,Tatiana Panova
202450,2141.493755,22,8,0,14,8,2013,Jana Cepelova
201479,2141.406029,11,3,0,8,1,2008,Olga Puchkova
201400,2141.395712,19,7,0,12,13,2009,Nicole Vaidisova
200441,2141.367504,15,5,0,10,12,1993,Louise Field
200713,2141.27079,9,2,0,7,8,2004,Yuka Yoshida
200046,2141.263881,9,1,0,8,3,2009,Meghann Shaughnessy
200584,2141.245406,15,5,0,10,6,1992,Laura Golarsa
200657,2141.148673,14,4,0,10,9,1996,Radka Bobkova
200025,2141.122322,16,5,0,11,4,1999,Ludmila Cervanova
200645,2140.945505,15,4,0,11,3,1993,Maja Zivec Skulj
200126,2140.935895,20,7,0,13,3,2004,Marissa Gould
200521,2140.914356,9,2,0,7,0,1990,Hellas Ter Riet
212095,2140.910045,5,0,0,5,35,2003,Chen Yee Liaw
213583,2140.905619,26,10,0,16,3,2015,Tatjana Maria
200659,2140.858538,26,8,0,18,2,1993,Rika Hiraki
200732,2140.82443,5,0,0,5,51,2001,Magdalena Grzybowska
200645,2140.747969,7,1,0,6,7,1992,Maja Zivec Skulj
200719,2140.741092,7,1,0,6,8,1997,Siobhan Drake Brockman
201681,2140.732732,7,1,0,6,4,2006,Suchanun Viratprasert
200732,2140.726194,9,2,0,7,1,2002,Magdalena Grzybowska
200028,2140.641227,5,0,0,5,13,1992,Maureen Drake
201086,2140.636911,20,7,0,13,9,2002,Greta Arn
200126,2140.555259,20,6,0,14,10,2005,Marissa Gould
202499,2140.51143,34,14,0,20,3,2014,Donna Vekic
200056,2140.503134,9,2,0,7,10,2008,Jelena Kostanic Tosic
200595,2140.461406,27,10,0,17,11,1997,Ann Wunderlich
201385,2140.455878,20,7,0,13,1,2006,Yuliana Fedak
201370,2140.437691,19,6,0,13,4,2012,Anastasia Rodionova
201556,2140.437156,16,5,0,11,7,2013,Lucie Hradecka
202702,2140.43668,25,9,0,16,9,2015,Tereza Smitkova
200040,2140.433686,18,6,0,12,0,1996,Anna Smashnova
200640,2140.429637,8,1,0,7,14,1996,Mercedes Paz
201448,2140.425361,28,11,0,17,3,2009,Galina Voskoboeva
200012,2140.419322,12,3,0,9,1,1994,Jana Nejedly
201394,2140.366361,17,6,0,11,13,2010,Anna Lena Groenefeld
200485,2140.237875,9,2,0,7,7,1995,Manon Bollegraf
201087,2140.212607,12,3,0,9,5,2000,Mashona Washington
200037,2140.204703,35,13,0,22,2,1998,Sabine Appelmans
200103,2140.191084,31,11,0,20,9,2001,Evie Dominikovic
200019,2140.139491,14,4,0,10,7,1992,Alexandra Fusai
200542,2140.139424,15,4,0,11,4,1995,Clare Wood
200629,2140.136303,33,14,0,19,2,1991,Cristina Tessi
200082,2140.101746,23,8,0,15,3,1993,Kristie Boogert
200735,2140.068523,17,5,0,12,0,1997,Miho Saeki
202420,2140.060635,7,1,0,6,8,2015,An Sophie Mestach
200707,2139.97262,18,6,0,12,0,1994,Romana Tedjakusuma
200031,2139.92972,7,1,0,6,33,2008,Meilen Tu
201484,2139.890562,24,8,0,16,9,2010,Sandra Zahlavova
201571,2139.888088,5,0,0,5,38,2011,Masa Zec Peskiric
201308,2139.78786,11,3,0,8,12,2003,Maria Elena Camerin
201411,2139.769885,34,13,0,21,4,2007,Aiko Nakamura
201554,2139.719418,10,2,0,8,9,2015,Vitalia Diatchenko
200055,2139.712084,16,5,0,11,3,2004,Mariana Diaz Oliva
201363,2139.709728,41,17,0,24,5,2006,Gisela Dulko
202428,2139.698891,33,14,0,19,8,2013,Kiki Bertens
201305,2139.61484,22,7,0,15,4,2011,Eleni Daniilidou
201722,2139.555232,7,1,0,6,0,1990,Luanne Spadea
212257,2139.546256,5,0,0,5,26,2009,Eirdis Ragnarsdottir
201442,2139.536342,7,1,0,6,4,2014,Yung Jan Chan
200557,2139.467864,9,2,0,7,6,1994,Katrina Adams
200031,2139.465662,19,6,0,13,4,1997,Meilen Tu
200648,2139.355389,22,7,0,15,2,1994,Marketa Kochta
200650,2139.307245,5,0,0,5,36,1992,Isabel Cueto
201370,2139.226602,9,2,0,7,5,2013,Anastasia Rodionova
200675,2139.220638,25,9,0,16,4,1992,Eugenia Maniokova
201446,2139.068484,16,5,0,11,17,2011,Sybille Bammer
202681,2139.065822,5,0,0,5,12,2015,Gabriela Dabrowski
202489,2139.045823,30,12,0,18,3,2015,Carina Witthoeft
200057,2139.037913,9,2,0,7,21,1996,Erika De Lone
200729,2139.036588,25,9,0,16,3,2004,Lindsay Lee Waters
200127,2139.02503,18,5,0,13,23,2001,Sarah Pitkowski Malcor
210451,2138.990011,5,0,0,5,25,2008,Olga Terteac
201450,2138.981496,34,12,0,22,0,2013,Tsvetana Pironkova
201075,2138.975591,7,1,0,6,0,1998,Liezel Huber
201598,2138.947982,11,3,0,8,0,2012,Noppawan Lertcheewakarn
200099,2138.870844,9,2,0,7,4,1996,Sonya Jeyaseelan
200773,2138.816681,9,2,0,7,18,2009,Stephanie Foretz Gacon
200038,2138.767655,5,0,0,5,1,1999,Annabel Ellwood
201477,2138.754118,7,1,0,6,8,2010,Stephanie Dubois
200051,2138.734865,6,0,0,6,15,1992,Irina Spirlea
201470,2138.724922,6,0,0,6,7,2006,Kristina Barrois
201477,2138.716558,5,0,0,5,7,2013,Stephanie Dubois
201590,2138.689941,39,15,0,24,4,2015,Alison Riske
200602,2138.661838,7,1,0,6,22,1996,Shaun Stafford
200474,2138.604878,10,2,0,8,2,1991,Louise Allen
200660,2138.574437,17,4,0,13,3,1995,Kimberly Po Messerli
212385,2138.563189,5,0,0,5,25,1998,Stefania Stefansdottir
201557,2138.557561,5,0,0,5,7,2009,Corinna Dentoni
210171,2138.512525,5,0,0,5,41,2012,Saba Aziz
201615,2138.505666,23,9,0,14,5,2012,Lesia Tsurenko
200504,2138.488547,7,1,0,6,4,1990,Julie Salmon
201291,2138.476569,17,5,0,12,12,2007,Nuria Llagostera Vives
200025,2138.47135,11,3,0,8,7,2000,Ludmila Cervanova
200042,2138.431546,23,7,0,16,8,2004,Els Callens
202216,2138.416096,5,0,0,5,24,1999,Lilia Biktyakova
201371,2138.414379,35,12,0,23,1,2006,Vera Dushevina
201387,2138.210004,38,17,0,21,1,2006,Sofia Arvidsson
203623,2138.190983,14,4,0,10,33,1997,Robyn Mawdsley
201454,2138.19075,7,1,0,6,5,2006,Akgul Amanmuradova
212546,2138.184345,5,0,0,5,25,1997,Jennifer Carter
200708,2138.094715,9,2,0,7,28,1999,Sandra Cacic
202395,2138.088874,8,1,0,7,8,2015,Maria Irigoyen
200428,2138.049083,8,1,0,7,11,1997,Lori Mcneil
203898,2137.994801,5,0,0,5,35,1997,Tina Samara
201331,2137.988019,5,0,0,5,20,2014,Iveta Benesova
200068,2137.978933,5,0,0,5,15,1998,Lilia Osterloh
212384,2137.961386,5,0,0,5,25,1998,Rakel Petursdottir
200773,2137.886931,13,3,0,10,3,2004,Stephanie Foretz Gacon
212169,2137.841599,5,0,0,5,35,2003,Karina Jarlkaganova
200626,2137.772324,23,9,0,14,9,1994,Emanuela Zardo
201462,2137.739669,25,9,0,16,15,2012,Alberta Brianti
200654,2137.700085,7,1,0,6,10,1992,Patty Oreilly
200754,2137.637372,46,19,0,27,1,2006,Jill Craybas
200063,2137.63037,15,5,0,10,0,1997,Tatiana Panova
212353,2137.612313,5,0,0,5,34,1997,Senait Gebreail
200666,2137.582158,5,0,0,5,21,1999,Marion Maruska
210138,2137.573416,5,0,0,5,41,2012,Noelia Zeballos
212205,2137.562851,5,0,0,5,26,2009,Sandra Kristjansdottir
207291,2137.552026,5,0,0,5,34,1997,Iris Staub
200031,2137.544187,13,3,0,10,2,1995,Meilen Tu
201459,2137.544103,5,0,0,5,8,2009,Zi Yan
201306,2137.503495,18,5,0,13,5,2004,Marie Gaiane Mikaelian
201420,2137.390786,26,10,0,16,9,2011,Sania Mirza
201072,2137.384339,14,4,0,10,15,2002,Eva Bes Ostariz
200543,2137.375402,7,1,0,6,3,1990,Jill Hetherington
200535,2137.31874,9,2,0,7,14,1991,Jo Anne Faull
201512,2137.316608,35,12,0,23,3,2009,Monica Niculescu
201207,2137.31235,13,4,0,9,4,2003,Ansley Cargill
201605,2137.3072,5,0,0,5,3,2009,Mandy Minella
200704,2137.287421,10,2,0,8,11,1996,Maria Jose Gaidano
200022,2137.237624,17,5,0,12,3,1998,Emmanuelle Gagliardi
200111,2137.228902,15,4,0,11,9,2000,Lina Krasnoroutskaya
200046,2137.21867,5,0,0,5,24,2008,Meghann Shaughnessy
200036,2137.199754,28,10,0,18,10,2007,Nicole Pratt
201349,2137.172768,12,3,0,9,4,2007,Melinda Czink
212540,2137.103281,5,0,0,5,27,1996,Jeanine Baillie
201291,2137.099595,20,8,0,12,14,2001,Nuria Llagostera Vives
200696,2137.027655,5,0,0,5,23,1994,Christina Papadaki
200105,2136.9769,9,2,0,7,50,2002,Rachel Mcquillan
212744,2136.926314,5,0,0,5,45,2000,Dina Naffa
201212,2136.870924,26,9,0,17,4,2015,Francesca Schiavone
200640,2136.844478,13,3,0,10,1,1994,Mercedes Paz
200425,2136.828236,9,2,0,7,18,1993,Sophie Amiach
212093,2136.785148,5,0,0,5,45,2000,Yik Hui Leow
200121,2136.728412,10,2,0,8,1,2007,Alina Jidkova
200012,2136.715803,19,7,0,12,9,2002,Jana Nejedly
201344,2136.713287,25,8,0,17,15,2009,Klara Koukalova
201468,2136.709148,24,10,0,14,1,2007,Yaroslava Shvedova
200066,2136.697171,43,15,0,28,8,2002,Cristina Torrens Valero
200101,2136.662569,33,12,0,21,7,2001,Jana Kandarr
201347,2136.589164,17,5,0,12,4,2003,Jelena Jankovic
200063,2136.583436,20,7,0,13,26,2003,Tatiana Panova
202471,2136.57804,5,0,0,5,27,2012,Karen Barbat
201367,2136.497265,10,2,0,8,3,2009,Arantxa Parra Santonja
212687,2136.466644,5,0,0,5,56,1997,Nida Waseem
201468,2136.449517,19,6,0,13,5,2008,Yaroslava Shvedova
207551,2136.447246,5,0,0,5,52,2002,Anna Patricia Santos
200742,2136.402728,11,3,0,8,14,1998,Olga Lugina
202347,2136.264021,5,0,0,5,30,2005,Karolina Kosinska
200362,2136.195568,23,7,0,16,2,1993,Liz Smylie
201537,2136.179721,31,12,0,19,4,2009,Patricia Mayr Achleitner
201443,2136.164748,10,2,0,8,2,2012,Alexa Glatch
200495,2136.148909,18,5,0,13,28,1992,Akiko Kijimuta
212207,2136.14608,5,0,0,5,26,2006,Puleng Tlhophane
212362,2136.145282,5,0,0,5,32,1997,Elya Constanta
200075,2136.144722,13,3,0,10,0,1996,Jing Qian Yi
212163,2136.059728,5,0,0,5,27,2002,Sylma Phillip
200623,2136.057249,35,14,0,21,1,1992,Petra Thoren
212234,2136.035619,5,0,0,5,31,2007,Sahar Al Disi
212137,2136.035139,5,0,0,5,52,2000,Kago Phatshwane
200036,2136.027979,8,1,0,7,23,1991,Nicole Pratt
200053,2136.022791,22,7,0,15,8,2000,Lubomira Bacheva
212114,2136.014946,5,0,0,5,28,2001,Anais Marie Moreno
201514,2135.851989,36,13,0,23,4,2010,Sorana Cirstea
200022,2135.806461,14,4,0,10,4,2007,Emmanuelle Gagliardi
200641,2135.803382,7,1,0,6,22,1995,Patricia Tarabini
201610,2135.711239,47,20,0,27,5,2015,Zarina Diyas
200670,2135.696284,8,1,0,7,9,1991,Nathalie Housset Gilbert
200586,2135.61599,17,5,0,12,18,1993,Federica Bonsignori
212260,2135.606566,5,0,0,5,23,2011,Rosaline Zafir Chavez Tello
212342,2135.596472,5,0,0,5,25,1998,Seble Woldegebriel
200062,2135.5956,22,8,0,14,18,2006,Kristina Brandi
200530,2135.589545,32,12,0,20,3,1993,Radomira Zrubakova
204690,2135.566006,5,0,0,5,52,2002,Czarina Mae Arevalo
200094,2135.472918,29,10,0,19,4,1997,Barbara Rittner
201379,2135.466619,22,8,0,14,6,2004,Mara Santangelo
201452,2135.443637,19,6,0,13,9,2009,Lourdes Dominguez Lino
200708,2135.43351,21,9,0,12,11,1996,Sandra Cacic
201605,2135.395719,12,3,0,9,3,2011,Mandy Minella
202456,2135.37274,28,10,0,18,4,2012,Alexandra Cadantu
200450,2135.357629,34,12,0,22,2,1995,Larisa Savchenko
200682,2135.352356,21,7,0,14,11,1996,Joannette Kruger
200578,2135.277181,18,5,0,13,2,1993,Rennae Stubbs
201403,2135.199747,11,3,0,8,9,2012,Anna Chakvetadze
200723,2135.162701,18,5,0,13,10,1999,Iva Majoli
200671,2135.157303,28,10,0,18,1,1992,Meike Babel
200647,2135.065294,23,8,0,15,10,1991,Noelle Van Lottum
201527,2135.048557,37,14,0,23,3,2014,Stefanie Voegele
201375,2135.016386,12,3,0,9,18,2007,Shenay Perry
201444,2135.014406,38,13,0,25,2,2013,Su Wei Hsieh
200005,2135.006104,17,5,0,12,4,1997,Jolene Watanabe Giltz
200745,2134.97867,20,6,0,14,0,1996,Andrea Glass
201460,2134.972851,17,5,0,12,6,2008,Meng Yuan
206621,2134.930286,5,0,0,5,33,1997,Kelesitse Makgale
200472,2134.913306,16,5,0,11,10,1994,Helen Kelesi
200062,2134.872529,12,3,0,9,21,2002,Kristina Brandi
200767,2134.814398,21,6,0,15,5,2000,Holly Parkinson
201402,2134.798329,17,5,0,12,8,2012,Sesil Karatantcheva
200042,2134.786666,26,10,0,16,4,1997,Els Callens
201472,2134.775627,20,6,0,14,9,2011,Romina Oprandi
200589,2134.749316,5,0,0,5,7,1993,Halle Cioffi
200607,2134.743158,12,3,0,9,10,1991,Beate Reinstadler
200057,2134.739527,5,0,0,5,13,2001,Erika De Lone
200632,2134.731294,18,6,0,12,7,1994,Andrea Strnadova
202484,2134.703822,15,4,0,11,8,2015,Nicole Gibbs
200046,2134.594642,42,17,0,25,1,2005,Meghann Shaughnessy
212235,2134.51153,5,0,0,5,31,2007,Leen Irani
200725,2134.4811,25,9,0,16,11,1995,Sandra Cecchini
200676,2134.442878,17,6,0,11,0,1997,Mana Endo
200679,2134.425597,24,8,0,16,2,1994,Caroline Kuhlman
200711,2134.311774,16,5,0,11,2,1993,Tatiana Ignatieva
200773,2134.287713,19,5,0,14,1,2005,Stephanie Foretz Gacon
200005,2134.281813,25,9,0,16,1,1995,Jolene Watanabe Giltz
201293,2134.252905,33,12,0,21,1,2007,Catalina Castano
201547,2134.190051,17,5,0,12,9,2010,Michelle Larcher De Brito
201021,2134.162764,17,5,0,12,16,1992,Laura Garrone
201377,2134.147922,5,0,0,5,17,2013,Yuliya Beygelzimer
200647,2134.092021,11,2,0,9,0,1997,Noelle Van Lottum
201468,2134.080458,19,6,0,13,4,2011,Yaroslava Shvedova
204487,2134.072882,5,0,0,5,45,1998,Monika Mastalirova
201043,2134.03446,15,4,0,11,12,1990,Barbara Romano
200659,2134.03313,10,2,0,8,8,1994,Rika Hiraki
200587,2134.027614,19,6,0,13,8,1990,Silke Meier
201615,2133.958506,14,4,0,10,8,2011,Lesia Tsurenko
201318,2133.853953,12,3,0,9,4,2014,Bethanie Mattek Sands
201284,2133.816511,38,15,0,23,1,2002,Tatiana Poutchek
200068,2133.788469,13,3,0,10,12,2008,Lilia Osterloh
201533,2133.782393,6,0,0,6,6,2008,Shuai Zhang
200016,2133.76406,9,1,0,8,15,2004,Sandrine Testud
201586,2133.759104,29,12,0,17,2,2013,Heather Watson
201501,2133.701635,43,15,0,28,3,2010,Olga Govortsova
201517,2133.55524,35,12,0,23,4,2010,Magdalena Rybarikova
201310,2133.517703,44,16,0,28,2,2007,Martina Muller
201456,2133.433381,25,8,0,17,2,2008,Olga Savchuk
200099,2133.389528,8,1,0,7,3,1995,Sonya Jeyaseelan
200657,2133.318497,23,8,0,15,11,1995,Radka Bobkova
200588,2133.301094,20,6,0,14,0,1990,Renata Baranski
201523,2133.237622,21,7,0,14,9,2015,Marina Erakovic
200024,2133.221835,17,5,0,12,9,2006,Maria Vento Kabchi
201424,2133.194725,41,16,0,25,10,2012,Shahar Peer
201478,2133.110494,17,5,0,12,8,2009,Varvara Lepchenko
200542,2133.045717,16,4,0,12,11,1992,Clare Wood
200754,2132.986535,25,8,0,17,9,2001,Jill Craybas
200053,2132.938235,20,6,0,14,7,2001,Lubomira Bacheva
200442,2132.893344,26,8,0,18,2,1990,Andrea Temesvari
200567,2132.669367,12,3,0,9,13,1990,Jennifer Santrock
201286,2132.650607,45,19,0,26,5,2010,Anabel Medina Garrigues
200751,2132.608022,12,3,0,9,10,2006,Conchita Martinez Granados
200519,2132.563815,16,5,0,11,24,1992,Sybille Niox Chateau
200628,2132.553461,10,2,0,8,12,1990,Sabrina Goles
200050,2132.545468,18,5,0,13,3,2004,Sandra Kleinova
201527,2132.497952,24,7,0,17,3,2015,Stefanie Voegele
200090,2132.488867,16,4,0,12,12,2001,Anca Barna
200560,2132.4886,10,2,0,8,0,1990,Rene Collins
200691,2132.449583,18,6,0,12,10,1998,Flora Perfetti
200584,2132.438892,13,3,0,10,10,1999,Laura Golarsa
200696,2132.415217,19,7,0,12,10,1999,Christina Papadaki
201457,2132.382344,20,6,0,14,6,2007,Jarmila Gajdosova
201208,2132.21996,8,1,0,7,23,2001,Dawn Buth
200124,2132.20786,13,4,0,9,20,2008,Anne Kremer
200673,2132.094569,8,1,0,7,9,1992,Susan Sloane Lundy
200042,2131.990566,10,2,0,8,0,1998,Els Callens
200036,2131.920188,19,6,0,13,0,1998,Nicole Pratt
201431,2131.851602,29,8,0,21,2,2007,Aravane Rezai
200120,2131.768713,12,3,0,9,34,2012,Jelena Dokic
201588,2131.595522,6,0,0,6,8,2014,Anna Tatishvili
200749,2131.478816,10,2,0,8,10,1998,Samantha Reeves
201361,2131.450849,18,5,0,13,4,2004,Julia Schruff
201427,2131.394468,29,11,0,18,3,2011,Alize Cornet
200510,2131.301745,12,3,0,9,12,1993,Julie Richardson
200008,2131.262817,8,1,0,7,12,2008,Alicia Molik
201571,2131.250432,8,1,0,7,15,2010,Masa Zec Peskiric
201412,2131.176455,19,6,0,13,3,2011,Anastasia Yakimova
202461,2131.143117,12,3,0,9,13,2013,Julia Cohen
201485,2131.137821,18,5,0,13,4,2014,Alla Kudryavtseva
203575,2131.129211,18,6,0,12,3,2014,Danka Kovinic
200686,2130.944725,12,2,0,10,3,1993,Sandra Dopfer
200060,2130.900058,26,9,0,17,3,2010,Tathiana Garbin
200114,2130.880616,36,14,0,22,4,2000,Patricia Wartusch
200124,2130.813713,22,7,0,15,6,2005,Anne Kremer
201430,2130.702288,13,4,0,9,5,2007,Yulia Fedossova
200063,2130.66998,29,11,0,18,0,1998,Tatiana Panova
200443,2130.515684,16,5,0,11,11,1992,Sara Gomer
201437,2130.50363,15,4,0,11,7,2006,Ivana Lisjak
200659,2130.33954,18,6,0,12,5,1996,Rika Hiraki
200727,2130.267326,45,17,0,28,1,2002,Adriana Serra Zanetti
201204,2130.259274,5,0,0,5,5,2007,Iroda Tulyaganova
200377,2130.137801,29,8,0,21,1,1997,Helena Sukova
201375,2130.129067,11,2,0,9,8,2010,Shenay Perry
201295,2130.077928,14,4,0,10,3,2003,Wynne Prakusya
201308,2129.990776,19,5,0,14,3,2009,Maria Elena Camerin
201593,2129.98478,28,10,0,18,2,2013,Irina Camelia Begu
200376,2129.914095,12,3,0,9,7,2006,Katerina Bohmova
200056,2129.882281,30,11,0,19,4,2007,Jelena Kostanic Tosic
201366,2129.874168,23,8,0,15,2,2005,Barbora Zahlavova Strycova
200464,2129.871703,6,0,0,6,27,1992,Ann Henricksson
201408,2129.731735,6,0,0,6,10,2007,Jamea Jackson
201454,2129.728398,42,17,0,25,5,2008,Akgul Amanmuradova
200674,2129.689051,16,4,0,12,3,1993,Bettina Fulco Villella
201464,2129.666456,10,2,0,8,13,2006,Nathalie Vierin
201349,2129.62088,12,3,0,9,18,2013,Melinda Czink
202440,2129.606741,28,9,0,19,9,2014,Paula Ormaechea
200004,2129.532336,19,5,0,14,10,1998,Kerry Anne Guse
202492,2129.376297,6,0,0,6,2,2012,Qiang Wang
201308,2129.37275,27,9,0,18,7,2007,Maria Elena Camerin
200051,2129.180278,15,4,0,11,24,2000,Irina Spirlea
200416,2129.172802,16,4,0,12,2,1993,Robin White
200622,2129.126573,21,6,0,15,8,1992,Maya Kidowaki
200089,2128.956027,12,3,0,9,28,1991,Miriam Oremans
200357,2128.932091,10,2,0,8,3,1995,Rosalyn Nideffer
201381,2128.85318,11,2,0,9,8,2004,Tian Tian Sun
200777,2128.754038,20,7,0,13,12,2003,Marta Marrero
200666,2128.701375,18,5,0,13,14,1998,Marion Maruska
200105,2128.649607,35,13,0,22,7,1993,Rachel Mcquillan
200390,2128.593123,9,1,0,8,1,1992,Mary Lou Daniels
200657,2128.510545,6,0,0,6,16,1992,Radka Bobkova
200415,2128.469742,13,3,0,10,25,1992,Catherine Suire
200959,2128.410685,8,1,0,7,53,1992,Mareen Louie Harper
200714,2128.394948,8,1,0,7,21,1995,Yvette Basting
201486,2128.390141,28,9,0,19,1,2007,Aleksandra Wozniak
201697,2128.319834,13,3,0,10,3,2013,Kristyna Pliskova
200040,2128.264311,23,8,0,15,12,1995,Anna Smashnova
200557,2128.099347,21,6,0,15,1,1992,Katrina Adams
200109,2127.947693,15,4,0,11,18,2009,Nathalie Dechy
212548,2127.907332,6,0,0,6,26,1997,Wendy Brown
200522,2127.906648,15,4,0,11,10,1994,Nicole Krijger Jagerman
201542,2127.881324,10,2,0,8,7,2014,Olivia Rogowska
200117,2127.81358,27,7,0,20,5,2006,Kveta Peschke
201383,2127.607246,10,2,0,8,4,2002,Marie Eve Pelletier
201301,2127.604364,18,5,0,13,1,2005,Camille Pin
201503,2127.453777,34,11,0,23,4,2009,Ayumi Morita
201482,2127.343908,16,4,0,12,1,2007,Andreja Klepac
201331,2127.321859,28,11,0,17,10,2012,Iveta Benesova
212112,2127.289625,6,0,0,6,31,1998,Isoke Perry
200752,2127.278855,15,4,0,11,14,1999,Raluca Sandu
201394,2127.243044,20,6,0,14,14,2007,Anna Lena Groenefeld
201523,2127.235228,12,3,0,9,8,2010,Marina Erakovic
202428,2127.192897,28,10,0,18,4,2015,Kiki Bertens
201455,2127.16803,32,12,0,20,4,2008,Elena Vesnina
200063,2127.147821,23,8,0,15,1,2005,Tatiana Panova
200706,2127.134756,11,2,0,9,27,1994,Catalina Cristea
200013,2127.112579,8,1,0,7,4,1997,Angelica Gavaldon
201708,2127.08649,6,0,0,6,12,2001,Natalie Grandin
201209,2127.046595,18,5,0,13,22,2002,Selima Sfar
200085,2126.89528,32,10,0,22,6,2009,Ai Sugiyama
200035,2126.879908,29,9,0,20,7,2005,Maria Sanchez Lorenzo
212559,2126.852863,6,0,0,6,27,1996,Kim Simmons
201587,2126.76321,43,16,0,27,3,2011,Bojana Jovanovski
207919,2126.592572,6,0,0,6,36,2003,Celine Francois
200686,2126.526568,7,0,0,7,16,1995,Sandra Dopfer
201502,2126.388001,9,1,0,8,2,2008,Tatjana Malek
200606,2126.31122,16,4,0,12,8,1997,Nana Smith
201412,2126.231336,17,5,0,12,5,2007,Anastasia Yakimova
201503,2126.206909,32,12,0,20,4,2010,Ayumi Morita
201438,2126.190086,18,5,0,13,10,2007,Ekaterina Bychkova
201485,2126.095258,21,7,0,14,5,2007,Alla Kudryavtseva
200101,2126.089537,23,8,0,15,3,1998,Jana Kandarr
200656,2126.073814,10,2,0,8,11,1992,Jessica Emmons
203297,2125.865802,12,3,0,9,4,2014,Nadiya Kichenok
200514,2125.763142,32,13,0,19,2,1992,Monique Javer
200123,2125.74157,21,6,0,15,4,2000,Marlene Weingartner
200084,2125.668483,8,1,0,7,43,2003,Asa Svensson
200061,2125.662774,33,10,0,23,8,2002,Gala Leon Garcia
202492,2125.651478,19,5,0,14,4,2015,Qiang Wang
201284,2125.599345,20,7,0,13,7,2003,Tatiana Poutchek
212560,2125.57845,6,0,0,6,27,1996,Donna Bradshaw
200013,2125.548085,14,3,0,11,6,1996,Angelica Gavaldon
200506,2125.51878,27,9,0,18,5,1991,Wiltrud Probst
201485,2125.504808,10,2,0,8,4,2015,Alla Kudryavtseva
201709,2125.458781,28,10,0,18,4,2015,Yulia Putintseva
201578,2125.450461,9,1,0,8,7,2011,Kai Chen Chang
200722,2125.434989,21,6,0,15,14,1998,Francesca Lubiani
200384,2125.433049,15,3,0,12,2,1990,Eva Pfaff
200346,2125.422815,6,0,0,6,58,1992,Anne Minter
201323,2125.354789,21,6,0,15,1,2002,Saori Obata
201438,2125.353716,17,5,0,12,10,2008,Ekaterina Bychkova
201616,2125.351472,35,13,0,22,4,2015,Lauren Davis
200729,2125.346707,6,0,0,6,20,2003,Lindsay Lee Waters
201356,2125.330056,10,2,0,8,8,2004,Eva Birnerova
200584,2125.266844,10,2,0,8,0,1996,Laura Golarsa
201066,2125.157134,10,2,0,8,18,1995,Neus Avila Bonastre
200576,2125.134239,22,6,0,16,1,1992,Nathalie Herreman
200648,2125.128277,20,6,0,14,1,1992,Marketa Kochta
201478,2125.122252,12,2,0,10,12,2007,Varvara Lepchenko
200727,2125.075276,22,7,0,15,4,2003,Adriana Serra Zanetti
200024,2125.018372,24,7,0,17,1,1999,Maria Vento Kabchi
201417,2124.932492,35,12,0,23,4,2006,Marta Domachowska
200675,2124.907899,19,6,0,13,9,1994,Eugenia Maniokova
201666,2124.860308,10,2,0,8,14,2015,Cagla Buyukakcay
200125,2124.779319,16,5,0,11,34,2001,Corina Morariu
200056,2124.750236,36,13,0,23,1,2005,Jelena Kostanic Tosic
200442,2124.665698,20,6,0,14,5,1991,Andrea Temesvari
201441,2124.533361,37,13,0,24,4,2006,Emma Laine
200599,2124.521917,11,2,0,9,29,1993,Carrie Cunningham
212110,2124.51956,6,0,0,6,25,1997,Niki Williams
200695,2124.406423,14,4,0,10,0,1996,Tina Krizan
200419,2124.328908,22,7,0,15,9,1991,Kathy Rinaldi Stunkel
200570,2124.293062,19,6,0,13,3,1993,Veronika Martinek
200485,2124.194058,18,5,0,13,2,1994,Manon Bollegraf
200745,2124.191698,15,3,0,12,6,2000,Andrea Glass
201395,2124.086206,11,2,0,9,3,2004,Teryn Ashley
200698,2123.966646,20,6,0,14,11,1997,Petra Begerow
201502,2123.924742,25,8,0,17,13,2010,Tatjana Malek
201083,2123.915726,22,6,0,16,12,2003,Daja Bedanova
200119,2123.897512,15,4,0,11,25,2002,Rita Kuti Kis
200602,2123.856275,23,6,0,17,2,1990,Shaun Stafford
200473,2123.813488,17,5,0,12,5,1990,Beverly Bowes Hackney
200078,2123.774059,6,0,0,6,24,2000,Barbara Schwartz
200506,2123.731392,11,2,0,9,22,1998,Wiltrud Probst
200497,2123.727377,9,1,0,8,19,1998,Patricia Hy Boulais
200723,2123.508529,24,7,0,17,12,2003,Iva Majoli
200610,2123.490669,23,8,0,15,13,1991,Stacey Martin
201493,2123.453775,22,7,0,15,13,2008,Angelique Kerber
201361,2123.398099,19,6,0,13,5,2007,Julia Schruff
200090,2123.372487,44,16,0,28,3,2004,Anca Barna
200028,2123.299794,13,3,0,10,2,1993,Maureen Drake
201370,2123.272783,31,8,0,23,4,2011,Anastasia Rodionova
200634,2123.171149,18,5,0,13,9,1994,Elena Brioukhovets
200045,2123.111518,6,0,0,6,22,2004,Tara Snyder
200495,2123.071129,13,3,0,10,13,1990,Akiko Kijimuta
201298,2122.814856,26,9,0,17,1,2002,Zsofia Gubacsi
200583,2122.767608,11,2,0,9,1,1996,Laxmi Poruri
201567,2122.70279,8,1,0,7,36,2012,Alexandra Dulgheru
200476,2122.693333,11,2,0,9,7,1993,Cammy Macgregor
200439,2122.54315,19,5,0,14,13,1993,Jenny Byrne
200574,2122.49253,20,5,0,15,10,1992,Eva Sviglerova
201383,2122.462703,6,0,0,6,4,2003,Marie Eve Pelletier
201440,2122.263983,20,6,0,14,15,2006,Laura Pous Tio
200011,2122.218513,30,11,0,19,4,2000,Katarina Srebotnik
200687,2122.207764,17,4,0,13,10,1996,Katarzyna Nowak
201388,2122.181034,10,2,0,8,4,2010,Sophie Ferguson
201296,2122.109734,17,4,0,13,21,2002,Bianka Lamade
200587,2121.853305,12,2,0,10,5,1996,Silke Meier
200052,2121.849487,6,0,0,6,40,2001,Olga Barabanschikova
200735,2121.826934,21,7,0,14,7,1999,Miho Saeki
201549,2121.817625,22,7,0,15,9,2010,Petra Martic
201454,2121.737927,16,4,0,12,9,2012,Akgul Amanmuradova
201426,2121.72622,18,5,0,13,3,2011,Pauline Parmentier
201379,2121.710773,11,2,0,9,19,2009,Mara Santangelo
201379,2121.674539,12,2,0,10,5,2008,Mara Santangelo
201389,2121.543389,7,0,0,7,7,2010,Zuzana Kucova
201459,2121.455644,22,7,0,15,6,2008,Zi Yan
201697,2121.45297,13,3,0,10,7,2014,Kristyna Pliskova
200608,2121.378573,16,4,0,12,12,1995,Audra Keller
200561,2121.161758,16,4,0,12,11,1991,Cathy Caverzasio
201528,2120.98352,14,3,0,11,7,2013,Melanie Oudin
200587,2120.934093,22,6,0,16,2,1993,Silke Meier
201360,2120.799058,28,10,0,18,11,2004,Julia Vakulenko
201549,2120.780821,11,2,0,9,7,2014,Petra Martic
201348,2120.729123,9,1,0,8,5,2013,Casey Dellacqua
202427,2120.655654,13,3,0,10,8,2014,Johanna Konta
201391,2120.34954,18,5,0,13,7,2005,Sanda Mamic
200661,2120.320622,16,4,0,12,22,1999,Samantha Smith
200474,2120.171441,11,2,0,9,15,1990,Louise Allen
200732,2120.069844,18,5,0,13,3,1996,Magdalena Grzybowska
201343,2119.985006,29,10,0,19,7,2006,Maret Ani
201448,2119.966462,13,2,0,11,1,2006,Galina Voskoboeva
200035,2119.849814,15,4,0,11,9,1996,Maria Sanchez Lorenzo
201451,2119.719528,7,0,0,7,3,2010,Kathrin Woerle
200083,2119.712491,40,13,0,27,0,2003,Alexandra Stevenson
200708,2119.5915,23,7,0,16,1,1998,Sandra Cacic
201442,2119.52881,22,6,0,16,7,2010,Yung Jan Chan
200012,2119.330829,14,3,0,11,4,1996,Jana Nejedly
200071,2119.255505,19,6,0,13,10,1998,Lenka Nemeckova
200606,2119.183584,25,9,0,16,13,1990,Nana Smith
200669,2119.116559,16,4,0,12,19,1995,Debbie Graham
201291,2119.094281,9,1,0,8,24,2002,Nuria Llagostera Vives
200554,2119.057775,13,3,0,10,22,1998,Brenda Schultz Mccarthy
201392,2118.900472,28,9,0,19,1,2005,Severine Beltrame
200015,2118.834483,16,4,0,12,8,2000,Petra Mandula
200019,2118.834147,12,2,0,10,9,2001,Alexandra Fusai
201532,2118.323793,11,2,0,9,4,2011,Anastasia Pivovarova
200624,2118.292718,13,2,0,11,11,1997,Tami Whitlinger Jones
200745,2118.1547,15,3,0,12,4,1997,Andrea Glass
200623,2118.091977,14,3,0,11,0,1990,Petra Thoren
200717,2117.837905,16,3,0,13,4,1997,Anne Miller
201385,2117.810288,11,2,0,9,2,2008,Yuliana Fedak
200704,2117.753813,18,4,0,14,10,1994,Maria Jose Gaidano
200103,2117.664745,19,5,0,14,7,2002,Evie Dominikovic
200476,2117.598466,24,8,0,16,5,1990,Cammy Macgregor
201365,2117.575508,11,2,0,9,21,2011,Edina Gallovits Hall
200107,2117.551699,22,6,0,16,11,1997,Paola Suarez
200665,2117.543867,15,3,0,12,9,1996,Yone Kamio
201387,2117.537696,28,8,0,20,2,2013,Sofia Arvidsson
200384,2117.489879,11,1,0,10,5,1991,Eva Pfaff
200055,2117.483478,19,6,0,13,10,1998,Mariana Diaz Oliva
202276,2117.4516,9,1,0,8,10,1997,Shelley Bryce
200691,2117.421827,9,1,0,8,18,1993,Flora Perfetti
200022,2117.403127,24,7,0,17,3,2006,Emmanuelle Gagliardi
200632,2117.275868,28,8,0,20,4,1993,Andrea Strnadova
200066,2117.264616,31,11,0,20,10,1998,Cristina Torrens Valero
200083,2117.236342,7,0,0,7,11,2004,Alexandra Stevenson
201052,2117.025902,10,1,0,9,0,1990,Federica Haumuller
200706,2116.992256,15,4,0,11,14,2000,Catalina Cristea
200009,2116.863208,27,9,0,18,4,2005,Tamarine Tanasugarn
200031,2116.777426,14,3,0,11,7,1999,Meilen Tu
202479,2116.775502,9,1,0,8,8,2013,Grace Min
200542,2116.624479,9,1,0,8,15,1996,Clare Wood
201527,2116.581599,31,9,0,22,4,2010,Stefanie Voegele
200605,2116.436874,14,3,0,11,25,1992,Regina Rajchrtova
200614,2116.404427,7,0,0,7,15,1992,Elena Pampoulova
200685,2116.373252,12,2,0,10,22,1993,Christelle Fauche
200050,2116.363196,23,6,0,17,4,2000,Sandra Kleinova
200068,2116.31175,11,2,0,9,13,2005,Lilia Osterloh
201360,2116.215366,15,3,0,12,9,2008,Julia Vakulenko
201450,2116.189459,32,11,0,21,3,2009,Tsvetana Pironkova
200087,2116.118934,19,5,0,14,22,2000,Seda Noorlander
201537,2116.005698,33,12,0,21,3,2014,Patricia Mayr Achleitner
200740,2115.917428,28,8,0,20,4,1999,Elena Tatarkova
201484,2115.716773,16,4,0,12,17,2011,Sandra Zahlavova
201414,2115.538702,16,3,0,13,17,2008,Michaella Krajicek
201061,2115.475008,13,3,0,10,8,1994,Eva Martincova
200439,2115.425982,16,4,0,12,13,1994,Jenny Byrne
200642,2115.300743,14,3,0,11,16,1992,Denisa Szabova
200403,2115.180177,21,6,0,15,2,1990,Andrea Leand
200021,2115.145579,21,6,0,15,12,1995,Alexia Dechaume Balleret
201489,2115.065913,25,7,0,18,9,2009,Mariya Koryttseva
201284,2115.045163,25,7,0,18,5,2007,Tatiana Poutchek
200038,2115.041704,11,2,0,9,6,1996,Annabel Ellwood
201426,2114.946791,11,2,0,9,17,2015,Pauline Parmentier
200510,2114.946026,10,1,0,9,8,1992,Julie Richardson
201086,2114.873392,23,7,0,16,2,2012,Greta Arn
200749,2114.829329,15,3,0,12,16,2004,Samantha Reeves
201370,2114.555156,28,8,0,20,7,2008,Anastasia Rodionova
200022,2114.496894,27,8,0,19,8,2004,Emmanuelle Gagliardi
200727,2114.47134,9,1,0,8,6,2004,Adriana Serra Zanetti
200014,2114.339263,19,5,0,14,12,2008,Tzipi Obziler
201603,2114.319342,18,4,0,14,8,2015,Shelby Rogers
200487,2114.296575,11,2,0,9,12,1990,Eva Krapl
200012,2114.284531,18,5,0,13,2,1999,Jana Nejedly
200659,2114.130532,25,9,0,16,0,1997,Rika Hiraki
201305,2114.041175,13,3,0,10,7,2013,Eleni Daniilidou
201501,2114.030616,31,12,0,19,4,2011,Olga Govortsova
201470,2113.910846,7,0,0,7,25,2012,Kristina Barrois
200010,2113.835314,37,13,0,24,2,1998,Rita Grande
201453,2113.653629,11,2,0,9,5,2007,Hana Sromova
200728,2113.548642,16,4,0,12,5,1996,Melanie Schnell
201396,2113.53728,10,1,0,9,4,2009,Katie Obrien
201387,2113.508094,12,2,0,10,8,2009,Sofia Arvidsson
201533,2113.289248,16,4,0,12,5,2015,Shuai Zhang
200126,2113.174483,14,3,0,11,4,2003,Marissa Gould
201473,2112.953722,23,8,0,15,18,2007,Vasilisa Bardina
201361,2112.951954,43,18,0,25,4,2006,Julia Schruff
201417,2112.871969,8,0,0,8,13,2010,Marta Domachowska
201472,2112.770089,19,5,0,14,20,2007,Romina Oprandi
201396,2112.7384,13,3,0,10,7,2010,Katie Obrien
200491,2112.494433,21,6,0,15,0,1996,Christina Singer
200101,2112.429101,10,1,0,9,10,1999,Jana Kandarr
200777,2112.220862,18,4,0,14,17,2005,Marta Marrero
201524,2112.071881,16,3,0,13,8,2014,Urszula Radwanska
201312,2112.01524,19,5,0,14,4,2003,Sarah Taylor
200404,2111.953838,11,1,0,10,1,1996,Zina Garrison
204717,2111.923409,10,1,0,9,33,1997,Lana Scardigno
201457,2111.804416,33,12,0,21,4,2015,Jarmila Gajdosova
201549,2111.637514,8,0,0,8,6,2015,Petra Martic
207154,2111.511342,9,1,0,8,33,1997,Sarah Stanley
200566,2111.435376,31,11,0,20,1,1992,Donna Faber
200007,2111.069006,28,9,0,19,5,2001,Silvija Talaja
201054,2110.93795,12,2,0,10,15,1992,Katia Piccolini
200448,2110.915168,10,1,0,9,3,1990,Sandy Collins
200727,2110.828916,21,5,0,16,5,1996,Adriana Serra Zanetti
200623,2110.809679,17,4,0,13,18,1993,Petra Thoren
201690,2110.769201,19,5,0,14,14,2013,Nina Bratchikova
201438,2110.637154,30,9,0,21,4,2006,Ekaterina Bychkova
200104,2110.510554,20,5,0,15,10,2008,Emilie Loit
201339,2110.42406,14,3,0,11,22,2011,Renata Voracova
201494,2110.288372,21,5,0,16,15,2010,Raluca Olaru
200559,2110.276537,17,4,0,13,6,1995,Kristine Kunce
200716,2110.200053,12,2,0,10,0,1997,Sung Hee Park
201292,2110.085095,19,4,0,15,4,2003,Martina Sucha
201409,2109.98041,22,6,0,16,1,2005,Michaela Pastikova
200692,2109.937499,15,3,0,12,10,1994,Marzia Grossi
200754,2109.922289,33,12,0,21,3,2004,Jill Craybas
201310,2109.812164,24,7,0,17,11,2008,Martina Muller
201376,2109.726329,19,5,0,14,1,2005,Angela Haynes
200770,2109.671593,24,7,0,17,11,2004,Stephanie Cohen Aloro
201551,2109.669934,18,4,0,14,14,2013,Arantxa Rus
201416,2109.586233,18,4,0,14,3,2011,Alona Bondarenko
200608,2109.492442,17,4,0,13,2,1994,Audra Keller
200686,2109.422709,12,2,0,10,11,1997,Sandra Dopfer
201344,2109.296494,33,11,0,22,4,2006,Klara Koukalova
200648,2109.23786,14,3,0,11,5,1995,Marketa Kochta
201565,2109.126475,16,4,0,12,7,2014,Katarzyna Piter
200057,2108.90673,25,7,0,18,5,2000,Erika De Lone
200697,2108.776431,25,7,0,18,12,2003,Janette Husarova
200640,2108.566798,13,2,0,11,3,1993,Mercedes Paz
201369,2108.560828,7,0,0,7,4,2009,Carly Gullickson
201600,2108.387564,10,1,0,9,8,2011,Jamie Hampton
200729,2108.376304,22,6,0,16,4,1996,Lindsay Lee Waters
200713,2108.286792,27,9,0,18,0,1998,Yuka Yoshida
200121,2108.242269,23,8,0,15,5,2002,Alina Jidkova
201367,2108.213683,10,1,0,9,7,2006,Arantxa Parra Santonja
201331,2107.951029,22,6,0,16,7,2007,Iveta Benesova
200625,2107.732255,17,4,0,13,11,1990,Jana Pospisilova
201381,2107.700193,22,5,0,17,6,2007,Tian Tian Sun
200099,2107.623525,18,4,0,14,12,2001,Sonya Jeyaseelan
201447,2107.377986,28,7,0,21,1,2008,Vania King
200661,2107.204855,14,3,0,11,10,1991,Samantha Smith
200120,2107.136485,26,9,0,17,9,2004,Jelena Dokic
201396,2106.559705,14,3,0,11,5,2008,Katie Obrien
200647,2106.549452,10,1,0,9,22,1995,Noelle Van Lottum
200745,2106.476294,26,8,0,18,3,1998,Andrea Glass
201646,2106.28703,11,1,0,10,8,2013,Maria Joao Koehler
200057,2106.24025,10,1,0,9,1,1994,Erika De Lone
200087,2106.061935,13,2,0,11,21,2002,Seda Noorlander
200044,2106.049197,25,7,0,18,10,2005,Denisa Chladkova
200746,2105.921849,18,4,0,14,10,2007,Sandra Kloesel
200054,2105.897236,21,5,0,16,22,2001,Sylvia Plischke
201300,2105.829181,8,0,0,8,12,2003,Maria Emilia Salerni
200025,2105.821075,22,7,0,15,13,2005,Ludmila Cervanova
201454,2105.50222,23,6,0,17,7,2011,Akgul Amanmuradova
200010,2105.3233,41,14,0,27,4,2003,Rita Grande
200739,2105.319575,15,3,0,12,15,1997,Stephanie De Ville
201356,2105.241097,19,5,0,14,14,2007,Eva Birnerova
201085,2104.91921,33,10,0,23,10,2001,Shinobu Asagoe
200095,2104.778476,17,3,0,14,11,1997,Linda Wild
200520,2104.445749,15,3,0,12,10,1991,Sarah Loosemore
200570,2104.043463,17,4,0,13,0,1996,Veronika Martinek
201303,2103.903067,30,9,0,21,4,2012,Anne Keothavong
200677,2103.86116,9,0,0,9,24,1992,Katja Oeljeklaus
201459,2103.739518,22,6,0,16,4,2006,Zi Yan
200639,2103.618155,17,4,0,13,2,1991,Claudine Toleafoa
201479,2103.573886,35,11,0,24,1,2007,Olga Puchkova
200582,2103.017266,25,8,0,17,3,1995,Maria Strandlund Tomsvik
200123,2102.92131,14,3,0,11,17,2005,Marlene Weingartner
201460,2102.855576,20,5,0,15,4,2006,Meng Yuan
200070,2102.726111,28,9,0,19,14,2001,Anne Gaelle Sidot
201504,2102.68222,43,16,0,27,3,2013,Julia Goerges
201477,2102.650425,15,3,0,12,9,2012,Stephanie Dubois
200690,2102.649854,19,4,0,15,0,1996,Kyoko Nagatsuka
200101,2102.636943,25,8,0,17,8,1997,Jana Kandarr
201331,2102.334923,30,9,0,21,4,2003,Iveta Benesova
200535,2102.300048,19,4,0,15,10,1990,Jo Anne Faull
201394,2102.00067,26,7,0,19,4,2004,Anna Lena Groenefeld
200059,2101.913605,26,9,0,17,18,2001,Ruxandra Dragomir Ilie
201462,2101.889645,29,9,0,20,4,2010,Alberta Brianti
200392,2101.841179,18,4,0,14,4,1993,Jo Durie
200123,2101.741825,29,9,0,20,1,2002,Marlene Weingartner
200737,2101.541351,11,1,0,10,8,1997,Aleksandra Olsza
200769,2101.525304,13,2,0,11,22,2001,Giulia Casoni
200593,2101.50874,19,4,0,15,2,1994,Karine Quentrec
201615,2101.482171,33,11,0,22,2,2013,Lesia Tsurenko
201209,2101.421933,12,2,0,10,7,2005,Selima Sfar
200584,2101.366672,16,3,0,13,9,1991,Laura Golarsa
201346,2101.301058,15,3,0,12,1,2005,Lubomira Kurhajcova
200646,2101.246117,13,2,0,11,12,1991,Francesca Romano
201321,2100.88002,33,11,0,22,4,2003,Antonella Serra Zanetti
200088,2100.401559,25,8,0,17,8,1997,Adriana Gersi
200674,2100.094991,27,8,0,19,0,1990,Bettina Fulco Villella
200002,2099.971991,14,2,0,12,16,2000,Mirjana Lucic
200066,2099.950495,24,7,0,17,12,2003,Cristina Torrens Valero
200047,2099.916903,31,9,0,22,5,2001,Pavlina Nola
201054,2099.804523,8,0,0,8,18,1993,Katia Piccolini
200701,2099.662654,16,3,0,13,3,1994,Caroline Vis
201380,2099.657795,22,6,0,16,7,2005,Claudine Schaul
201556,2099.497229,25,6,0,19,3,2010,Lucie Hradecka
201526,2099.472924,20,5,0,15,3,2009,Julie Coin
200500,2099.2101,11,1,0,10,23,1991,Pilar Vasquez
201040,2099.1506,13,2,0,11,0,1991,Luciana Corsato Owsianka
201371,2098.824337,20,5,0,15,4,2012,Vera Dushevina
200663,2098.52312,18,4,0,14,9,1995,Nanne Dahlman
202453,2098.200864,32,9,0,23,1,2015,Saisai Zheng
200607,2098.198976,9,0,0,9,22,1996,Beate Reinstadler
200031,2098.03386,18,4,0,14,4,2003,Meilen Tu
201479,2097.974784,25,7,0,18,5,2013,Olga Puchkova
201085,2097.698754,19,4,0,15,10,2006,Shinobu Asagoe
200088,2097.341391,11,1,0,10,12,2002,Adriana Gersi
201412,2097.2676,12,1,0,11,18,2012,Anastasia Yakimova
200089,2097.030093,31,9,0,22,4,1999,Miriam Oremans
200668,2096.549808,9,0,0,9,19,1995,Silke Frankl
200773,2096.254391,19,5,0,14,10,2006,Stephanie Foretz Gacon
200745,2096.161034,25,7,0,18,7,2001,Andrea Glass
200105,2096.135326,16,3,0,13,15,1996,Rachel Mcquillan
201305,2096.066239,29,8,0,21,5,2012,Eleni Daniilidou
201457,2096.062196,29,9,0,20,8,2012,Jarmila Gajdosova
200569,2095.981537,18,4,0,14,11,1997,Petra Pichalova Langrova
201310,2095.808669,13,2,0,11,23,2003,Martina Muller
203533,2095.308312,22,5,0,17,4,2014,Anna Karolina Schmiedlova
200566,2094.927919,11,1,0,10,3,1993,Donna Faber
201588,2094.770223,22,4,0,18,7,2013,Anna Tatishvili
200614,2094.544444,10,0,0,10,12,1995,Elena Pampoulova
201333,2094.390189,19,4,0,15,12,2003,Angelika Roesch
201412,2094.310903,12,1,0,11,2,2005,Anastasia Yakimova
201426,2094.058548,22,6,0,16,8,2010,Pauline Parmentier
201300,2093.41485,18,3,0,15,1,2005,Maria Emilia Salerni
200038,2093.043701,31,10,0,21,0,1997,Annabel Ellwood
201303,2092.983673,11,1,0,10,5,2006,Anne Keothavong
200573,2092.899482,26,7,0,19,10,1991,Cecilia Dahlman
201531,2092.348922,14,2,0,12,15,2009,Mariana Duque Marino
200068,2092.070137,25,7,0,18,10,2002,Lilia Osterloh
200627,2091.966133,18,4,0,14,7,1992,Petra Schwarz
201562,2091.697081,19,3,0,16,16,2015,Silvia Soler Espinosa
200578,2091.442035,22,5,0,17,2,1996,Rennae Stubbs
200444,2091.034439,26,7,0,19,3,1990,Elise Burgin
201411,2090.674304,26,6,0,20,5,2008,Aiko Nakamura
200606,2090.07006,12,1,0,11,7,1993,Nana Smith
200106,2089.804821,30,9,0,21,12,2002,Angeles Montolio
201047,2089.665485,17,3,0,14,0,1990,Andrea Vieira
200689,2089.503883,12,1,0,11,7,1993,Tessa Price
200485,2089.435687,22,5,0,17,2,1993,Manon Bollegraf
200608,2089.036555,18,3,0,15,1,1992,Audra Keller
201309,2088.61551,17,3,0,14,19,2005,Tatiana Perebiynis
201401,2088.475187,23,6,0,17,1,2005,Abigail Spears
200557,2087.500977,12,1,0,11,3,1990,Katrina Adams
201510,2086.848761,18,3,0,15,1,2008,Julie Ditty
200441,2086.512539,17,3,0,14,15,1991,Louise Field
200579,2085.722632,13,1,0,12,15,1997,Karin Kschwendt
201078,2085.608764,14,2,0,12,7,2003,Eugenia Kulikovskaya
200455,2085.601296,14,1,0,13,3,1995,Katerina Maleeva
200588,2085.501808,19,4,0,15,0,1991,Renata Baranski
200083,2084.547649,33,9,0,24,5,2000,Alexandra Stevenson
200754,2084.389123,39,12,0,27,1,2007,Jill Craybas
202498,2083.14551,19,3,0,16,7,2014,Julia Glushko
200121,2082.176718,18,3,0,15,7,2000,Alina Jidkova
200046,2081.930346,32,10,0,22,2,1999,Meghann Shaughnessy
200709,2081.673143,18,3,0,15,10,2003,Rosana De Los Rios
201323,2081.294939,28,8,0,20,7,2004,Saori Obata
201334,2080.546712,12,1,0,11,19,2011,Zuzana Ondraskova
201324,2079.824834,13,1,0,12,10,2002,Irina Selyutina
201426,2079.432576,13,1,0,12,16,2013,Pauline Parmentier
200474,2079.207523,16,2,0,14,2,1993,Louise Allen
201392,2077.715776,33,8,0,25,1,2007,Severine Beltrame
200617,2077.255049,31,7,0,24,3,2011,Kimiko Date Krumm
200122,2076.952776,35,9,0,26,3,2004,Tina Pisnik
200754,2075.730876,26,6,0,20,4,2011,Jill Craybas
201533,2075.457245,30,8,0,22,4,2011,Shuai Zhang
201385,2075.057128,23,5,0,18,5,2005,Yuliana Fedak
200019,2074.548213,19,3,0,16,20,1999,Alexandra Fusai
200121,2072.824331,32,7,0,25,5,2005,Alina Jidkova
201462,2072.699405,18,3,0,15,5,2007,Alberta Brianti
200072,2070.330257,27,6,0,21,6,2004,Cara Black
200055,2069.555897,28,6,0,22,4,2006,Mariana Diaz Oliva
200105,2067.224254,20,3,0,17,10,1998,Rachel Mcquillan
200044,2066.363129,23,4,0,19,0,1998,Denisa Chladkova
200104,2063.912028,18,3,0,15,0,1999,Emilie Loit
201528,2063.547597,32,8,0,24,8,2011,Melanie Oudin
201349,2062.954401,19,3,0,16,18,2010,Melinda Czink
201321,2062.837406,20,3,0,17,15,2006,Antonella Serra Zanetti
200093,2062.4126,21,4,0,17,14,2000,Amelie Cocheteux
202456,2061.205611,20,3,0,17,14,2014,Alexandra Cadantu
201526,2060.93082,20,3,0,17,4,2010,Julie Coin
200766,2056.912894,27,6,0,21,9,2002,Jennifer Hopkins
200442,2056.460613,23,4,0,19,2,1993,Andrea Temesvari
201481,2052.210715,19,2,0,17,7,2013,Tamira Paszek
201349,2046.103566,21,3,0,18,11,2004,Melinda Czink
200050,2043.363831,23,3,0,20,0,1998,Sandra Kleinova