.id,Player,Rating,Games,Win,Draw,Loss,Lag,name
2006,103819,2695.419131,97,92,0,5,1,Roger Federer
2015,104925,2688.979291,89,83,0,6,2,Novak Djokovic
1985,100656,2668.397683,91,84,0,7,0,Ivan Lendl
2013,104925,2661.524692,83,74,0,9,0,Novak Djokovic
2005,103819,2646.325834,85,81,0,4,1,Roger Federer
1987,100656,2639.885305,77,70,0,7,1,Ivan Lendl
2012,104925,2635.679675,87,75,0,12,2,Novak Djokovic
2014,104925,2635.325589,73,65,0,8,1,Novak Djokovic
2004,103819,2630.424053,81,75,0,6,1,Roger Federer
1986,100656,2622.474589,81,75,0,6,1,Ivan Lendl
2013,104745,2620.964098,83,76,0,7,2,Rafael Nadal
2010,103819,2615.136216,79,66,0,13,1,Roger Federer
1989,100656,2615.032854,87,80,0,7,1,Ivan Lendl
1986,101414,2601.810807,82,69,0,13,1,Boris Becker
1987,101222,2600.789221,90,78,0,12,1,Stefan Edberg
2007,103819,2600.081221,78,69,0,9,1,Roger Federer
1989,101414,2599.293358,73,65,0,8,0,Boris Becker
2011,103819,2598.37154,76,64,0,12,1,Roger Federer
2005,104745,2597.480232,89,79,0,10,4,Rafael Nadal
2008,104745,2596.474663,93,82,0,11,2,Rafael Nadal
2009,104925,2595.667373,97,78,0,19,1,Novak Djokovic
2015,103819,2591.645953,74,63,0,11,2,Roger Federer
2014,103819,2584.317332,87,74,0,13,0,Roger Federer
2010,104745,2569.680149,81,71,0,10,1,Rafael Nadal
1994,101948,2568.000151,90,78,0,12,0,Pete Sampras
2012,103819,2565.30041,87,74,0,13,2,Roger Federer
1993,101948,2561.437803,101,85,0,16,0,Pete Sampras
1990,101414,2560.277738,79,66,0,13,2,Boris Becker
1995,101736,2557.936025,82,73,0,9,5,Andre Agassi
1988,101414,2557.547473,65,56,0,9,0,Boris Becker
2011,104925,2556.237157,79,72,0,7,1,Novak Djokovic
1996,101948,2555.668615,78,66,0,12,2,Pete Sampras
2012,103970,2553.917532,91,76,0,15,1,David Ferrer
2011,104918,2552.842438,71,58,0,13,1,Andy Murray
2015,104918,2550.772957,86,71,0,15,0,Andy Murray
1994,101736,2549.89775,66,52,0,14,0,Andre Agassi
2008,104918,2548.204975,75,58,0,17,1,Andy Murray
1990,101222,2542.802466,75,63,0,12,0,Stefan Edberg
2003,103819,2541.578323,96,79,0,17,1,Roger Federer
1985,100581,2541.574967,82,72,0,10,0,John Mcenroe
1997,101948,2540.572945,69,57,0,12,0,Pete Sampras
1995,101948,2539.182304,89,72,0,17,0,Pete Sampras
1993,101529,2538.93878,98,76,0,22,0,Michael Stich
2001,103720,2537.939852,96,79,0,17,0,Lleyton Hewitt
2009,104918,2536.931793,78,66,0,12,1,Andy Murray
1985,101414,2535.843893,76,57,0,19,0,Boris Becker
2009,103819,2535.436428,73,61,0,12,1,Roger Federer
1999,101736,2533.552437,77,63,0,14,1,Andre Agassi
1989,101222,2532.52091,81,64,0,17,0,Stefan Edberg
1992,101948,2531.112158,91,72,0,19,0,Pete Sampras
2011,104745,2528.483213,85,70,0,15,0,Rafael Nadal
1991,101222,2524.443404,93,76,0,17,4,Stefan Edberg
1992,101414,2517.587349,68,52,0,16,2,Boris Becker
2010,104925,2517.335739,81,63,0,18,0,Novak Djokovic
2008,103819,2516.636055,83,67,0,16,1,Roger Federer
2007,104745,2515.934512,86,71,0,15,1,Rafael Nadal
2012,105223,2512.969494,82,65,0,17,2,Juan Martin Del Potro
1992,101964,2512.591442,80,61,0,19,0,Goran Ivanisevic
2012,104918,2511.535778,76,59,0,17,2,Andy Murray
2015,104745,2510.907379,81,61,0,20,2,Rafael Nadal
1988,101084,2509.154877,64,49,0,15,1,Jakob Hlasek
2009,103786,2508.804834,76,57,0,19,1,Nikolay Davydenko
2009,105223,2508.579596,70,54,0,16,1,Juan Martin Del Potro
1986,101222,2508.376103,91,70,0,21,0,Stefan Edberg
2003,104053,2507.497516,91,72,0,19,1,Andy Roddick
1987,101062,2506.104774,89,71,0,18,0,Mats Wilander
2000,103498,2505.788615,93,68,0,25,3,Marat Safin
1988,101736,2502.861112,74,63,0,11,1,Andre Agassi
2014,105453,2502.287436,69,54,0,15,1,Kei Nishikori
1985,101222,2501.264956,80,60,0,20,0,Stefan Edberg
2008,104925,2501.222052,81,64,0,17,1,Novak Djokovic
2014,104918,2500.620481,80,60,0,20,1,Andy Murray
2004,103720,2500.224275,86,68,0,18,1,Lleyton Hewitt
1988,100656,2496.297702,49,41,0,8,1,Ivan Lendl
2009,104745,2494.371512,82,68,0,14,0,Rafael Nadal
2012,104745,2494.253369,49,42,0,7,22,Rafael Nadal
1994,101414,2494.186873,67,50,0,17,0,Boris Becker
1985,101062,2493.427179,91,70,0,21,0,Mats Wilander
1993,101964,2492.148924,75,54,0,21,2,Goran Ivanisevic
2002,103720,2491.985614,78,62,0,16,1,Lleyton Hewitt
1986,101062,2489.908823,67,54,0,13,1,Mats Wilander
1997,102035,2485.949985,97,71,0,26,0,Jonas Bjorkman
2006,104745,2483.999196,72,60,0,12,1,Rafael Nadal
2011,104542,2483.969073,81,57,0,24,1,Jo Wilfried Tsonga
2003,103909,2482.314482,77,61,0,16,1,Guillermo Coria
2013,105223,2481.878398,68,52,0,16,2,Juan Martin Del Potro
1991,101414,2479.139378,63,50,0,13,2,Boris Becker
1996,101414,2478.688227,57,42,0,15,0,Boris Becker
1989,100581,2477.502539,58,47,0,11,1,John Mcenroe
1988,101426,2476.773543,59,50,0,9,0,Kent Carlsson
1994,101723,2476.277554,61,39,0,22,0,Magnus Larsson
1988,101062,2474.181291,65,53,0,12,0,Mats Wilander
1989,101073,2474.08813,66,51,0,15,2,Martin Jaite
2011,103970,2473.521198,78,59,0,19,0,David Ferrer
2010,104417,2473.510537,79,57,0,22,1,Robin Soderling
1995,101414,2472.389104,73,54,0,19,0,Boris Becker
1993,101404,2472.275897,98,77,0,21,0,Thomas Muster
1999,101948,2471.645994,49,39,0,10,1,Pete Sampras
1996,102358,2471.46586,87,58,0,29,1,Thomas Enqvist
2007,103970,2471.179219,84,61,0,23,1,David Ferrer
1995,101404,2471.07806,105,86,0,19,0,Thomas Muster
2012,104607,2470.704446,84,61,0,23,1,Tomas Berdych
1995,102021,2469.477977,84,65,0,19,0,Michael Chang
1998,101948,2468.962013,79,61,0,18,1,Pete Sampras
2004,104053,2468.585203,92,74,0,18,0,Andy Roddick
1991,101948,2467.119406,71,52,0,19,1,Pete Sampras
2015,104527,2467.037388,74,55,0,19,2,Stanislas Wawrinka
2001,103163,2466.529781,77,55,0,22,2,Tommy Haas
1998,102257,2465.667622,75,53,0,22,1,Greg Rusedski
1992,101793,2465.435032,88,70,0,18,1,Jim Courier
2013,104918,2465.181468,51,43,0,8,11,Andy Murray
1990,100656,2464.887584,62,52,0,10,0,Ivan Lendl
1988,101222,2464.560515,85,67,0,18,0,Stefan Edberg
2005,104053,2463.90008,74,59,0,15,2,Andy Roddick
1993,102021,2462.505705,87,66,0,21,0,Michael Chang
1996,102338,2462.096642,105,80,0,25,0,Yevgeny Kafelnikov
2007,104925,2461.288208,87,68,0,19,1,Novak Djokovic
2010,104918,2460.298148,64,46,0,18,1,Andy Murray
1997,102158,2460.018111,95,66,0,29,1,Patrick Rafter
2003,101736,2458.265632,57,47,0,10,1,Andre Agassi
1990,101948,2457.049008,67,50,0,17,0,Pete Sampras
1989,101381,2456.778041,70,50,0,20,1,Aaron Krickstein
1994,102021,2455.300505,88,67,0,21,0,Michael Chang
1989,100763,2455.218282,77,60,0,17,1,Brad Gilbert
2001,102338,2454.68851,97,69,0,28,1,Yevgeny Kafelnikov
1995,102358,2453.027521,87,63,0,24,2,Thomas Enqvist
1985,100284,2452.774556,64,48,0,16,9,Jimmy Connors
2000,102856,2452.179053,86,64,0,22,1,Gustavo Kuerten
2006,103602,2450.445615,72,50,0,22,2,Fernando Gonzalez
1998,101736,2448.499143,86,68,0,18,1,Andre Agassi
1987,101138,2447.433657,61,45,0,16,1,Pat Cash
1988,100284,2447.274483,51,40,0,11,10,Jimmy Connors
1991,101793,2446.589954,78,58,0,20,0,Jim Courier
2002,101736,2445.591883,66,54,0,12,1,Andre Agassi
1992,100656,2445.527154,75,51,0,24,3,Ivan Lendl
1991,100656,2445.393429,73,55,0,18,0,Ivan Lendl
1992,101222,2445.3219,92,68,0,24,0,Stefan Edberg
1996,101964,2445.083012,103,77,0,26,0,Goran Ivanisevic
2013,103819,2444.835105,62,45,0,17,2,Roger Federer
1988,101404,2443.599156,67,51,0,16,6,Thomas Muster
2011,104607,2443.515736,77,53,0,24,1,Tomas Berdych
2008,103900,2443.159896,60,44,0,16,0,David Nalbandian
2010,104792,2442.826986,66,46,0,20,0,Gael Monfils
2002,103387,2441.651746,75,50,0,25,2,Paradorn Srichaphan
1998,102158,2441.623774,81,60,0,21,3,Patrick Rafter
2006,103484,2441.277826,85,60,0,25,1,James Blake
2009,104417,2440.98028,69,46,0,23,1,Robin Soderling
1994,101964,2440.620875,92,65,0,27,0,Goran Ivanisevic
1987,100763,2440.583239,78,55,0,23,1,Brad Gilbert
1997,101434,2439.305753,81,56,0,25,2,Petr Korda
2007,103900,2438.494709,49,31,0,18,2,David Nalbandian
2002,102845,2438.308,79,58,0,21,1,Carlos Moya
1998,101774,2438.139944,65,44,0,21,2,Todd Martin
2007,104053,2437.286188,70,54,0,16,0,Andy Roddick
1987,100689,2437.087561,57,43,0,14,4,Tim Mayotte
1985,100757,2437.021508,77,56,0,21,0,Anders Jarryd
1987,101414,2437.018676,69,53,0,16,1,Boris Becker
1997,101990,2436.659594,69,50,0,19,3,Richard Krajicek
1992,101529,2435.709566,68,47,0,21,0,Michael Stich
1991,102021,2435.208377,67,47,0,20,0,Michael Chang
1991,101098,2434.426236,84,63,0,21,0,Guy Forget
1986,101426,2433.646131,57,44,0,13,5,Kent Carlsson
2015,105453,2433.137154,72,55,0,17,2,Kei Nishikori
2005,101736,2433.087089,51,38,0,13,1,Andre Agassi
2015,103970,2433.086519,71,55,0,16,2,David Ferrer
2003,103900,2432.7052,63,42,0,21,1,David Nalbandian
2005,103900,2432.603421,63,44,0,19,1,David Nalbandian
2000,102450,2432.337228,83,58,0,25,2,Tim Henman
1991,101529,2432.302986,100,74,0,26,0,Michael Stich
1991,101320,2432.264136,69,52,0,17,8,Magnus Gustafsson
2011,104417,2431.948487,47,38,0,9,20,Robin Soderling
1998,102450,2431.826836,88,59,0,29,1,Tim Henman
2010,103888,2431.672307,55,40,0,15,8,Mardy Fish
1997,102338,2431.358546,82,55,0,27,1,Yevgeny Kafelnikov
2005,103344,2431.155718,81,57,0,24,0,Ivan Ljubicic
1993,101222,2430.472754,87,61,0,26,0,Stefan Edberg
1996,102021,2430.282081,84,65,0,19,2,Michael Chang
1986,100763,2429.96371,63,47,0,16,7,Brad Gilbert
2005,103720,2429.852704,48,38,0,10,7,Lleyton Hewitt
2000,103720,2429.101522,79,61,0,18,0,Lleyton Hewitt
2006,103786,2428.945707,99,70,0,29,0,Nikolay Davydenko
2015,104755,2427.785179,60,43,0,17,3,Richard Gasquet
2014,104745,2427.209016,60,49,0,11,3,Rafael Nadal
2003,102783,2427.103468,99,70,0,29,1,Rainer Schuettler
2004,103498,2426.445106,73,50,0,23,1,Marat Safin
2001,102158,2425.760126,66,48,0,18,0,Patrick Rafter
1986,100936,2425.11019,60,46,0,14,1,Henri Leconte
1994,102238,2424.761064,91,65,0,26,0,Alberto Berasategui
2000,101948,2424.744427,54,41,0,13,1,Pete Sampras
1998,102338,2424.386649,87,58,0,29,1,Yevgeny Kafelnikov
2002,103819,2423.973338,81,59,0,22,1,Roger Federer
1987,100757,2423.570526,63,43,0,20,0,Anders Jarryd
1994,101820,2423.43627,76,49,0,27,3,Marc Rosset
2008,104468,2423.198785,79,52,0,27,1,Gilles Simon
1999,102257,2423.013459,75,49,0,26,3,Greg Rusedski
1992,101098,2422.384215,70,47,0,23,0,Guy Forget
1998,102374,2422.119555,78,57,0,21,1,Alex Corretja
2000,102374,2422.082049,73,55,0,18,1,Alex Corretja
2014,105683,2421.827821,69,49,0,20,1,Milos Raonic
1998,102701,2420.975681,87,69,0,18,1,Marcelo Rios
2006,104339,2420.681212,71,53,0,18,2,Mario Ancic
1986,100676,2420.521651,57,43,0,14,1,Yannick Noah
1990,101736,2420.334831,48,39,0,9,3,Andre Agassi
2014,105777,2420.096774,69,51,0,18,2,Grigor Dimitrov
1999,102839,2418.977341,80,58,0,22,1,Nicolas Lapentti
2014,105227,2418.970172,75,54,0,21,1,Marin Cilic
1993,101434,2418.338043,79,55,0,24,0,Petr Korda
1992,101990,2417.806088,73,49,0,24,0,Richard Krajicek
2013,104527,2417.544334,75,51,0,24,2,Stanislas Wawrinka
2004,101736,2417.256501,50,37,0,13,3,Andre Agassi
1987,101426,2417.032248,46,37,0,9,19,Kent Carlsson
2002,103498,2416.92459,79,56,0,23,0,Marat Safin
1997,102257,2416.756043,78,54,0,24,1,Greg Rusedski
1989,102021,2416.414549,64,47,0,17,1,Michael Chang
1987,101036,2416.260016,90,71,0,19,1,Miloslav Mecir
2010,103970,2415.935678,84,60,0,24,1,David Ferrer
1998,101990,2415.869608,61,45,0,16,3,Richard Krajicek
2003,102450,2414.472835,48,31,0,17,2,Tim Henman
1993,101820,2414.162441,73,49,0,24,3,Marc Rosset
1993,102446,2413.863867,82,58,0,24,2,Andrei Medvedev
2007,103333,2413.321137,66,45,0,21,2,Ivo Karlovic
2007,104918,2412.407605,57,43,0,14,2,Andy Murray
1994,101965,2412.255451,95,69,0,26,0,Wayne Ferreira
2015,104607,2411.438168,79,57,0,22,2,Tomas Berdych
2006,104607,2411.031716,71,47,0,24,2,Tomas Berdych
1986,100284,2410.877471,61,46,0,15,3,Jimmy Connors
1990,101084,2410.170025,63,41,0,22,1,Jakob Hlasek
2013,103970,2410.042486,87,63,0,24,2,David Ferrer
2003,103507,2409.508309,88,67,0,21,0,Juan Carlos Ferrero
2008,105223,2409.232002,63,46,0,17,0,Juan Martin Del Potro
2010,103781,2409.161876,78,53,0,25,2,Jurgen Melzer
1992,101434,2409.130703,93,63,0,30,0,Petr Korda
1994,102338,2408.956558,96,67,0,29,1,Yevgeny Kafelnikov
2008,104053,2408.523324,68,50,0,18,1,Andy Roddick
1992,102021,2408.476159,81,58,0,23,0,Michael Chang
1985,100901,2408.39393,64,45,0,19,0,Paul Annacone
2006,103344,2408.37551,80,60,0,20,1,Ivan Ljubicic
2008,104542,2407.933532,49,34,0,15,1,Jo Wilfried Tsonga
2006,104053,2407.67165,69,49,0,20,1,Andy Roddick
1995,101965,2407.668021,84,58,0,26,2,Wayne Ferreira
2014,104792,2406.900027,51,36,0,15,0,Gael Monfils
2003,103720,2406.714704,47,37,0,10,0,Lleyton Hewitt
1996,101736,2406.412158,52,38,0,14,0,Andre Agassi
2001,101948,2406.004258,51,35,0,16,4,Pete Sampras
1996,101774,2405.945651,76,55,0,21,3,Todd Martin
2007,104571,2405.418369,70,48,0,22,2,Marcos Baghdatis
1992,101736,2404.380795,57,42,0,15,0,Andre Agassi
1995,101793,2404.322567,83,61,0,22,1,Jim Courier
2008,103786,2403.45909,78,56,0,22,1,Nikolay Davydenko
2004,102562,2403.174803,63,42,0,21,2,Jiri Novak
2009,104053,2402.866145,64,49,0,15,7,Andy Roddick
1994,101843,2402.651337,91,66,0,25,0,Sergi Bruguera
2009,103285,2402.433231,68,47,0,21,0,Radek Stepanek
1988,100581,2402.231592,40,30,0,10,3,John Mcenroe
1996,101404,2401.404171,89,68,0,21,2,Thomas Muster
2008,104417,2400.803231,65,44,0,21,2,Robin Soderling
1991,101434,2400.787948,69,45,0,24,3,Petr Korda
1991,101736,2400.40482,56,39,0,17,1,Andre Agassi
2014,104607,2400.188748,78,55,0,23,1,Tomas Berdych
1993,101611,2400.167423,78,51,0,27,0,Cedric Pioline
1999,103017,2399.860115,77,53,0,24,1,Nicolas Kiefer
2013,104607,2399.781593,80,55,0,25,0,Tomas Berdych
1985,100763,2399.688058,75,53,0,22,0,Brad Gilbert
1997,101723,2399.48911,66,42,0,24,0,Magnus Larsson
2001,102450,2399.307299,71,51,0,20,2,Tim Henman
2002,103507,2399.226064,73,48,0,25,1,Juan Carlos Ferrero
1993,101320,2398.975247,82,52,0,30,3,Magnus Gustafsson
1987,100284,2398.678755,70,52,0,18,1,Jimmy Connors
1986,100653,2398.351991,81,59,0,22,1,Andres Gomez
2011,104386,2398.100624,81,54,0,27,1,Janko Tipsarevic
2014,103970,2397.437101,79,55,0,24,1,David Ferrer
1993,101843,2397.130329,90,65,0,25,0,Sergi Bruguera
1994,101774,2395.635681,73,53,0,20,0,Todd Martin
1990,101964,2395.106544,68,46,0,22,0,Goran Ivanisevic
1996,101434,2394.8703,62,42,0,20,3,Petr Korda
1990,100763,2394.816991,65,46,0,19,0,Brad Gilbert
2006,103900,2394.772388,63,44,0,19,0,David Nalbandian
2004,103084,2394.029325,62,40,0,22,2,Guillermo Canas
2009,104022,2393.576102,70,42,0,28,3,Mikhail Youzhny
2013,105683,2393.570251,68,46,0,22,3,Milos Raonic
2011,105223,2393.320496,68,49,0,19,0,Juan Martin Del Potro
2009,105227,2393.111565,69,48,0,21,2,Marin Cilic
1988,100936,2392.829081,74,51,0,23,1,Henri Leconte
2003,102845,2392.666967,79,57,0,22,0,Carlos Moya
2000,102338,2392.643496,102,67,0,35,1,Yevgeny Kafelnikov
1986,101138,2392.509778,35,24,0,11,0,Pat Cash
1999,102796,2392.488748,66,44,0,22,2,Magnus Norman
2004,102845,2391.821137,79,60,0,19,0,Carlos Moya
2012,104542,2391.732857,82,57,0,25,2,Jo Wilfried Tsonga
1999,102158,2391.62468,55,38,0,17,11,Patrick Rafter
1986,100581,2391.572974,27,22,0,5,4,John Mcenroe
2011,104545,2390.931819,57,36,0,21,3,John Isner
1988,100689,2389.888421,67,48,0,19,1,Tim Mayotte
2009,104542,2389.757453,75,54,0,21,2,Jo Wilfried Tsonga
1989,100284,2389.602501,44,31,0,13,4,Jimmy Connors
1995,101589,2389.324068,79,46,0,33,3,Arnaud Boetsch
2006,104755,2389.300124,56,34,0,22,2,Richard Gasquet
2005,103602,2388.902275,73,50,0,23,1,Fernando Gonzalez
1993,101736,2388.258452,44,33,0,11,11,Andre Agassi
1997,102450,2388.196553,72,48,0,24,1,Tim Henman
2009,104792,2387.984646,62,42,0,20,2,Gael Monfils
1991,101964,2387.036587,64,41,0,23,4,Goran Ivanisevic
1986,101036,2386.642626,61,42,0,19,4,Miloslav Mecir
2000,101736,2385.482217,54,39,0,15,1,Andre Agassi
1987,100653,2385.385198,70,51,0,19,2,Andres Gomez
1993,101589,2385.296336,72,46,0,26,4,Arnaud Boetsch
1993,101793,2385.029609,75,58,0,17,2,Jim Courier
1985,100676,2384.832853,72,51,0,21,0,Yannick Noah
2002,103206,2384.701169,65,43,0,22,0,Sebastien Grosjean
1989,101736,2384.339449,60,41,0,19,1,Andre Agassi
2005,102563,2384.183836,72,47,0,25,2,Thomas Johansson
2001,103498,2384.112614,70,45,0,25,2,Marat Safin
2015,104542,2383.774068,48,32,0,16,3,Jo Wilfried Tsonga
1985,100689,2383.734217,67,48,0,19,0,Tim Mayotte
1997,102701,2383.552717,86,60,0,26,2,Marcelo Rios
1994,101529,2383.481598,85,60,0,25,3,Michael Stich
2006,104925,2383.41435,58,40,0,18,2,Novak Djokovic
2005,103484,2383.115312,56,35,0,21,2,James Blake
1985,100893,2383.016077,71,50,0,21,0,Joakim Nystrom
1996,101320,2382.951382,54,37,0,17,4,Magnus Gustafsson
1986,101142,2382.510241,79,54,0,25,4,Emilio Sanchez
1995,101529,2382.257545,66,47,0,19,6,Michael Stich
1994,102374,2381.945018,66,44,0,22,3,Alex Corretja
1986,101298,2381.732959,53,34,0,19,4,Jonas Svensson
2000,102358,2381.646279,74,51,0,23,2,Thomas Enqvist
2007,103484,2381.638648,80,55,0,25,0,James Blake
1993,101475,2381.590862,71,45,0,26,3,Carlos Costa
2001,102856,2381.502206,78,60,0,18,1,Gustavo Kuerten
1998,102563,2381.392771,78,47,0,31,2,Thomas Johansson
2009,104269,2381.293323,77,52,0,25,1,Fernando Verdasco
2015,104731,2380.485655,70,46,0,24,3,Kevin Anderson
1987,101073,2380.327498,67,46,0,21,2,Martin Jaite
1998,101320,2380.177783,61,40,0,21,0,Magnus Gustafsson
2008,104792,2380.109451,47,30,0,17,2,Gael Monfils
2001,103206,2379.864809,76,50,0,26,0,Sebastien Grosjean
2004,104022,2379.761758,69,42,0,27,2,Mikhail Youzhny
2001,101736,2379.054418,61,46,0,15,1,Andre Agassi
1999,102338,2378.0892,94,62,0,32,1,Yevgeny Kafelnikov
1999,102358,2378.069921,75,47,0,28,1,Thomas Enqvist
1988,101036,2377.984998,48,35,0,13,6,Miloslav Mecir
2011,105227,2377.796959,67,44,0,23,3,Marin Cilic
2004,103900,2377.449856,48,34,0,14,3,David Nalbandian
1987,100581,2377.415347,41,29,0,12,16,John Mcenroe
2000,103096,2377.314609,63,36,0,27,3,Arnaud Clement
2002,102562,2377.30541,80,53,0,27,1,Jiri Novak
1992,101820,2377.265482,69,42,0,27,1,Marc Rosset
2014,104527,2376.898344,59,42,0,17,0,Stanislas Wawrinka
1985,100936,2376.532189,72,47,0,25,0,Henri Leconte
2003,103758,2376.484773,41,28,0,13,3,Taylor Dent
2010,104053,2376.366938,66,48,0,18,1,Andy Roddick
2015,105227,2376.342933,54,35,0,19,3,Marin Cilic
1988,101230,2376.235749,65,48,0,17,2,Andrei Chesnokov
1985,100942,2375.148602,58,36,0,22,7,Thierry Tulasne
2005,103292,2375.012351,77,56,0,21,1,Gaston Gaudio
2009,103602,2374.926142,55,39,0,16,2,Fernando Gonzalez
2000,101965,2374.896495,65,43,0,22,3,Wayne Ferreira
2013,104755,2374.844445,73,50,0,23,2,Richard Gasquet
1996,102701,2374.67015,83,58,0,25,3,Marcelo Rios
1988,101381,2374.575853,74,50,0,24,2,Aaron Krickstein
1987,101649,2374.535484,55,40,0,15,2,Guillermo Perez Roldan
1999,102701,2374.102706,65,47,0,18,3,Marcelo Rios
2012,105023,2373.167398,62,37,0,25,3,Sam Querrey
2011,104792,2373.094773,55,38,0,17,3,Gael Monfils
1986,101073,2373.081977,58,42,0,16,4,Martin Jaite
2007,104755,2372.715403,74,49,0,25,1,Richard Gasquet
1986,100893,2372.677963,77,59,0,18,1,Joakim Nystrom
1995,102338,2372.615721,106,74,0,32,0,Yevgeny Kafelnikov
1995,101774,2372.07216,72,47,0,25,0,Todd Martin
2015,104545,2371.739192,70,45,0,25,3,John Isner
1988,100944,2371.682252,43,31,0,12,6,Mikael Pernfors
1997,102021,2371.530104,78,57,0,21,0,Michael Chang
2004,103017,2371.480327,57,37,0,20,11,Nicolas Kiefer
1993,101774,2371.096912,68,45,0,23,0,Todd Martin
1997,101532,2370.430624,65,41,0,24,2,Francisco Clavet
1996,101222,2370.407378,72,46,0,26,1,Stefan Edberg
2001,103507,2370.331108,78,57,0,21,1,Juan Carlos Ferrero
2005,103786,2370.230567,86,56,0,30,1,Nikolay Davydenko
1988,100763,2369.949641,45,30,0,15,3,Brad Gilbert
2005,104068,2369.861033,60,37,0,23,2,Robby Ginepri
2014,105138,2369.674438,69,45,0,24,2,Roberto Bautista Agut
2012,105227,2369.609437,58,39,0,19,3,Marin Cilic
1990,101298,2369.419166,60,41,0,19,0,Jonas Svensson
1985,100532,2369.366045,64,43,0,21,0,Johan Kriek
1991,101609,2369.217,52,33,0,19,0,David Wheaton
2007,103720,2369.079234,52,36,0,16,7,Lleyton Hewitt
2001,104053,2369.071412,58,42,0,16,2,Andy Roddick
1990,100581,2369.063046,48,33,0,15,2,John Mcenroe
1994,101793,2368.758014,66,47,0,19,4,Jim Courier
2000,102796,2368.442401,94,69,0,25,1,Magnus Norman
2012,104597,2368.411368,83,59,0,24,1,Nicolas Almagro
2012,105453,2368.310238,56,37,0,19,3,Kei Nishikori
2012,105683,2368.038979,67,46,0,21,3,Milos Raonic
1989,101409,2367.937923,54,37,0,17,2,Jaime Yzaga
2010,103900,2367.937118,39,28,0,11,2,David Nalbandian
2004,103909,2367.848957,53,39,0,14,1,Guillermo Coria
1997,102456,2367.494441,75,53,0,22,2,Felix Mantilla
2001,102563,2367.281885,71,46,0,25,2,Thomas Johansson
2013,104542,2366.833423,55,39,0,16,3,Jo Wilfried Tsonga
1989,101142,2366.77901,56,38,0,18,2,Emilio Sanchez
2000,102882,2366.05352,66,43,0,23,3,Mark Philippoussis
2012,104527,2365.876058,55,35,0,20,3,Stanislas Wawrinka
1985,100653,2365.685639,43,28,0,15,0,Andres Gomez
2003,103454,2365.623018,55,35,0,20,2,Nicolas Massu
2004,103163,2365.586659,57,37,0,20,2,Tommy Haas
1988,100676,2365.527465,47,36,0,11,17,Yannick Noah
2013,104022,2365.150307,63,39,0,24,3,Mikhail Youzhny
2001,101962,2365.133443,56,33,0,23,3,Younes El Aynaoui
1996,102257,2364.333683,68,42,0,26,3,Greg Rusedski
1987,101142,2364.159149,88,60,0,28,2,Emilio Sanchez
2011,104053,2363.972627,50,34,0,16,3,Andy Roddick
2013,103990,2363.697763,56,36,0,20,7,Tommy Robredo
1995,101964,2363.205614,71,47,0,24,0,Goran Ivanisevic
2012,104755,2362.877081,64,42,0,22,3,Richard Gasquet
2012,104468,2362.777064,69,44,0,25,3,Gilles Simon
2002,104053,2362.59137,78,56,0,22,2,Andy Roddick
2002,103602,2362.483416,62,40,0,22,2,Fernando Gonzalez
1997,102344,2362.29883,64,37,0,27,2,Karol Kucera
2007,104607,2362.264722,70,46,0,24,2,Tomas Berdych
2007,104338,2362.230657,60,41,0,19,2,Juan Monaco
2014,105676,2362.205418,40,25,0,15,2,David Goffin
1987,101106,2361.80312,43,27,0,16,4,Peter Lundgren
2005,104755,2361.771669,42,31,0,11,6,Richard Gasquet
2013,104545,2361.692882,63,39,0,24,3,John Isner
1989,100653,2361.628311,49,32,0,17,8,Andres Gomez
2006,104918,2361.578677,65,40,0,25,2,Andy Murray
2014,103990,2361.418694,69,43,0,26,2,Tommy Robredo
2006,103163,2361.381477,70,49,0,21,2,Tommy Haas
2012,103163,2361.078792,48,31,0,17,6,Tommy Haas
2009,104468,2360.974127,71,45,0,26,2,Gilles Simon
1988,101649,2360.913139,66,44,0,22,5,Guillermo Perez Roldan
2005,104607,2360.876832,63,34,0,29,2,Tomas Berdych
2010,104527,2360.828943,55,36,0,19,2,Stanislas Wawrinka
2008,103484,2360.010022,72,48,0,24,2,James Blake
1992,101843,2359.981841,68,46,0,22,3,Sergi Bruguera
1991,101084,2359.951034,77,50,0,27,0,Jakob Hlasek
1999,103163,2359.851461,72,48,0,24,2,Tommy Haas
2001,103084,2359.231075,66,45,0,21,2,Guillermo Canas
1988,101142,2359.182668,67,43,0,24,2,Emilio Sanchez
1997,101964,2358.543155,78,56,0,22,4,Goran Ivanisevic
2008,103602,2358.333099,56,40,0,16,4,Fernando Gonzalez
2007,103786,2358.329318,85,53,0,32,1,Nikolay Davydenko
2013,103163,2358.278311,71,47,0,24,3,Tommy Haas
1997,102882,2357.6309,69,48,0,21,4,Mark Philippoussis
2000,103206,2357.374129,71,44,0,27,2,Sebastien Grosjean
2002,102450,2357.116027,70,50,0,20,2,Tim Henman
2008,104607,2357.049866,57,35,0,22,2,Tomas Berdych
1990,102021,2357.034113,53,34,0,19,0,Michael Chang
2011,105453,2356.690856,58,36,0,22,3,Kei Nishikori
1989,101793,2356.653766,48,30,0,18,2,Jim Courier
2014,104542,2356.608337,56,37,0,19,0,Jo Wilfried Tsonga
1989,101062,2356.55716,52,34,0,18,0,Mats Wilander
1996,101733,2356.536879,66,36,0,30,3,Jan Siemerink
2001,102562,2356.228627,48,29,0,19,2,Jiri Novak
2008,104269,2356.152881,74,47,0,27,0,Fernando Verdasco
1994,101990,2356.099911,47,33,0,14,3,Richard Krajicek
2012,104386,2355.709547,85,57,0,28,2,Janko Tipsarevic
2015,106058,2355.655185,53,35,0,18,3,Jack Sock
2011,103888,2355.410916,68,43,0,25,1,Mardy Fish
1992,102446,2355.385405,44,32,0,12,3,Andrei Medvedev
2002,104022,2355.332868,55,31,0,24,0,Mikhail Youzhny
1994,101797,2354.985183,65,40,0,25,3,Jacco Eltingh
2004,102450,2354.816071,65,44,0,21,1,Tim Henman
2003,102882,2354.002252,58,38,0,20,0,Mark Philippoussis
2001,103819,2353.863141,70,49,0,21,2,Roger Federer
1989,101309,2353.729553,60,41,0,19,2,Jay Berger
2005,103103,2353.113834,69,43,0,26,0,Dominik Hrbaty
2006,104527,2352.938716,57,33,0,24,2,Stanislas Wawrinka
2011,103852,2352.827829,62,36,0,26,3,Feliciano Lopez
2006,103498,2352.642393,61,36,0,25,0,Marat Safin
1998,102882,2352.385054,53,33,0,20,3,Mark Philippoussis
2008,105227,2352.131759,62,37,0,25,2,Marin Cilic
1996,102450,2351.848096,67,42,0,25,0,Tim Henman
2009,105023,2351.771606,61,39,0,22,12,Sam Querrey
2006,103720,2351.76649,48,33,0,15,8,Lleyton Hewitt
2011,104252,2351.741097,71,45,0,26,3,Florian Mayer
1987,100946,2351.623628,56,35,0,21,6,Slobodan Zivojinovic
2015,105676,2351.414918,64,39,0,25,0,David Goffin
1992,101589,2351.374416,61,35,0,26,4,Arnaud Boetsch
1991,101196,2351.170444,63,39,0,24,4,Derrick Rostagno
1999,102882,2351.1198,53,36,0,17,0,Mark Philippoussis
2003,102856,2350.786681,63,42,0,21,2,Gustavo Kuerten
2001,102854,2350.723395,66,38,0,28,2,Sjeng Schalken
1990,101230,2350.519854,63,43,0,20,2,Andrei Chesnokov
1999,101990,2350.514269,64,43,0,21,3,Richard Krajicek
1998,101532,2350.158026,69,43,0,26,2,Francisco Clavet
1989,101649,2349.841302,54,36,0,18,11,Guillermo Perez Roldan
2015,105138,2349.745781,71,42,0,29,3,Roberto Bautista Agut
2009,103781,2349.454422,65,36,0,29,4,Jurgen Melzer
1987,101230,2349.083765,46,30,0,16,4,Andrei Chesnokov
2006,103990,2348.816076,78,49,0,29,1,Tommy Robredo
1988,102021,2348.638581,36,23,0,13,12,Michael Chang
1988,101195,2348.446967,52,33,0,19,3,Amos Mansdorf
1999,103720,2348.417438,64,44,0,20,0,Lleyton Hewitt
1991,101843,2348.225835,73,51,0,22,4,Sergi Bruguera
2000,103103,2348.186652,72,43,0,29,2,Dominik Hrbaty
1996,102238,2347.999555,72,46,0,26,3,Alberto Berasategui
2013,105208,2347.773514,55,37,0,18,3,Ernests Gulbis
2002,102257,2347.65213,51,33,0,18,10,Greg Rusedski
1987,100676,2347.580549,47,34,0,13,6,Yannick Noah
1987,101084,2347.027726,59,37,0,22,3,Jakob Hlasek
1998,102035,2346.938166,65,38,0,27,2,Jonas Bjorkman
1989,100689,2346.700577,47,30,0,17,5,Tim Mayotte
1991,101063,2346.112019,58,36,0,22,3,Jordi Arrese
2009,103720,2345.995123,54,34,0,20,7,Lleyton Hewitt
2015,104259,2345.938978,56,33,0,23,5,Philipp Kohlschreiber
2012,104545,2345.647953,66,45,0,21,3,John Isner
2010,104678,2345.607944,69,39,0,30,0,Viktor Troicki
1994,101532,2345.429091,46,27,0,19,3,Francisco Clavet
1994,101222,2345.383826,87,60,0,27,0,Stefan Edberg
2005,103498,2345.303106,38,27,0,11,12,Marat Safin
2005,104214,2345.199689,68,38,0,30,5,Igor Andreev
1998,103163,2344.829231,66,40,0,26,2,Tommy Haas
2000,103017,2344.777079,46,30,0,16,10,Nicolas Kiefer
1998,102845,2344.418757,77,49,0,28,1,Carlos Moya
1990,101772,2344.254628,61,35,0,26,0,Andrei Cherkasov
2001,103344,2344.168325,51,29,0,22,2,Ivan Ljubicic
2013,105777,2344.071259,60,37,0,23,3,Grigor Dimitrov
1995,101723,2343.903017,51,36,0,15,3,Magnus Larsson
2010,104022,2343.721753,63,43,0,20,2,Mikhail Youzhny
2003,103888,2343.08465,64,39,0,25,2,Mardy Fish
1986,100529,2343.017351,55,36,0,19,3,Kevin Curren
1995,101843,2342.961704,60,40,0,20,0,Sergi Bruguera
1988,101298,2342.826721,61,40,0,21,2,Jonas Svensson
1998,101964,2342.478212,72,44,0,28,2,Goran Ivanisevic
2006,102450,2342.351605,51,31,0,20,3,Tim Henman
2007,103990,2342.09596,75,49,0,26,2,Tommy Robredo
1996,102882,2342.060879,58,35,0,23,4,Mark Philippoussis
2011,104755,2342.048114,55,35,0,20,3,Richard Gasquet
2015,105683,2341.498998,49,33,0,16,7,Milos Raonic
1988,101511,2341.326901,48,29,0,19,9,Horst Skoff
1986,100752,2341.307048,59,34,0,25,3,Ramesh Krishnan
1986,101381,2341.222227,61,39,0,22,3,Aaron Krickstein
1990,101609,2341.145257,55,35,0,20,0,David Wheaton
1987,100893,2340.858519,52,34,0,18,4,Joakim Nystrom
1992,101120,2340.731705,68,42,0,26,3,Karel Novacek
2002,102374,2340.669423,58,39,0,19,3,Alex Corretja
2002,103084,2340.630151,66,43,0,23,2,Guillermo Canas
2000,101990,2340.312165,42,27,0,15,5,Richard Krajicek
1993,101613,2340.269895,62,39,0,23,0,Malivai Washington
2003,103852,2339.975021,65,34,0,31,2,Feliciano Lopez
2007,104269,2339.75215,62,34,0,28,2,Fernando Verdasco
2005,103507,2339.592174,73,46,0,27,2,Juan Carlos Ferrero
2013,104926,2338.974914,69,42,0,27,3,Fabio Fognini
1992,101510,2338.739618,40,25,0,15,3,Henrik Holm
1990,101404,2338.569504,59,44,0,15,0,Thomas Muster
2005,103285,2338.220093,71,45,0,26,2,Radek Stepanek
2001,102358,2337.898119,55,33,0,22,2,Thomas Enqvist
1992,101611,2337.852922,58,31,0,27,3,Cedric Pioline
1991,101334,2337.730246,76,46,0,30,3,Alexander Volkov
2005,103990,2337.657342,68,43,0,25,2,Tommy Robredo
1996,102845,2337.634385,72,44,0,28,3,Carlos Moya
1996,101965,2337.454763,77,49,0,28,3,Wayne Ferreira
2007,103908,2337.203818,70,46,0,24,2,Paul Henri Mathieu
2009,103970,2337.021382,70,46,0,24,0,David Ferrer
2006,103285,2336.512166,45,30,0,15,19,Radek Stepanek
1996,102456,2336.469152,75,48,0,27,3,Felix Mantilla
2001,103018,2336.299454,58,31,0,27,2,Max Mirnyi
1997,102610,2336.09708,68,46,0,22,6,Albert Costa
1999,102344,2335.772545,65,43,0,22,3,Karol Kucera
2012,105668,2335.733803,19,14,0,5,3,Jerzy Janowicz
2015,104468,2335.639576,67,43,0,24,3,Gilles Simon
1992,101965,2335.590854,74,49,0,25,0,Wayne Ferreira
1992,101613,2335.104733,72,50,0,22,3,Malivai Washington
2010,104542,2334.891194,47,31,0,16,5,Jo Wilfried Tsonga
1998,102358,2334.528392,51,36,0,15,2,Thomas Enqvist
2002,102856,2334.336814,39,25,0,14,2,Gustavo Kuerten
2000,102158,2334.264841,53,34,0,19,0,Patrick Rafter
1991,101381,2333.904073,52,31,0,21,0,Aaron Krickstein
2010,103507,2333.792581,47,33,0,14,13,Juan Carlos Ferrero
2002,101948,2333.72533,44,27,0,17,10,Pete Sampras
1993,101414,2333.382143,64,42,0,22,0,Boris Becker
1990,101793,2333.338723,60,39,0,21,2,Jim Courier
2006,104417,2333.240831,58,35,0,23,2,Robin Soderling
2008,104214,2333.170261,75,43,0,32,2,Igor Andreev
1990,101820,2333.152765,58,35,0,23,1,Marc Rosset
2000,103507,2333.136858,72,46,0,26,0,Juan Carlos Ferrero
2007,104022,2332.87031,75,50,0,25,0,Mikhail Youzhny
1992,100581,2332.802416,50,32,0,18,0,John Mcenroe
1994,101404,2332.649208,84,58,0,26,0,Thomas Muster
2002,103900,2332.588062,60,36,0,24,2,David Nalbandian
1986,100944,2332.553767,58,38,0,20,0,Mikael Pernfors
2013,104597,2332.43748,65,42,0,23,3,Nicolas Almagro
1999,101774,2332.393112,63,43,0,20,1,Todd Martin
1997,102374,2332.363051,72,49,0,23,2,Alex Corretja
2000,102854,2332.255734,65,37,0,28,2,Sjeng Schalken
1991,101120,2331.703329,89,58,0,31,2,Karel Novacek
1997,102845,2331.488027,86,56,0,30,1,Carlos Moya
2004,102563,2331.451711,50,29,0,21,2,Thomas Johansson
1987,100586,2331.088386,37,24,0,13,7,Eliot Teltscher
2003,102562,2331.081064,74,46,0,28,2,Jiri Novak
2009,103507,2331.028629,55,35,0,20,3,Juan Carlos Ferrero
2012,103888,2330.972276,33,21,0,12,12,Mardy Fish
2012,104312,2330.790991,65,38,0,27,3,Andreas Seppi
2007,102845,2330.588791,65,42,0,23,2,Carlos Moya
2006,103813,2330.505465,82,55,0,27,2,Jarkko Nieminen
1989,101391,2330.491871,60,39,0,21,0,Carl Uwe Steeb
2012,104338,2330.442458,59,40,0,19,3,Juan Monaco
1987,100772,2330.315148,52,34,0,18,4,Kelly Evernden
2001,102701,2330.258939,51,31,0,20,3,Marcelo Rios
1988,100967,2330.180496,55,36,0,19,3,Dan Goldie
2001,103598,2329.792851,61,38,0,23,2,Xavier Malisse
1988,101138,2329.702663,34,25,0,9,19,Pat Cash
1988,100529,2329.469792,46,31,0,15,3,Kevin Curren
2002,103163,2329.039719,66,44,0,22,2,Tommy Haas
2002,103908,2328.997452,39,23,0,16,0,Paul Henri Mathieu
2011,104269,2328.903218,60,36,0,24,3,Fernando Verdasco
2014,103852,2328.730627,67,41,0,26,2,Feliciano Lopez
1994,101932,2328.314746,48,28,0,20,3,Jared Palmer
1993,101965,2328.264274,69,44,0,25,0,Wayne Ferreira
1995,101222,2328.165807,62,42,0,20,3,Stefan Edberg
2009,103344,2328.055836,55,32,0,23,2,Ivan Ljubicic
1990,101142,2327.766542,69,48,0,21,1,Emilio Sanchez
1999,102610,2327.624919,62,40,0,22,3,Albert Costa
2003,102854,2327.436469,66,42,0,24,2,Sjeng Schalken
1989,101511,2327.415747,61,38,0,23,5,Horst Skoff
2006,104571,2327.134286,57,37,0,20,3,Marcos Baghdatis
2002,103292,2327.114124,61,43,0,18,2,Gaston Gaudio
1985,100800,2327.090948,53,32,0,21,11,Diego Perez
1988,101606,2327.055085,45,30,0,15,2,Alberto Mancini
2006,102860,2326.840904,51,31,0,20,3,Agustin Calleri
1994,101613,2326.817921,59,36,0,23,5,Malivai Washington
1991,100763,2326.772541,61,37,0,24,4,Brad Gilbert
2013,105453,2326.725541,55,36,0,19,3,Kei Nishikori
2002,102318,2326.545274,70,44,0,26,2,Andrei Pavel
2015,105449,2326.497708,65,37,0,28,5,Steve Johnson
1997,102358,2326.449115,63,39,0,24,2,Thomas Enqvist
2004,104026,2326.435877,57,35,0,22,3,Joachim Johansson
2011,104731,2326.102595,69,42,0,27,3,Kevin Anderson
1990,101195,2325.927805,62,39,0,23,1,Amos Mansdorf
1994,102158,2325.859306,73,45,0,28,3,Patrick Rafter
1985,101073,2325.743174,58,39,0,19,6,Martin Jaite
2007,103163,2325.728589,57,39,0,18,2,Tommy Haas
2010,105062,2325.622447,25,17,0,8,5,Mikhail Kukushkin
1997,102148,2325.502623,56,32,0,24,2,Fabrice Santoro
1998,102021,2325.401751,53,35,0,18,3,Michael Chang
2003,103387,2325.215904,79,51,0,28,2,Paradorn Srichaphan
1989,100923,2324.976405,54,32,0,22,4,Wally Masur
2003,103018,2324.789106,69,41,0,28,2,Max Mirnyi
2005,103084,2324.723656,34,23,0,11,21,Guillermo Canas
1997,102796,2324.686635,68,42,0,26,2,Magnus Norman
1990,101334,2324.39714,60,34,0,26,1,Alexander Volkov
2008,104098,2324.385115,59,36,0,23,2,Dmitry Tursunov
1986,101098,2324.274741,57,34,0,23,3,Guy Forget
1995,102701,2324.141144,62,41,0,21,3,Marcelo Rios
2015,105332,2323.918873,42,25,0,17,3,Benoit Paire
1996,101990,2323.837449,74,46,0,28,0,Richard Krajicek
1998,102856,2323.689787,66,41,0,25,2,Gustavo Kuerten
2010,104468,2323.486783,42,24,0,18,0,Gilles Simon
2007,103017,2323.426022,31,19,0,12,2,Nicolas Kiefer
1995,101820,2323.379815,62,40,0,22,3,Marc Rosset
2008,104259,2323.301849,54,33,0,21,2,Philipp Kohlschreiber
1993,102257,2323.236698,25,16,0,9,6,Greg Rusedski
2004,103852,2322.899643,59,33,0,26,2,Feliciano Lopez
2008,103990,2322.72852,60,37,0,23,2,Tommy Robredo
2004,103454,2322.72683,68,40,0,28,2,Nicolas Massu
2009,104607,2322.665676,62,36,0,26,0,Tomas Berdych
1991,101142,2322.215963,69,43,0,26,3,Emilio Sanchez
1998,102456,2321.857655,69,43,0,26,2,Felix Mantilla
2006,103781,2321.844597,60,34,0,26,3,Jurgen Melzer
1998,102344,2321.758312,82,53,0,29,1,Karol Kucera
2000,103163,2321.733929,55,34,0,21,3,Tommy Haas
2010,104755,2321.678331,62,38,0,24,2,Richard Gasquet
1994,101320,2321.628633,41,30,0,11,25,Magnus Gustafsson
1994,101434,2321.539251,60,38,0,22,3,Petr Korda
1986,100757,2321.504148,47,32,0,15,13,Anders Jarryd
1997,101793,2321.427016,56,37,0,19,3,Jim Courier
1990,101191,2321.378761,62,37,0,25,1,Richey Reneberg
2006,103970,2321.22749,67,41,0,26,2,David Ferrer
2003,102035,2321.144488,53,32,0,21,2,Jonas Bjorkman
2006,104098,2321.084069,77,46,0,31,2,Dmitry Tursunov
1987,101147,2321.055056,47,30,0,17,4,Claudio Mezzadri
2014,104545,2321.042075,60,39,0,21,2,John Isner
1990,101649,2320.853373,62,41,0,21,2,Guillermo Perez Roldan
2004,103344,2320.797699,61,37,0,24,2,Ivan Ljubicic
2003,103096,2320.661261,51,31,0,20,3,Arnaud Clement
1989,101686,2320.480848,35,23,0,12,17,Franco Davin
2000,102021,2320.352747,68,42,0,26,3,Michael Chang
2009,103990,2320.346288,71,46,0,25,2,Tommy Robredo
1997,103017,2320.286537,42,26,0,16,2,Nicolas Kiefer
1987,101736,2320.13158,38,22,0,16,2,Andre Agassi
1990,101086,2319.746896,58,33,0,25,2,Ronald Agenor
2005,103909,2319.698898,82,55,0,27,1,Guillermo Coria
1997,101320,2319.655938,46,26,0,20,2,Magnus Gustafsson
2008,104339,2319.530294,49,32,0,17,2,Mario Ancic
2014,104731,2319.293271,63,39,0,24,2,Kevin Anderson
1989,100870,2318.924079,43,28,0,15,3,Christo Van Rensburg
2009,104527,2318.909017,51,31,0,20,2,Stanislas Wawrinka
1986,101195,2318.820542,41,23,0,18,3,Amos Mansdorf
1993,102238,2318.726864,48,29,0,19,3,Alberto Berasategui
1991,100581,2318.632197,52,34,0,18,3,John Mcenroe
1987,101195,2318.48222,57,35,0,22,2,Amos Mansdorf
1991,101404,2318.126327,49,30,0,19,4,Thomas Muster
1988,100653,2317.962057,55,36,0,19,3,Andres Gomez
1985,100934,2317.855557,27,17,0,10,4,Matt Anger
2004,103602,2317.83546,62,41,0,21,2,Fernando Gonzalez
2004,102257,2317.798391,42,26,0,16,3,Greg Rusedski
2010,104198,2317.740291,54,31,0,23,4,Guillermo Garcia Lopez
1993,101195,2317.523983,68,44,0,24,3,Amos Mansdorf
1990,101062,2317.085563,34,21,0,13,1,Mats Wilander
1991,101613,2317.017262,55,33,0,22,3,Malivai Washington
2008,103852,2316.98935,53,27,0,26,0,Feliciano Lopez
1999,102856,2316.930185,74,49,0,25,1,Gustavo Kuerten
2008,103720,2316.908671,31,20,0,11,12,Lleyton Hewitt
2015,105311,2316.905635,69,38,0,31,5,Joao Sousa
2008,104755,2316.831018,54,32,0,22,3,Richard Gasquet
2003,101962,2316.787406,68,41,0,27,2,Younes El Aynaoui
1993,101990,2316.733845,58,36,0,22,4,Richard Krajicek
2007,103285,2316.458515,50,28,0,22,4,Radek Stepanek
1997,101404,2316.378658,70,46,0,24,1,Thomas Muster
1996,101711,2316.196992,28,18,0,10,3,Alex Obrien
1992,101381,2316.183768,46,31,0,15,16,Aaron Krickstein
2005,103387,2316.170669,66,35,0,31,3,Paradorn Srichaphan
2002,103484,2316.040496,61,36,0,25,2,James Blake
2005,103017,2315.816005,56,33,0,23,2,Nicolas Kiefer
2004,103285,2315.755489,57,30,0,27,2,Radek Stepanek
1995,101084,2315.4627,62,34,0,28,3,Jakob Hlasek
1993,101409,2315.339255,57,35,0,22,3,Jaime Yzaga
2002,102765,2314.923525,48,30,0,18,2,Nicolas Escude
1985,100530,2314.224089,42,28,0,14,6,Andreas Maurer
1995,101990,2314.139177,67,41,0,26,3,Richard Krajicek
1996,101589,2314.057356,59,31,0,28,1,Arnaud Boetsch
1985,101036,2314.03294,51,36,0,15,9,Miloslav Mecir
2001,102839,2313.869694,55,30,0,25,2,Nicolas Lapentti
1991,101772,2313.850855,73,42,0,31,3,Andrei Cherkasov
1991,101191,2313.786233,50,32,0,18,3,Richey Reneberg
2014,104468,2313.70107,53,28,0,25,2,Gilles Simon
1985,100946,2313.652991,48,27,0,21,5,Slobodan Zivojinovic
2009,103163,2313.497917,49,31,0,18,2,Tommy Haas
1991,101532,2313.454235,64,38,0,26,3,Francisco Clavet
2013,105227,2313.307566,39,26,0,13,3,Marin Cilic
2001,102271,2313.108753,56,31,0,25,2,Hicham Arazi
2011,104338,2312.77295,59,31,0,28,0,Juan Monaco
1989,101320,2312.663266,41,23,0,18,5,Magnus Gustafsson
2010,103566,2312.640153,51,29,0,22,0,Michael Llodra
1996,102446,2312.59851,56,34,0,22,7,Andrei Medvedev
2012,104053,2312.356955,39,23,0,16,12,Andy Roddick
1990,101309,2312.194394,50,32,0,18,3,Jay Berger
1989,101230,2311.906405,48,30,0,18,4,Andrei Chesnokov
1995,101647,2311.888033,56,30,0,26,0,Byron Black
1995,101613,2311.697608,56,28,0,28,3,Malivai Washington
2003,104068,2311.685872,50,31,0,19,2,Robby Ginepri
2005,103694,2311.634565,64,37,0,27,2,Olivier Rochus
1996,102563,2311.609173,49,28,0,21,3,Thomas Johansson
1990,101098,2311.412675,61,38,0,23,1,Guy Forget
1998,101733,2311.372502,65,41,0,24,3,Jan Siemerink
2006,103103,2311.164963,60,32,0,28,2,Dominik Hrbaty
2001,103900,2310.948405,26,17,0,9,7,David Nalbandian
1987,101298,2310.883726,42,24,0,18,4,Jonas Svensson
1985,100617,2310.876354,43,26,0,17,4,Bud Schultz
1992,102358,2310.811833,25,16,0,9,5,Thomas Enqvist
2013,104792,2310.683678,55,33,0,22,5,Gael Monfils
1992,101142,2310.520193,75,48,0,27,0,Emilio Sanchez
1996,101611,2310.225047,67,44,0,23,0,Cedric Pioline
2002,103096,2310.194368,59,33,0,26,2,Arnaud Clement
1985,101084,2309.847677,54,31,0,23,5,Jakob Hlasek
1995,102882,2309.787865,44,26,0,18,5,Mark Philippoussis
2001,102456,2309.7746,46,26,0,20,3,Felix Mantilla
1992,101404,2309.6659,62,39,0,23,3,Thomas Muster
2004,104417,2309.642793,59,31,0,28,2,Robin Soderling
2007,103813,2309.34628,60,33,0,27,2,Jarkko Nieminen
1992,101723,2309.321196,50,30,0,20,3,Magnus Larsson
1997,102446,2309.316548,58,34,0,24,4,Andrei Medvedev
1994,101098,2309.199722,39,22,0,17,3,Guy Forget
1992,101185,2309.186486,50,27,0,23,3,Mark Woodforde
2007,104468,2309.172756,61,35,0,26,2,Gilles Simon
1987,100901,2309.156201,47,28,0,19,4,Paul Annacone
2006,103694,2309.01034,53,33,0,20,2,Olivier Rochus
1988,100713,2308.391557,57,36,0,21,2,John Fitzgerald
1992,101334,2308.157009,80,47,0,33,0,Alexander Volkov
1997,103031,2308.142124,32,21,0,11,2,Julian Alonso
2013,104471,2308.078584,60,33,0,27,3,Ivan Dodig
1989,101232,2307.819192,23,15,0,8,5,Nicklas Kroon
1989,101439,2307.790622,46,26,0,20,2,Javier Sanchez
1993,101723,2307.721277,59,32,0,27,0,Magnus Larsson
2007,104214,2307.698849,60,34,0,26,0,Igor Andreev
2009,104571,2307.695018,40,24,0,16,6,Marcos Baghdatis
2001,102610,2307.481168,49,27,0,22,2,Albert Costa
1988,101276,2307.467454,44,27,0,17,2,Horacio De La Pena
2002,102854,2307.41884,66,37,0,29,2,Sjeng Schalken
2000,103819,2307.384396,66,36,0,30,2,Roger Federer
1985,100434,2307.363746,77,49,0,28,0,Tomas Smid
2007,103602,2307.255441,57,35,0,22,1,Fernando Gonzalez
2005,103206,2306.859526,53,30,0,23,2,Sebastien Grosjean
2012,104571,2306.832308,60,35,0,25,3,Marcos Baghdatis
1989,101606,2306.79887,54,37,0,17,2,Alberto Mancini
2010,104269,2306.734884,65,43,0,22,2,Fernando Verdasco
1992,101063,2306.64627,54,32,0,22,4,Jordi Arrese
1985,101061,2306.398145,53,32,0,21,8,Jimmy Arias
1989,100529,2306.286161,51,33,0,18,3,Kevin Curren
2010,104597,2306.248187,70,44,0,26,2,Nicolas Almagro
1990,101843,2305.89107,57,33,0,24,2,Sergi Bruguera
1996,101806,2305.804806,49,25,0,24,5,Marc Kevin Goellner
2008,103888,2305.68739,55,32,0,23,3,Mardy Fish
2014,105023,2305.515504,50,28,0,22,2,Sam Querrey
1996,101792,2305.32525,34,21,0,13,14,Slava Dosedel
2014,104755,2305.265181,51,31,0,20,0,Richard Gasquet
2004,103206,2305.22792,43,28,0,15,11,Sebastien Grosjean
1998,101727,2305.153922,59,35,0,24,2,Jason Stoltenberg
2011,103507,2304.863301,31,20,0,11,3,Juan Carlos Ferrero
1996,101191,2304.779741,63,38,0,25,3,Richey Reneberg
1997,101611,2304.708276,65,37,0,28,2,Cedric Pioline
1995,102024,2304.694386,42,25,0,17,3,Hernan Gumy
1993,101318,2304.640399,32,21,0,11,3,Javier Frana
2000,102845,2304.366094,53,32,0,21,3,Carlos Moya
1991,101368,2304.216654,17,12,0,5,3,Christian Miniussi
1996,102374,2304.144436,63,37,0,26,0,Alex Corretja
2013,103917,2304.108308,24,17,0,7,3,Nicolas Mahut
2005,104269,2304.039308,63,35,0,28,2,Fernando Verdasco
1986,100815,2303.863031,58,35,0,23,3,David Pate
2001,103990,2303.713326,57,37,0,20,2,Tommy Robredo
2010,103656,2303.702092,62,38,0,24,2,Albert Montanes
2011,103900,2303.323661,35,22,0,13,7,David Nalbandian
2008,104527,2303.319882,59,38,0,21,2,Stanislas Wawrinka
1986,100920,2303.123629,31,19,0,12,16,Robert Seguso
2001,102257,2302.792117,63,39,0,24,2,Greg Rusedski
2004,103292,2302.749206,61,37,0,24,1,Gaston Gaudio
1988,101309,2302.486082,45,29,0,16,5,Jay Berger
1997,102162,2302.410165,56,35,0,21,3,Chris Woodruff
1995,101888,2302.278539,63,31,0,32,3,Daniel Vacek
1993,101439,2302.277956,70,39,0,31,3,Javier Sanchez
1995,102539,2302.242338,51,31,0,20,3,Bohdan Ulihrach
2004,103990,2302.223314,69,43,0,26,0,Tommy Robredo
2011,104527,2302.162674,56,36,0,20,3,Stanislas Wawrinka
1986,100532,2301.967442,35,21,0,14,3,Johan Kriek
1995,101733,2301.723589,67,38,0,29,3,Jan Siemerink
1988,101391,2301.671299,48,28,0,20,0,Carl Uwe Steeb
1994,101191,2301.587388,57,33,0,24,3,Richey Reneberg
1985,100529,2301.58491,38,25,0,13,9,Kevin Curren
1992,101761,2301.554296,52,31,0,21,3,Jaime Oncins
1991,100284,2301.387872,33,19,0,14,0,Jimmy Connors
1999,101793,2301.375255,52,31,0,21,3,Jim Courier
1998,102401,2301.256075,40,23,0,17,11,Scott Draper
1989,100757,2301.230371,38,23,0,15,5,Anders Jarryd
2015,104792,2301.198642,52,34,0,18,3,Gael Monfils
1994,101120,2300.880659,70,38,0,32,0,Karel Novacek
1987,100954,2300.831038,47,29,0,18,2,Luiz Mattar
2013,103852,2300.741732,50,30,0,20,3,Feliciano Lopez
1991,101358,2300.732559,30,19,0,11,4,Olivier Delaitre
2002,102701,2300.702656,53,32,0,21,2,Marcelo Rios
1996,101647,2300.624457,65,37,0,28,3,Byron Black
1993,101298,2300.475816,62,34,0,28,4,Jonas Svensson
1999,102765,2300.406189,37,20,0,17,2,Nicolas Escude
1990,101440,2300.273268,45,26,0,19,1,Mark Koevermans
2013,105668,2300.23847,47,27,0,20,3,Jerzy Janowicz
1988,100920,2299.99438,35,21,0,14,3,Robert Seguso
2015,105777,2299.646014,55,33,0,22,3,Grigor Dimitrov
1988,100532,2299.586634,43,25,0,18,4,Johan Kriek
1996,101820,2299.489285,68,39,0,29,0,Marc Rosset
2013,104259,2299.484428,60,34,0,26,3,Philipp Kohlschreiber
2010,104545,2299.462141,62,38,0,24,2,John Isner
1994,102247,2299.396044,69,38,0,31,3,Andrea Gaudenzi
2007,103084,2299.295716,61,40,0,21,2,Guillermo Canas
2000,102035,2299.015014,55,30,0,25,2,Jonas Bjorkman
2010,103344,2298.858575,46,26,0,20,2,Ivan Ljubicic
2015,103333,2298.497856,63,38,0,25,3,Ivo Karlovic
2002,102338,2298.386607,66,39,0,27,0,Yevgeny Kafelnikov
2007,103507,2298.36298,57,34,0,23,2,Juan Carlos Ferrero
2004,104745,2298.251702,48,30,0,18,0,Rafael Nadal
2008,103970,2298.232329,67,44,0,23,0,David Ferrer
1988,100757,2298.201088,44,29,0,15,6,Anders Jarryd
1992,101026,2298.149869,55,31,0,24,3,Jim Grabb
1997,101774,2298.130687,20,13,0,7,3,Todd Martin
2010,104607,2297.918852,71,45,0,26,1,Tomas Berdych
1995,102446,2297.852901,67,41,0,26,0,Andrei Medvedev
1994,101727,2297.719204,63,38,0,25,3,Jason Stoltenberg
2005,102845,2297.584654,52,32,0,20,4,Carlos Moya
2013,104719,2297.457904,51,27,0,24,3,Marcel Granollers
2003,103206,2297.40177,57,36,0,21,2,Sebastien Grosjean
2004,103280,2297.306159,45,26,0,19,19,Martin Verkerk
1993,100923,2297.278914,61,38,0,23,0,Wally Masur
2010,105208,2297.156939,51,31,0,20,2,Ernests Gulbis
1991,101481,2297.094326,65,38,0,27,4,Omar Camporese
2010,104338,2296.912643,50,30,0,20,2,Juan Monaco
2012,104259,2296.590869,67,42,0,25,3,Philipp Kohlschreiber
2009,104338,2296.575834,62,36,0,26,2,Juan Monaco
2005,103813,2296.556808,55,33,0,22,2,Jarkko Nieminen
2006,103096,2296.547782,49,27,0,22,2,Arnaud Clement
2000,102860,2296.488653,19,13,0,6,9,Agustin Calleri
1991,101761,2296.466346,44,27,0,17,3,Jaime Oncins
1985,100857,2296.36952,31,20,0,11,6,Sergio Casal
2001,101964,2296.320577,52,30,0,22,1,Goran Ivanisevic
2000,102644,2296.259945,58,34,0,24,3,Franco Squillari
2003,102227,2296.187204,54,28,0,26,3,Sargis Sargsian
2014,105208,2296.147738,62,41,0,21,3,Ernests Gulbis
1998,102998,2296.000482,56,32,0,24,4,Jan Michael Gambill
1994,101230,2295.853075,68,38,0,30,3,Andrei Chesnokov
2002,103990,2295.839064,59,33,0,26,2,Tommy Robredo
2015,106071,2295.786343,68,40,0,28,3,Bernard Tomic
1997,101889,2295.74528,52,32,0,20,3,Todd Woodbridge
2012,104022,2295.533205,55,33,0,22,3,Mikhail Youzhny
1988,100752,2295.502288,47,31,0,16,17,Ramesh Krishnan
1985,100631,2295.471908,64,36,0,28,4,Tim Wilkison
2015,104926,2295.400545,58,32,0,26,3,Fabio Fognini
2013,104269,2295.364119,53,29,0,24,3,Fernando Verdasco
1997,101965,2295.239046,52,29,0,23,5,Wayne Ferreira
1997,102856,2295.152973,61,36,0,25,2,Gustavo Kuerten
1988,100870,2295.08867,39,24,0,15,3,Christo Van Rensburg
2011,103285,2294.941148,55,31,0,24,3,Radek Stepanek
2010,103720,2294.762427,34,22,0,12,11,Lleyton Hewitt
2001,103709,2294.699865,28,18,0,10,3,Kristian Pless
1987,100607,2294.461569,44,27,0,17,3,Eduardo Bengoechea
1986,101324,2294.407933,32,20,0,12,5,Ulf Stenlund
1987,101309,2294.347984,47,28,0,19,3,Jay Berger
1995,101889,2294.067436,56,32,0,24,3,Todd Woodbridge
1996,101185,2294.057098,57,32,0,25,0,Mark Woodforde
2000,102318,2293.637892,64,37,0,27,3,Andrei Pavel
1997,103103,2293.463378,50,27,0,23,7,Dominik Hrbaty
1997,101414,2293.407082,32,19,0,13,2,Boris Becker
1996,102610,2293.301733,81,52,0,29,3,Albert Costa
2007,103344,2293.259165,67,44,0,23,2,Ivan Ljubicic
1994,101609,2293.202304,46,28,0,18,3,David Wheaton
1993,101772,2293.180442,68,36,0,32,3,Andrei Cherkasov
2010,104571,2293.106945,70,43,0,27,5,Marcos Baghdatis
2000,102184,2293.084104,42,23,0,19,3,David Prinosil
1995,101334,2292.97239,62,34,0,28,3,Alexander Volkov
1998,103264,2292.952469,33,21,0,12,2,Mariano Puerta
1997,101843,2292.938398,77,49,0,28,1,Sergi Bruguera
2005,103970,2292.792405,72,43,0,29,2,David Ferrer
1987,100752,2292.495795,62,35,0,27,0,Ramesh Krishnan
2008,105208,2292.439428,46,24,0,22,3,Ernests Gulbis
2014,103898,2292.356685,50,26,0,24,2,Julien Benneteau
1990,101320,2292.338978,41,25,0,16,1,Magnus Gustafsson
2004,103786,2292.14623,62,33,0,29,2,Nikolay Davydenko
2006,102967,2292.0092,29,17,0,12,2,Marc Gicquel
2006,103835,2292.00763,60,34,0,26,3,Filippo Volandri
1999,102223,2291.951297,52,29,0,23,7,Karim Alami
2000,102231,2291.748248,30,20,0,10,4,Alex Calatrava
1993,101265,2291.62559,46,26,0,20,7,Patrick Mcenroe
2009,104386,2291.526836,55,30,0,25,3,Janko Tipsarevic
1985,100772,2291.508226,30,19,0,11,3,Kelly Evernden
2011,104719,2291.471759,52,27,0,25,3,Marcel Granollers
1998,101414,2291.47056,26,15,0,11,3,Boris Becker
1991,101649,2291.401435,43,26,0,17,4,Guillermo Perez Roldan
2000,103166,2291.3497,25,16,0,9,2,Vladimir Voltchkov
1985,100555,2291.178167,39,24,0,15,12,Jose Luis Clerc
1992,100923,2290.985291,70,40,0,30,0,Wally Masur
1996,101793,2290.911531,45,28,0,17,0,Jim Courier
2012,104269,2290.821207,54,32,0,22,3,Fernando Verdasco
2000,102446,2290.754373,40,23,0,17,19,Andrei Medvedev
1986,101276,2290.729162,60,38,0,22,2,Horacio De La Pena
2009,103656,2290.712308,46,25,0,21,2,Albert Montanes
2002,103454,2290.680436,48,29,0,19,3,Nicolas Massu
2003,103344,2290.666355,54,29,0,25,3,Ivan Ljubicic
2014,104259,2290.522914,63,37,0,26,2,Philipp Kohlschreiber
2011,104166,2290.461791,48,27,0,21,3,Alex Bogomolov Jr
1990,101686,2290.389192,53,33,0,20,1,Franco Davin
1989,100809,2290.323442,30,20,0,10,2,Juan Aguilera
1992,100936,2290.31914,38,21,0,17,0,Henri Leconte
2015,104180,2290.298246,57,33,0,24,5,Gilles Muller
1996,101613,2290.274807,58,33,0,25,0,Malivai Washington
1990,101138,2290.252648,28,18,0,10,1,Pat Cash
2005,102257,2290.166267,51,29,0,22,2,Greg Rusedski
2005,104339,2290.08219,71,44,0,27,0,Mario Ancic
1988,100901,2290.019571,43,25,0,18,3,Paul Annacone
2006,102703,2289.920855,39,23,0,16,5,Hyung Taik Lee
1997,101792,2289.864971,42,24,0,18,12,Slava Dosedel
2011,104597,2289.753795,70,47,0,23,3,Nicolas Almagro
2010,104259,2289.70524,63,37,0,26,2,Philipp Kohlschreiber
1985,100815,2289.408286,55,31,0,24,5,David Pate
1989,101098,2289.237046,25,15,0,10,4,Guy Forget
2008,104678,2289.223929,40,21,0,19,2,Viktor Troicki
1989,101382,2289.218682,48,28,0,20,2,Marcelo Filippini
2003,103428,2289.194538,63,36,0,27,2,Juan Ignacio Chela
1994,102446,2289.165294,52,34,0,18,0,Andrei Medvedev
1999,101320,2289.134296,42,22,0,20,2,Magnus Gustafsson
2001,102539,2289.036076,64,37,0,27,2,Bohdan Ulihrach
2012,105238,2288.884003,59,34,0,25,3,Alexandr Dolgopolov
2009,104545,2288.77428,45,27,0,18,2,John Isner
1990,101481,2288.730749,49,28,0,21,7,Omar Camporese
2008,103017,2288.582013,43,23,0,20,2,Nicolas Kiefer
1993,101191,2288.581929,64,38,0,26,3,Richey Reneberg
1999,103252,2288.568421,48,27,0,21,7,Alberto Martin
1995,102158,2288.553773,57,32,0,25,6,Patrick Rafter
1990,101190,2288.529423,41,22,0,19,1,Darren Cahill
2002,102358,2288.48877,46,28,0,18,3,Thomas Enqvist
2011,103344,2288.463172,44,25,0,19,4,Ivan Ljubicic
2014,106058,2288.338142,47,27,0,20,2,Jack Sock
2008,104597,2288.256937,53,36,0,17,4,Nicolas Almagro
2001,102783,2288.249095,64,33,0,31,3,Rainer Schuettler
1996,101529,2288.194806,40,25,0,15,0,Michael Stich
1985,100950,2288.161418,46,25,0,21,6,Libor Pimek
2004,102642,2288.13527,51,28,0,23,2,Cyril Saulnier
1996,102093,2288.106253,63,34,0,29,3,Martin Damm
1993,101924,2288.075879,30,15,0,15,6,Stefano Pescosolido
1999,102148,2288.015264,62,37,0,25,2,Fabrice Santoro
1986,100855,2287.669328,38,19,0,19,3,Scott Davis
2010,103813,2287.537643,58,30,0,28,2,Jarkko Nieminen
1985,101106,2287.457867,12,8,0,4,8,Peter Lundgren
2013,104898,2287.400798,56,30,0,26,3,Robin Haase
1994,101792,2287.360441,61,36,0,25,3,Slava Dosedel
2006,104068,2287.319472,48,23,0,25,2,Robby Ginepri
1993,102247,2287.092162,27,17,0,10,6,Andrea Gaudenzi
1989,100772,2287.058293,50,32,0,18,4,Kelly Evernden
2015,103852,2286.795999,58,32,0,26,3,Feliciano Lopez
1985,100343,2286.443924,47,26,0,21,4,John Lloyd
2001,103484,2286.417789,22,13,0,9,5,James Blake
2007,103852,2286.410785,52,27,0,25,2,Feliciano Lopez
1998,101404,2286.404726,52,32,0,20,3,Thomas Muster
2015,106401,2286.403384,44,25,0,19,5,Nick Kyrgios
1995,102610,2286.328372,55,33,0,22,3,Albert Costa
2003,103484,2286.236207,58,32,0,26,2,James Blake
1999,102259,2286.216964,35,22,0,13,21,Jerome Golmard
1989,101026,2286.055679,47,27,0,20,2,Jim Grabb
1989,101404,2286.047964,30,20,0,10,2,Thomas Muster
1999,102021,2286.010456,49,27,0,22,2,Michael Chang
1991,101190,2285.98623,21,15,0,6,43,Darren Cahill
2008,103333,2285.917238,57,31,0,26,2,Ivo Karlovic
1999,102450,2285.849583,72,44,0,28,2,Tim Henman
1995,101434,2285.810077,50,27,0,23,0,Petr Korda
1990,100809,2285.654325,50,31,0,19,1,Juan Aguilera
1990,100936,2285.606714,42,25,0,17,0,Henri Leconte
1992,101609,2285.519586,53,30,0,23,3,David Wheaton
2001,102765,2285.340757,56,33,0,23,0,Nicolas Escude
1991,101733,2285.282735,51,30,0,21,3,Jan Siemerink
2009,104259,2285.001383,67,40,0,27,2,Philipp Kohlschreiber
2001,103813,2284.608624,9,7,0,2,3,Jarkko Nieminen
2002,103428,2284.527489,76,47,0,29,2,Juan Ignacio Chela
2000,102998,2284.411885,61,33,0,28,2,Jan Michael Gambill
1996,101889,2284.379536,61,37,0,24,4,Todd Woodbridge
2005,104792,2284.257343,47,25,0,22,3,Gael Monfils
2004,102434,2284.228047,68,40,0,28,2,Vincent Spadea
2014,104655,2284.227809,30,18,0,12,2,Pablo Cuevas
1998,101965,2284.119513,60,33,0,27,2,Wayne Ferreira
1993,101235,2284.049007,60,33,0,27,3,Paul Haarhuis
1999,101611,2283.835731,75,43,0,32,0,Cedric Pioline
1989,101434,2283.815304,21,13,0,8,6,Petr Korda
1990,101511,2283.716482,53,31,0,22,1,Horst Skoff
2007,104527,2283.665288,45,21,0,24,2,Stanislas Wawrinka
2002,101965,2283.63563,42,24,0,18,6,Wayne Ferreira
1985,100752,2283.610141,54,27,0,27,6,Ramesh Krishnan
1988,101793,2283.588036,36,21,0,15,2,Jim Courier
2002,103166,2283.472582,17,11,0,6,3,Vladimir Voltchkov
1992,101320,2283.415008,54,31,0,23,5,Magnus Gustafsson
1995,101475,2283.314515,54,30,0,24,4,Carlos Costa
1990,101723,2283.298707,24,15,0,9,1,Magnus Larsson
1999,103498,2283.202502,71,39,0,32,2,Marat Safin
2015,104571,2283.157421,45,26,0,19,6,Marcos Baghdatis
1999,103387,2282.902651,20,13,0,7,6,Paradorn Srichaphan
1999,102374,2282.887861,59,36,0,23,3,Alex Corretja
1990,101276,2282.759791,34,20,0,14,1,Horacio De La Pena
2005,104918,2282.739961,24,14,0,10,3,Andy Murray
1988,101190,2282.650725,56,32,0,24,7,Darren Cahill
2008,103781,2282.630698,56,30,0,26,3,Jurgen Melzer
1993,101185,2282.596968,52,30,0,22,3,Mark Woodforde
2004,102905,2282.539172,50,24,0,26,3,Stefan Koubek
2002,102610,2282.538993,57,35,0,22,1,Albert Costa
1996,101532,2282.46202,65,37,0,28,3,Francisco Clavet
1999,103507,2282.352636,24,16,0,8,2,Juan Carlos Ferrero
1990,101900,2282.351822,26,15,0,11,1,Nicklas Kulti
2008,103812,2282.264854,45,23,0,22,3,Victor Hanescu
2014,105064,2282.262401,31,18,0,13,3,Thomaz Bellucci
1994,101185,2282.259835,57,30,0,27,3,Mark Woodforde
2010,103428,2282.230309,52,28,0,24,2,Juan Ignacio Chela
1985,100855,2282.230226,58,37,0,21,0,Scott Davis
1986,100942,2282.08065,65,41,0,24,3,Thierry Tulasne
1985,100829,2281.961826,50,30,0,20,6,Jan Gunnarsson
2013,104468,2281.912197,60,36,0,24,3,Gilles Simon
1992,101412,2281.79461,40,24,0,16,7,Shuzo Matsuoka
1992,100763,2281.783551,65,39,0,26,3,Brad Gilbert
1987,100434,2281.626415,56,30,0,26,2,Tomas Smid
1986,101404,2281.559636,40,22,0,18,7,Thomas Muster
1986,100536,2281.491029,35,21,0,14,10,Fernando Luna
2010,103898,2281.370423,45,26,0,19,13,Julien Benneteau
1987,101117,2281.337943,48,24,0,24,6,Eric Jelen
1987,101086,2281.276657,45,25,0,20,3,Ronald Agenor
2007,104417,2281.234434,42,26,0,16,15,Robin Soderling
1990,101063,2280.916504,47,26,0,21,2,Jordi Arrese
2010,105023,2280.889004,63,39,0,24,2,Sam Querrey
1999,101888,2280.657458,61,30,0,31,2,Daniel Vacek
2012,105373,2280.409854,34,19,0,15,3,Martin Klizan
2014,105373,2280.360482,42,25,0,17,3,Martin Klizan
1998,102610,2280.328305,73,47,0,26,1,Albert Costa
2000,103264,2280.19925,61,40,0,21,3,Mariano Puerta
1998,103151,2280.171082,22,14,0,8,2,Mariano Zabaleta
2002,102202,2280.158646,33,19,0,14,2,Kenneth Carlsen
2000,102701,2280.152134,53,30,0,23,6,Marcelo Rios
1987,100790,2279.961029,17,12,0,5,12,Bruce Derlin
2008,103507,2279.903432,36,21,0,15,3,Juan Carlos Ferrero
1989,101843,2279.858336,36,23,0,13,13,Sergi Bruguera
1993,101806,2279.761014,64,38,0,26,1,Marc Kevin Goellner
2000,102563,2279.604137,48,22,0,26,2,Thomas Johansson
2003,103292,2279.573105,66,40,0,26,2,Gaston Gaudio
1992,101084,2279.554402,60,32,0,28,1,Jakob Hlasek
2012,105777,2279.488594,43,24,0,19,3,Grigor Dimitrov
2001,103356,2279.389384,52,27,0,25,3,Michel Kratochvil
1987,100967,2279.312285,41,23,0,18,4,Dan Goldie
1987,100955,2279.025542,9,8,0,1,28,Yahiya Doumbia
2013,103720,2279.00768,42,24,0,18,6,Lleyton Hewitt
1994,101884,2278.917554,6,6,0,0,10,Frank Ofori
1989,101030,2278.733467,26,15,0,11,5,Goran Prpic
2004,102765,2278.711407,26,17,0,9,16,Nicolas Escude
1989,100829,2278.641655,40,22,0,18,5,Jan Gunnarsson
1990,101381,2278.624925,63,37,0,26,0,Aaron Krickstein
2004,103387,2278.440898,74,44,0,30,2,Paradorn Srichaphan
1991,101990,2278.394899,46,26,0,20,3,Richard Krajicek
1986,100631,2278.36966,56,33,0,23,5,Tim Wilkison
2007,102563,2278.353421,51,27,0,24,3,Thomas Johansson
1987,100936,2278.287016,44,23,0,21,3,Henri Leconte
2014,103333,2278.270373,64,36,0,28,2,Ivo Karlovic
1987,101404,2278.199754,44,26,0,18,9,Thomas Muster
2000,102839,2278.150537,73,44,0,29,3,Nicolas Lapentti
2013,104098,2278.144415,53,31,0,22,3,Dmitry Tursunov
2012,104792,2278.105549,29,19,0,10,6,Gael Monfils
1992,101532,2278.09283,68,39,0,29,3,Francisco Clavet
2012,104327,2278.029427,40,22,0,18,6,Steve Darcis
1992,101475,2277.953499,61,40,0,21,3,Carlos Costa
1997,101727,2277.865811,36,21,0,15,12,Jason Stoltenberg
1988,100536,2277.840967,30,18,0,12,13,Fernando Luna
1988,100923,2277.840485,44,26,0,18,2,Wally Masur
1994,102035,2277.839367,57,31,0,26,0,Jonas Bjorkman
2004,102856,2277.782469,36,23,0,13,11,Gustavo Kuerten
2004,103566,2277.75726,32,20,0,12,2,Michael Llodra
1989,100676,2277.710555,39,22,0,17,5,Yannick Noah
1995,101582,2277.612737,73,43,0,30,3,Gilbert Schaller
1994,102148,2277.503727,42,24,0,18,3,Fabrice Santoro
1988,101382,2277.461442,44,27,0,17,2,Marcelo Filippini
1997,101897,2277.453243,46,25,0,21,2,Fernando Meligeni
1996,101727,2277.42701,64,37,0,27,0,Jason Stoltenberg
1989,101287,2277.386717,6,6,0,0,22,Denis Langaskens
1989,101124,2277.377726,38,24,0,14,3,Paolo Cane
2012,103607,2277.370273,6,6,0,0,11,Victor Estrella
2002,103598,2277.350101,55,32,0,23,2,Xavier Malisse
2007,102148,2277.340961,43,24,0,19,2,Fabrice Santoro
1997,101529,2277.267795,30,17,0,13,21,Michael Stich
1988,101439,2277.259653,39,21,0,18,2,Javier Sanchez
1989,101820,2277.197215,9,7,0,2,11,Marc Rosset
1993,101649,2277.172182,33,20,0,13,11,Guillermo Perez Roldan
2010,104907,2277.039953,8,7,0,1,11,Jose Rubin Statham
1988,106782,2277.019733,6,6,0,0,23,Colin Grant
2008,105453,2276.994515,29,17,0,12,5,Kei Nishikori
2009,104755,2276.659893,38,23,0,15,3,Richard Gasquet
1991,101439,2276.518918,64,36,0,28,3,Javier Sanchez
2012,105464,2276.508211,6,6,0,0,11,Christopher Rungkat
1991,101377,2276.387132,54,31,0,23,4,Christian Bergstrom
2000,102344,2276.279062,51,27,0,24,3,Karol Kucera
1997,102238,2276.231145,66,39,0,27,2,Alberto Berasategui
1998,102539,2276.052019,63,34,0,29,2,Bohdan Ulihrach
1998,103387,2275.958164,6,6,0,0,9,Paradorn Srichaphan
1988,101369,2275.937895,6,6,0,0,29,Bent Ove Pedersen
2000,103060,2275.834843,8,7,0,1,20,Alejandro Hernandez
2011,105683,2275.819647,51,32,0,19,3,Milos Raonic
1995,102029,2275.771522,27,14,0,13,3,Filip Dewulf
2003,103990,2275.734728,64,38,0,26,2,Tommy Robredo
1991,101214,2275.687647,29,17,0,12,7,Bryan Shelton
2002,103909,2275.622297,38,22,0,16,2,Guillermo Coria
1989,101117,2275.467833,36,22,0,14,4,Eric Jelen
1995,101532,2275.459178,58,31,0,27,3,Francisco Clavet
1992,101195,2275.444979,62,35,0,27,4,Amos Mansdorf
2008,102845,2275.415754,51,28,0,23,4,Carlos Moya
2000,102843,2275.39767,6,6,0,0,9,Suwandi Suwandi
2014,105985,2275.369996,6,6,0,0,9,Darian King
2003,102860,2275.316894,57,34,0,23,2,Agustin Calleri
1996,102184,2275.277797,55,26,0,29,3,David Prinosil
2004,103758,2275.270063,57,32,0,25,2,Taylor Dent
1988,101185,2275.253031,56,31,0,25,4,Mark Woodforde
1991,101150,2275.249229,29,16,0,13,3,Gianluca Pozzi
2006,104252,2275.186458,47,26,0,21,3,Florian Mayer
2013,104252,2275.136528,55,29,0,26,5,Florian Mayer
1987,101647,2275.036308,6,6,0,0,33,Byron Black
1993,101890,2274.832177,51,28,0,23,3,Jonathan Stark
2010,103333,2274.63654,26,17,0,9,29,Ivo Karlovic
1996,102158,2274.391214,45,25,0,20,7,Patrick Rafter
1993,100656,2274.358399,56,33,0,23,3,Ivan Lendl
1989,101190,2274.178202,46,25,0,21,8,Darren Cahill
2011,104468,2273.961135,66,39,0,27,3,Gilles Simon
1990,101529,2273.905432,52,29,0,23,1,Michael Stich
1995,102839,2273.851412,11,9,0,2,10,Nicolas Lapentti
2007,102703,2273.82496,48,25,0,23,7,Hyung Taik Lee
1988,101234,2273.635702,34,18,0,16,0,Patrik Kuhnen
1991,101318,2273.608319,42,25,0,17,3,Javier Frana
1989,101298,2273.57536,49,29,0,20,5,Jonas Svensson
1999,103206,2273.559914,65,37,0,28,0,Sebastien Grosjean
1987,100529,2273.491569,38,21,0,17,3,Kevin Curren
1988,100946,2273.480776,45,27,0,18,6,Slobodan Zivojinovic
1994,102358,2273.300111,42,23,0,19,5,Thomas Enqvist
1993,101381,2273.233744,45,26,0,19,3,Aaron Krickstein
2000,102271,2273.218275,59,32,0,27,4,Hicham Arazi
1996,102539,2273.188266,68,35,0,33,3,Bohdan Ulihrach
2015,106233,2273.129771,64,36,0,28,3,Dominic Thiem
2010,105227,2273.031419,62,40,0,22,2,Marin Cilic
2004,103835,2272.896268,55,32,0,23,2,Filippo Volandri
1994,101611,2272.743039,62,31,0,31,3,Cedric Pioline
1994,101463,2272.66562,63,35,0,28,3,Bernd Karbacher
1989,101393,2272.557225,14,9,0,5,5,Jens Woehrmann
2006,104022,2272.491776,47,25,0,22,3,Mikhail Youzhny
1989,101086,2272.462469,41,24,0,17,5,Ronald Agenor
2014,104919,2272.30843,48,28,0,20,2,Leonardo Mayer
2012,103898,2272.307069,50,27,0,23,3,Julien Benneteau
1993,101230,2272.088458,68,38,0,30,4,Andrei Chesnokov
1999,102162,2271.544043,41,22,0,19,4,Chris Woodruff
2007,103428,2271.484414,62,39,0,23,2,Juan Ignacio Chela
2005,103325,2271.439582,29,17,0,12,3,Wesley Moodie
2006,104597,2271.437218,47,27,0,20,2,Nicolas Almagro
2003,103151,2271.374217,59,34,0,25,2,Mariano Zabaleta
1987,100815,2271.344272,43,26,0,17,3,David Pate
1992,101920,2271.287094,14,9,0,5,6,Jamie Morgan
1986,100956,2271.277898,21,14,0,7,12,Simone Colombo
2005,103758,2271.265601,54,33,0,21,2,Taylor Dent
2007,104542,2271.232306,24,14,0,10,2,Jo Wilfried Tsonga
1986,100782,2271.035228,45,26,0,19,9,Pablo Arraya
2008,103285,2271.015812,57,33,0,24,1,Radek Stepanek
2000,101723,2270.994917,19,13,0,6,26,Magnus Larsson
1986,101511,2270.941622,24,16,0,8,2,Horst Skoff
2004,103888,2270.881019,50,29,0,21,0,Mardy Fish
2001,102374,2270.874074,54,34,0,20,2,Alex Corretja
1998,103017,2270.823114,63,34,0,29,3,Nicolas Kiefer
1985,100586,2270.713581,35,22,0,13,13,Eliot Teltscher
2014,104269,2270.605469,46,26,0,20,2,Fernando Verdasco
2004,103103,2270.534153,69,43,0,26,2,Dominik Hrbaty
2007,104534,2270.473541,15,10,0,5,7,Dudi Sela
1992,101391,2270.443809,62,34,0,28,3,Carl Uwe Steeb
1996,102521,2270.363246,45,24,0,21,5,Hendrik Dreekmann
1998,101723,2270.293395,36,19,0,17,8,Magnus Larsson
2008,103163,2270.291198,33,18,0,15,10,Tommy Haas
2014,104678,2270.280073,12,8,0,4,4,Viktor Troicki
2010,103285,2270.149876,35,19,0,16,2,Radek Stepanek
1988,101196,2270.130139,53,31,0,22,3,Derrick Rostagno
1991,100795,2270.068061,8,7,0,1,10,Alvaro Jordan
2006,103888,2269.94329,41,23,0,18,3,Mardy Fish
1990,100972,2269.89464,43,23,0,20,5,Todd Witsken
2004,102148,2269.679156,34,18,0,16,8,Fabrice Santoro
1995,101611,2269.614532,55,27,0,28,0,Cedric Pioline
1986,101124,2269.589924,39,23,0,16,6,Paolo Cane
1996,101843,2269.583895,47,26,0,21,4,Sergi Bruguera
1999,101962,2269.337858,52,29,0,23,2,Younes El Aynaoui
1994,101358,2269.201486,46,23,0,23,3,Olivier Delaitre
2011,104571,2269.17903,55,28,0,27,4,Marcos Baghdatis
1995,101191,2269.150886,45,22,0,23,3,Richey Reneberg
2004,103490,2268.98432,10,8,0,2,17,Santiago Ventura
1991,101265,2268.898979,50,29,0,21,0,Patrick Mcenroe
1990,100855,2268.861018,46,24,0,22,1,Scott Davis
1998,101611,2268.779148,70,41,0,29,2,Cedric Pioline
2005,103163,2268.757348,54,31,0,23,2,Tommy Haas
2011,106071,2268.644411,31,16,0,15,7,Bernard Tomic
1986,100689,2268.429371,44,27,0,17,3,Tim Mayotte
1993,102375,2268.37504,9,7,0,2,11,Dinu Pescariu
1994,101318,2268.252469,28,15,0,13,3,Javier Frana
2007,104259,2268.165554,60,33,0,27,3,Philipp Kohlschreiber
1991,101511,2268.132225,64,34,0,30,3,Horst Skoff
1988,100990,2268.106883,54,31,0,23,2,Milan Srejber
2003,104417,2268.076153,16,10,0,6,3,Robin Soderling
1987,101004,2268.029838,42,23,0,19,4,Jim Pugh
2003,101774,2267.970014,29,16,0,13,10,Todd Martin
2010,104386,2267.825409,48,25,0,23,0,Janko Tipsarevic
1993,101601,2267.662942,62,33,0,29,0,Brett Steven
1986,100434,2267.631211,57,31,0,26,4,Tomas Smid
2014,104338,2267.414507,42,22,0,20,4,Juan Monaco
2009,104500,2267.300922,16,11,0,5,9,Somdev Devvarman
1991,101409,2267.278072,41,24,0,17,0,Jaime Yzaga
1997,103163,2267.255969,39,22,0,17,2,Tommy Haas
2010,104252,2267.226523,42,23,0,19,3,Florian Mayer
1988,101063,2267.178011,30,18,0,12,13,Jordi Arrese
2011,104180,2267.121792,29,17,0,12,3,Gilles Muller
1997,101703,2267.081446,53,27,0,26,2,Guillaume Raoux
1994,100656,2267.015422,46,28,0,18,12,Ivan Lendl
1989,108844,2267.011778,5,5,0,0,22,Hamed Ul Haq
1991,101230,2266.990188,51,29,0,22,4,Andrei Chesnokov
1987,101119,2266.918127,42,24,0,18,4,Marian Vajda
1999,102434,2266.910289,60,33,0,27,2,Vincent Spadea
2003,102271,2266.815106,45,24,0,21,2,Hicham Arazi
2012,103285,2266.71437,51,24,0,27,1,Radek Stepanek
2007,105223,2266.639835,53,28,0,25,2,Juan Martin Del Potro
1999,102845,2266.475857,61,37,0,24,3,Carlos Moya
1988,101374,2266.473827,22,12,0,10,9,Leonardo Lavalle
1986,101309,2266.453662,10,7,0,3,4,Jay Berger
1995,102538,2266.427505,5,5,0,0,10,Tuomas Ketola
1988,101073,2266.41695,51,29,0,22,2,Martin Jaite
2003,103602,2266.328454,62,37,0,25,2,Fernando Gonzalez
2012,104871,2266.240231,44,24,0,20,3,Jeremy Chardy
2001,102369,2266.18904,50,25,0,25,2,Julien Boutter
1994,101601,2266.185988,49,24,0,25,6,Brett Steven
1986,101120,2266.174577,30,16,0,14,5,Karel Novacek
2003,103813,2266.118496,70,41,0,29,2,Jarkko Nieminen
2010,103786,2266.112068,50,30,0,20,2,Nikolay Davydenko
1988,100607,2266.091229,41,20,0,21,2,Eduardo Bengoechea
2005,103018,2266.049684,60,35,0,25,2,Max Mirnyi
1999,102562,2265.931232,55,29,0,26,2,Jiri Novak
2006,103598,2265.918097,55,31,0,24,2,Xavier Malisse
1991,100653,2265.822839,39,20,0,19,3,Andres Gomez
2011,103813,2265.737366,48,23,0,25,4,Jarkko Nieminen
2000,102148,2265.721935,61,34,0,27,2,Fabrice Santoro
2004,103592,2265.662924,10,7,0,3,3,Jerome Haehnel
1994,102119,2265.498007,5,5,0,0,30,Chih Jung Chen
1991,101365,2265.471666,7,6,0,1,11,Paul Wekesa
1995,102238,2265.456054,67,36,0,31,3,Alberto Berasategui
1991,107263,2265.44643,5,5,0,0,20,Jacques Radoux
2011,104678,2265.444241,66,40,0,26,3,Viktor Troicki
2012,105064,2265.401126,51,28,0,23,0,Thomaz Bellucci
1988,101098,2265.369622,43,24,0,19,4,Guy Forget
2001,102259,2265.332306,48,27,0,21,6,Jerome Golmard
1995,100955,2265.256437,5,5,0,0,12,Yahiya Doumbia
2015,105577,2265.208908,48,25,0,23,5,Vasek Pospisil
2003,102434,2265.177438,59,34,0,25,2,Vincent Spadea
2004,102318,2265.174026,59,34,0,25,2,Andrei Pavel
2010,104979,2265.111797,45,24,0,21,2,Andrey Golubev
2014,104871,2265.102263,60,33,0,27,2,Jeremy Chardy
2007,104545,2265.064819,13,8,0,5,12,John Isner
1993,101120,2265.018442,68,43,0,25,3,Karel Novacek
1990,100757,2264.898532,27,14,0,13,1,Anders Jarryd
2006,104019,2264.87682,55,32,0,23,2,Kristof Vliegen
1995,101991,2264.836423,31,19,0,12,4,Mauricio Hadad
1996,102347,2264.803506,7,6,0,1,10,Dmitri Tomashevich
1992,102148,2264.606319,51,28,0,23,4,Fabrice Santoro
1995,101659,2264.586199,32,17,0,15,13,Jan Apell
2000,102610,2264.552467,58,32,0,26,0,Albert Costa
2013,105311,2264.53695,30,16,0,14,5,Joao Sousa
1985,100579,2264.535148,43,23,0,20,6,Heinz Gunthardt
1992,101772,2264.468773,70,39,0,31,3,Andrei Cherkasov
1986,100857,2264.443415,53,24,0,29,4,Sergio Casal
1991,102104,2264.411229,5,5,0,0,20,Christian Ruud
1997,102448,2264.411229,5,5,0,0,10,Ali Hamadeh
1985,100698,2264.402436,5,5,0,0,31,Young Dae Jeon
2006,103206,2264.273571,48,27,0,21,2,Sebastien Grosjean
2006,102845,2264.252962,52,30,0,22,4,Carlos Moya
1989,100810,2264.209729,49,28,0,21,3,Paul Chamberlin
2012,104813,2264.203531,19,11,0,8,6,Grega Zemlja
1999,102998,2264.128207,50,25,0,25,2,Jan Michael Gambill
1988,101409,2264.119144,42,22,0,20,2,Jaime Yzaga
2000,103714,2263.897037,50,29,0,21,2,Andreas Vinciguerra
2008,103898,2263.872421,41,22,0,19,3,Julien Benneteau
2009,104597,2263.770261,54,30,0,24,2,Nicolas Almagro
2006,102905,2263.760731,25,15,0,10,5,Stefan Koubek
1994,101901,2263.725204,50,26,0,24,3,Chuck Adams
2001,102148,2263.519032,63,36,0,27,2,Fabrice Santoro
1986,101179,2263.427496,10,7,0,3,2,Jean Philippe Fleurian
2015,104871,2263.424744,54,27,0,27,3,Jeremy Chardy
1988,107680,2263.40399,5,5,0,0,23,Mark Bailey
2007,103917,2263.260592,42,22,0,20,2,Nicolas Mahut
1999,102854,2263.237626,56,29,0,27,3,Sjeng Schalken
1996,102024,2263.2327,60,31,0,29,3,Hernan Gumy
1988,101086,2263.18436,42,24,0,18,2,Ronald Agenor
2002,101774,2263.153355,40,24,0,16,3,Todd Martin
2004,104269,2263.123237,56,31,0,25,2,Fernando Verdasco
1990,101073,2263.079201,50,31,0,19,1,Martin Jaite
2013,104122,2262.93517,54,29,0,25,5,Carlos Berlocq
1993,100944,2262.772452,34,19,0,15,3,Mikael Pernfors
2012,105575,2262.768573,15,10,0,5,6,Ricardas Berankis
2003,103581,2262.747051,46,25,0,21,5,Flavio Saretta
2011,103484,2262.649917,35,19,0,16,4,James Blake
1986,101145,2262.641634,49,27,0,22,4,Jonathan Canter
1995,102184,2262.426197,37,19,0,18,3,David Prinosil
2001,103909,2262.376541,41,26,0,15,15,Guillermo Coria
1989,101354,2262.260135,26,16,0,10,12,Andrew Sznajder
2009,104678,2262.163525,60,31,0,29,2,Viktor Troicki
2000,102607,2262.127487,19,12,0,7,11,Juan Balcells
1991,101589,2261.898694,40,22,0,18,3,Arnaud Boetsch
1993,101917,2261.725937,31,17,0,14,7,Grant Stafford
2010,103747,2261.696724,7,6,0,1,26,Dominik Meffert
2006,103789,2261.618334,10,7,0,3,8,Irakli Labadze
1998,102434,2261.460474,55,28,0,27,2,Vincent Spadea
2007,103206,2261.368591,39,21,0,18,2,Sebastien Grosjean
1988,100628,2261.354752,48,27,0,21,4,Michiel Schapers
1995,101601,2261.320117,60,35,0,25,3,Brett Steven
1990,101242,2261.315559,39,22,0,17,5,Brad Pearce
1998,101820,2261.237116,58,29,0,29,2,Marc Rosset
2007,104327,2260.819402,8,6,0,2,12,Steve Darcis
2004,103971,2260.805459,44,22,0,22,3,Karol Beck
2006,102839,2260.790934,22,12,0,10,7,Nicolas Lapentti
1995,101924,2260.551522,37,20,0,17,6,Stefano Pescosolido
2006,103454,2260.480801,62,36,0,26,2,Nicolas Massu
2014,104597,2260.375553,25,15,0,10,23,Nicolas Almagro
2006,103507,2260.176066,51,28,0,23,4,Juan Carlos Ferrero
1991,101298,2260.17501,46,24,0,22,4,Jonas Svensson
2007,104339,2260.130035,24,13,0,11,2,Mario Ancic
1988,101106,2259.928418,41,20,0,21,6,Peter Lundgren
2006,104076,2259.909381,53,32,0,21,0,Jose Acasuso
1995,102456,2259.892991,15,10,0,5,3,Felix Mantilla
1990,101332,2259.851189,46,25,0,21,1,Gilad Bloom
1995,101897,2259.819135,42,24,0,18,3,Fernando Meligeni
1987,101191,2259.772486,27,15,0,12,3,Richey Reneberg
1992,101463,2259.646915,30,16,0,14,6,Bernd Karbacher
2000,101611,2259.6392,52,32,0,20,3,Cedric Pioline
1996,102796,2259.623353,23,13,0,10,3,Magnus Norman
2014,103794,2259.609478,53,27,0,26,3,Benjamin Becker
1988,100947,2259.570704,7,6,0,1,24,Doug Burke
1996,101890,2259.517545,35,19,0,16,3,Jonathan Stark
1989,101084,2259.47835,48,28,0,20,2,Jakob Hlasek
2009,103694,2259.381361,23,14,0,9,3,Olivier Rochus
1985,100356,2259.348025,32,18,0,14,13,Paul Mcnamee
2007,103598,2259.307795,14,10,0,4,12,Xavier Malisse
2013,105138,2259.305917,48,26,0,22,5,Roberto Bautista Agut
1991,100757,2259.176873,47,26,0,21,4,Anders Jarryd
1996,102025,2259.169805,43,24,0,19,0,Mikael Tillstrom
1987,101264,2259.102913,8,6,0,2,12,Michael Tauson
2010,104871,2259.032453,55,26,0,29,5,Jeremy Chardy
2013,105023,2258.941058,50,28,0,22,7,Sam Querrey
1993,101735,2258.927988,68,37,0,31,1,Richard Fromberg
1989,101609,2258.812307,34,18,0,16,5,David Wheaton
1987,100870,2258.70371,29,17,0,12,4,Christo Van Rensburg
1985,101276,2258.520869,40,23,0,17,9,Horacio De La Pena
1985,101145,2258.511672,30,16,0,14,1,Jonathan Canter
1986,100530,2258.20497,36,17,0,19,13,Andreas Maurer
2000,103018,2258.182547,59,32,0,27,2,Max Mirnyi
2007,103581,2258.145732,9,7,0,2,35,Flavio Saretta
2000,103694,2258.076964,14,9,0,5,7,Olivier Rochus
2001,103096,2258.065786,65,37,0,28,2,Arnaud Clement
2014,105575,2257.921955,18,11,0,7,4,Ricardas Berankis
1985,101048,2257.840307,17,11,0,6,12,Francisco Maciel
2000,103344,2257.673579,45,23,0,22,2,Ivan Ljubicic
1989,100954,2257.567863,40,24,0,16,2,Luiz Mattar
2015,104919,2257.562727,51,28,0,23,3,Leonardo Mayer
2008,104660,2257.537924,13,9,0,4,3,Sergiy Stakhovsky
1989,101195,2257.507,52,32,0,20,3,Amos Mansdorf
2002,102148,2257.452081,53,28,0,25,2,Fabrice Santoro
1987,100894,2257.442575,29,16,0,13,3,Francesco Cancellotti
1985,101013,2257.402705,47,29,0,18,5,Henrik Sundstrom
2004,104607,2257.363309,31,16,0,15,3,Tomas Berdych
2012,105676,2257.3547,31,17,0,14,5,David Goffin
1988,101320,2257.273815,43,24,0,19,2,Magnus Gustafsson
2001,102318,2257.25747,58,30,0,28,2,Andrei Pavel
1989,100944,2257.2288,37,20,0,17,5,Mikael Pernfors
2002,102860,2257.216763,48,25,0,23,3,Agustin Calleri
1993,101063,2257.038118,42,20,0,22,3,Jordi Arrese
2003,102571,2256.982181,26,14,0,12,2,Gregory Carraz
2006,103428,2256.843898,57,30,0,27,0,Juan Ignacio Chela
1985,101086,2256.838044,31,17,0,14,6,Ronald Agenor
2001,102905,2256.7756,46,22,0,24,3,Stefan Koubek
1994,102351,2256.683471,19,11,0,8,5,Oscar Martinez
2011,103898,2256.674458,42,21,0,21,3,Julien Benneteau
1986,100829,2256.671467,47,23,0,24,4,Jan Gunnarsson
1998,101962,2256.647876,7,5,0,2,2,Younes El Aynaoui
2011,103786,2256.583976,51,26,0,25,3,Nikolay Davydenko
2013,104731,2256.575788,60,37,0,23,3,Kevin Anderson
1993,101920,2256.530869,49,24,0,25,6,Jamie Morgan
2004,103632,2256.516314,60,31,0,29,2,Luis Horna
2000,101774,2256.503388,27,14,0,13,12,Todd Martin
1985,100742,2256.423588,26,15,0,11,1,Christo Steyn
1999,101414,2256.297861,17,10,0,7,20,Boris Becker
1987,100711,2256.290562,22,14,0,8,2,Pedro Rebolledo
1987,100944,2256.149451,38,21,0,17,4,Mikael Pernfors
1998,102863,2256.125558,10,7,0,3,2,Takao Suzuki
2001,102845,2256.10678,59,35,0,24,2,Carlos Moya
2013,105643,2256.04633,20,12,0,8,9,Federico Delbonis
2003,103017,2255.90602,36,19,0,17,3,Nicolas Kiefer
1990,101750,2255.88915,7,5,0,2,9,Cristiano Caratti
1988,101117,2255.796504,43,23,0,20,2,Eric Jelen
1996,101723,2255.777645,54,29,0,25,3,Magnus Larsson
2011,104312,2255.76392,49,25,0,24,3,Andreas Seppi
2011,104259,2255.743435,58,31,0,27,3,Philipp Kohlschreiber
2009,104339,2255.725658,20,13,0,7,27,Mario Ancic
2000,102259,2255.609819,56,31,0,25,3,Jerome Golmard
1992,101594,2255.574336,13,8,0,5,3,Carsten Arriens
1999,102456,2255.534086,55,34,0,21,3,Felix Mantilla
1997,101776,2255.37679,42,23,0,19,16,Sandon Stolle
1990,101312,2255.35024,21,13,0,8,3,Robbie Weiss
2011,105238,2255.274304,67,38,0,29,3,Alexandr Dolgopolov
1991,101482,2255.249615,25,13,0,12,3,Markus Zoecke
1997,103096,2255.14695,20,11,0,9,3,Arnaud Clement
1997,101439,2255.130766,68,35,0,33,2,Javier Sanchez
1993,101334,2254.999497,75,44,0,31,0,Alexander Volkov
1994,101589,2254.976206,54,28,0,26,3,Arnaud Boetsch
1987,101409,2254.895691,45,23,0,22,2,Jaime Yzaga
2000,101820,2254.863354,56,31,0,25,3,Marc Rosset
2012,104731,2254.859532,57,31,0,26,3,Kevin Anderson
2009,103900,2254.846925,22,14,0,8,31,David Nalbandian
1991,108831,2254.833466,6,5,0,1,10,Michael Walker
1995,101062,2254.817979,42,21,0,21,3,Mats Wilander
2003,102610,2254.775302,44,24,0,20,2,Albert Costa
1996,102162,2254.69358,38,20,0,18,3,Chris Woodruff
1994,102154,2254.665267,35,18,0,17,7,Marcos Ondruska
1997,101382,2254.642323,53,30,0,23,2,Marcelo Filippini
1998,101647,2254.60639,65,39,0,26,2,Byron Black
1995,102202,2254.606148,51,28,0,23,3,Kenneth Carlsen
2012,104719,2254.583679,46,23,0,23,3,Marcel Granollers
1986,100800,2254.532647,59,32,0,27,2,Diego Perez
2015,105916,2254.530791,8,6,0,2,11,Marton Fucsovics
2013,103333,2254.520724,28,15,0,13,5,Ivo Karlovic
1995,102845,2254.508246,18,11,0,7,3,Carlos Moya
1995,101185,2254.464949,58,31,0,27,3,Mark Woodforde
1985,101131,2254.418053,41,23,0,18,13,Jimmy Brown
1996,101249,2254.410373,40,21,0,19,3,Andrei Olhovskiy
1993,108686,2254.311124,6,5,0,1,21,Alejandro Aramburu Acuna
1994,101382,2254.202709,45,27,0,18,3,Marcelo Filippini
2004,103672,2254.046249,19,11,0,8,3,Ricardo Mello
2007,104098,2254.004254,51,28,0,23,0,Dmitry Tursunov
1996,108532,2254,4,4,0,0,34,Worapol Thongkamcho
1987,100282,2253.96149,32,18,0,14,2,Guillermo Vilas
2006,104026,2253.945163,8,5,0,3,4,Joachim Johansson
2005,103151,2253.860475,36,20,0,16,7,Mariano Zabaleta
1995,101797,2253.850534,54,26,0,28,0,Jacco Eltingh
1985,100282,2253.824785,31,17,0,14,13,Guillermo Vilas
2015,103990,2253.62581,45,24,0,21,7,Tommy Robredo
2000,101150,2253.487679,50,27,0,23,2,Gianluca Pozzi
2015,105656,2253.475706,4,4,0,0,19,Marcelo Arevalo
1998,102562,2253.45824,41,20,0,21,3,Jiri Novak
1985,101426,2253.430046,29,17,0,12,8,Kent Carlsson
1996,102434,2253.38194,49,27,0,22,3,Vincent Spadea
2000,102959,2253.373524,6,5,0,1,9,Marko Tkalec
2002,103337,2253.321311,6,5,0,1,8,Ben Qiang Zhu
1988,100955,2253.241895,35,20,0,15,9,Yahiya Doumbia
2002,102344,2253.229447,35,18,0,17,3,Karol Kucera
2002,101962,2253.223477,71,45,0,26,2,Younes El Aynaoui
1986,100603,2253.132791,14,9,0,5,10,Roland Stadler
2001,103292,2253.095644,51,28,0,23,3,Gaston Gaudio
1986,101084,2253.06336,69,38,0,31,3,Jakob Hlasek
2005,102035,2253.041283,41,20,0,21,3,Jonas Bjorkman
2005,103812,2253.035432,51,26,0,25,2,Victor Hanescu
1985,101142,2253.014296,31,17,0,14,6,Emilio Sanchez
2009,105064,2252.998928,39,21,0,18,6,Thomaz Bellucci
1991,110852,2252.993674,4,4,0,0,20,Umesha Wallooppillai
2009,103607,2252.992127,4,4,0,0,11,Victor Estrella
2013,106175,2252.970282,4,4,0,0,11,Ricardo Rodriguez
2006,103387,2252.964195,63,30,0,33,2,Paradorn Srichaphan
2006,103828,2252.951412,4,4,0,0,30,Jean Julien Rojer
1999,102238,2252.94199,40,20,0,20,7,Alberto Berasategui
2007,102821,2252.910796,4,4,0,0,9,Cecil Mamiit
1989,100972,2252.899306,37,21,0,16,2,Todd Witsken
1992,102202,2252.821209,22,14,0,8,3,Kenneth Carlsen
1993,102158,2252.764788,22,11,0,11,6,Patrick Rafter
1998,101185,2252.74358,51,25,0,26,4,Mark Woodforde
1986,100332,2252.689208,8,6,0,2,19,Balazs Taroczy
2012,104180,2252.627329,43,22,0,21,5,Gilles Muller
1989,101642,2252.609218,4,4,0,0,22,Bart Wuyts
2005,104098,2252.546226,33,17,0,16,2,Dmitry Tursunov
1998,102887,2252.520513,48,26,0,22,2,Ramon Delgado
1986,101048,2252.509771,41,23,0,18,2,Francisco Maciel
2013,104763,2252.469324,4,4,0,0,11,Rafael Arevalo
1995,102826,2252.428698,4,4,0,0,35,Muhammad Khaliq Siddiq
2012,104586,2252.360072,37,19,0,18,6,Lukas Rosol
1997,102812,2252.352867,4,4,0,0,10,Jicham Zaatini
1995,101746,2252.34062,72,39,0,33,0,Renzo Furlan
1999,102737,2252.28381,4,4,0,0,9,Gergely Kisgyorgy
1986,100950,2252.267954,51,26,0,25,4,Libor Pimek
1995,101196,2252.10029,22,13,0,9,13,Derrick Rostagno
1999,102318,2251.978932,55,30,0,25,2,Andrei Pavel
1998,100955,2251.968368,4,4,0,0,18,Yahiya Doumbia
2009,102821,2251.930004,4,4,0,0,11,Cecil Mamiit
2001,103656,2251.925302,20,12,0,8,8,Albert Montanes
1988,101158,2251.919796,45,24,0,21,4,John Frawley
1987,107181,2251.905983,4,4,0,0,33,Haseeb Aslam
1992,101165,2251.905983,4,4,0,0,35,Mario Tabares
2004,103504,2251.905983,4,4,0,0,31,Febi Widhiyanto
2000,102703,2251.886701,16,10,0,6,2,Hyung Taik Lee
1988,101124,2251.777966,37,18,0,19,3,Paolo Cane
1996,101439,2251.769374,63,30,0,33,3,Javier Sanchez
1989,100919,2251.741,6,5,0,1,22,Khalid Outaleb
1991,101606,2251.736826,42,25,0,17,3,Alberto Mancini
2007,104312,2251.693257,46,22,0,24,2,Andreas Seppi
2013,105430,2251.639709,6,5,0,1,11,Radu Albot
2004,103746,2251.636721,6,5,0,1,8,Miguel Gallardo Valles
2004,103018,2251.584026,53,26,0,27,2,Max Mirnyi
2003,104022,2251.564426,56,29,0,27,2,Mikhail Youzhny
1990,100529,2251.562134,39,20,0,19,0,Kevin Curren
2008,104068,2251.498903,44,24,0,20,2,Robby Ginepri
2005,104210,2251.386408,4,4,0,0,17,Ryan Russell
2010,104535,2251.380167,4,4,0,0,11,Daniel Garza
2005,104180,2251.366286,44,21,0,23,5,Gilles Muller
1999,103632,2251.354374,6,5,0,1,9,Luis Horna
2011,105385,2251.283523,36,19,0,17,3,Donald Young
2009,103484,2251.281004,45,24,0,21,2,James Blake
1997,101647,2251.252364,57,31,0,26,2,Byron Black
2005,102148,2251.211436,37,18,0,19,2,Fabrice Santoro
1988,101004,2251.172795,54,27,0,27,4,Jim Pugh
1999,103821,2251.10513,6,5,0,1,9,Danai Udomchoke
1992,101150,2251.099621,56,28,0,28,6,Gianluca Pozzi
2001,101897,2251.073281,35,18,0,17,11,Fernando Meligeni
1994,101970,2251.031487,6,5,0,1,10,Iztok Bozic
2014,106401,2251.028145,19,10,0,9,7,Nick Kyrgios
1998,101792,2250.987025,48,26,0,22,8,Slava Dosedel
1995,101318,2250.979661,41,26,0,15,3,Javier Frana
1985,100824,2250.96155,6,5,0,1,12,Peter Bastiansen
1989,108815,2250.946153,6,5,0,1,22,Kojo Atiso
2010,105579,2250.886446,6,5,0,1,11,Kittipong Wachiramanowong
1988,101080,2250.879812,38,21,0,17,13,Lawson Duncan
2004,104291,2250.871495,4,4,0,0,18,Malek Jaziri
1987,100631,2250.868667,43,23,0,20,3,Tim Wilkison
2001,103714,2250.840638,56,29,0,27,2,Andreas Vinciguerra
1993,108532,2250.827828,6,5,0,1,30,Worapol Thongkamcho
1995,101265,2250.813124,54,29,0,25,0,Patrick Mcenroe
1986,101117,2250.793947,34,19,0,15,4,Eric Jelen
1992,101774,2250.780541,41,22,0,19,6,Todd Martin
1998,101086,2250.775939,6,5,0,1,18,Ronald Agenor
2015,106078,2250.750841,6,5,0,1,11,Egor Gerasimov
2015,104198,2250.558342,57,32,0,25,3,Guillermo Garcia Lopez
2002,102783,2250.539727,71,41,0,30,2,Rainer Schuettler
2006,103794,2250.501044,17,9,0,8,3,Benjamin Becker
1996,102437,2250.434577,56,30,0,26,3,Adrian Voinea
2010,105060,2250.412684,6,5,0,1,11,Aldin Setkic
1997,101484,2250.41078,4,4,0,0,19,Vladimir Gabrichidze
1997,102107,2250.400015,4,4,0,0,10,Jan Frode Andersen
1989,100837,2250.306597,27,15,0,12,3,Jeremy Bates
2015,105438,2250.244318,6,5,0,1,1,Inigo Cervantes Huegun
1989,100901,2250.217007,35,17,0,18,4,Paul Annacone
1999,101885,2250.210978,25,14,0,11,6,Wayne Arthurs
1996,101084,2250.067532,55,25,0,30,0,Jakob Hlasek
1997,102770,2250.046884,9,6,0,3,12,John Van Lottum
1986,100485,2250.037136,8,6,0,2,7,Tsuyoshi Fukui
2009,104660,2249.94655,30,16,0,14,5,Sergiy Stakhovsky
1992,108831,2249.884411,6,5,0,1,29,Michael Walker
2003,103598,2249.823203,39,18,0,21,5,Xavier Malisse
2014,106033,2249.817302,4,4,0,0,32,Romain Arneodo
1986,101066,2249.76822,9,6,0,3,5,Richard Matuszewski
2004,103781,2249.755289,54,27,0,27,2,Jurgen Melzer
2002,103970,2249.732957,16,10,0,6,3,David Ferrer
2002,104076,2249.702461,41,22,0,19,3,Jose Acasuso
1999,102035,2249.68656,47,24,0,23,2,Jonas Bjorkman
1989,101413,2249.565952,6,5,0,1,37,Felix Barrientos
1987,100628,2249.559348,50,28,0,22,4,Michiel Schapers
1993,101577,2249.471141,8,6,0,2,6,Jia Ping Xia
2006,104269,2249.446812,57,32,0,25,2,Fernando Verdasco
1998,101703,2249.401893,54,26,0,28,2,Guillaume Raoux
1987,101098,2249.389907,42,22,0,20,3,Guy Forget
1994,101647,2249.314137,50,23,0,27,3,Byron Black
2000,101647,2249.249805,55,29,0,26,2,Byron Black
1985,100920,2249.144345,21,12,0,9,9,Robert Seguso
1986,101013,2249.095715,40,21,0,19,5,Henrik Sundstrom
1985,101404,2249.075219,20,12,0,8,6,Thomas Muster
2008,104797,2248.967532,8,6,0,2,5,Denis Istomin
2010,104719,2248.921333,43,21,0,22,2,Marcel Granollers
1985,100922,2248.809742,34,18,0,16,13,Roberto Arguello
2003,102344,2248.772668,43,24,0,19,2,Karol Kucera
2011,104022,2248.703994,51,27,0,24,3,Mikhail Youzhny
1986,100282,2248.668053,33,19,0,14,14,Guillermo Vilas
1997,102533,2248.666028,20,11,0,9,10,Jens Knippschild
1987,100532,2248.555884,44,25,0,19,3,Johan Kriek
1990,100954,2248.531606,43,25,0,18,1,Luiz Mattar
2005,104076,2248.469303,53,27,0,26,3,Jose Acasuso
1989,107097,2248.443513,6,5,0,1,29,Gilles Ganancia
1986,100830,2248.384546,22,11,0,11,3,Gary Donnelly
2007,103888,2248.304193,45,24,0,21,2,Mardy Fish
1988,108332,2248.277155,6,5,0,1,23,Suharyadi Suharyadi
1996,102562,2248.273676,55,31,0,24,3,Jiri Novak
1990,101507,2248.273542,48,25,0,23,1,Tomas Carbonell
1986,100586,2248.244712,27,14,0,13,3,Eliot Teltscher
1986,101230,2248.212346,26,14,0,12,6,Andrei Chesnokov
1985,100635,2248.143826,46,23,0,23,4,Mark Dickson
2008,102783,2248.140946,44,21,0,23,2,Rainer Schuettler
2004,104076,2248.096476,34,18,0,16,5,Jose Acasuso
2005,103852,2248.052512,59,31,0,28,2,Feliciano Lopez
1985,100923,2248.017936,44,21,0,23,3,Wally Masur
2004,104214,2248.00588,57,29,0,28,3,Igor Andreev
1987,101026,2247.992088,38,20,0,18,4,Jim Grabb
2000,101962,2247.866454,64,37,0,27,4,Younes El Aynaoui
2011,103821,2247.846585,6,5,0,1,10,Danai Udomchoke
1989,101004,2247.761436,38,20,0,18,5,Jim Pugh
1994,101334,2247.751544,75,39,0,36,1,Alexander Volkov
2010,105238,2247.694123,44,21,0,23,3,Alexandr Dolgopolov
1990,101196,2247.661318,39,21,0,18,3,Derrick Rostagno
1995,101868,2247.560645,16,9,0,7,6,Dick Norman
1993,101609,2247.485206,54,28,0,26,3,David Wheaton
1998,103103,2247.389375,62,34,0,28,2,Dominik Hrbaty
1999,101792,2247.378191,29,16,0,13,11,Slava Dosedel
2009,104871,2247.311204,63,35,0,28,2,Jeremy Chardy
1999,102446,2247.306129,49,26,0,23,2,Andrei Medvedev
2008,103498,2247.293757,46,23,0,23,2,Marat Safin
1985,100657,2247.230574,35,18,0,17,5,Mike Leach
2000,103602,2247.223833,14,9,0,5,14,Fernando Gonzalez
2003,102642,2247.035423,29,14,0,15,5,Cyril Saulnier
2006,103898,2246.88329,46,24,0,22,2,Julien Benneteau
2004,104180,2246.821498,22,13,0,9,3,Gilles Muller
2010,105575,2246.777104,12,8,0,4,11,Ricardas Berankis
1995,101727,2246.759581,47,22,0,25,7,Jason Stoltenberg
2007,103582,2246.737951,25,13,0,12,3,Michael Berrer
1998,102259,2246.730402,46,24,0,22,2,Jerome Golmard
2010,104813,2246.66885,11,7,0,4,5,Grega Zemlja
1989,100855,2246.643551,39,21,0,18,3,Scott Davis
1991,101391,2246.579982,57,27,0,30,3,Carl Uwe Steeb
1987,101381,2246.48577,28,15,0,13,24,Aaron Krickstein
1985,100315,2246.430972,22,12,0,10,16,Hank Pfister
1999,101647,2246.383034,51,27,0,24,2,Byron Black
2014,105223,2246.322582,10,7,0,3,35,Juan Martin Del Potro
1996,101897,2246.305277,41,21,0,20,3,Fernando Meligeni
1990,101889,2246.275277,33,16,0,17,1,Todd Woodbridge
2007,104792,2246.138798,42,21,0,21,11,Gael Monfils
1988,101377,2245.987189,35,18,0,17,6,Christian Bergstrom
1992,101230,2245.962062,59,30,0,29,3,Andrei Chesnokov
1986,100990,2245.898686,57,32,0,25,4,Milan Srejber
1988,101178,2245.781075,30,15,0,15,3,Pieter Aldrich
1991,101630,2245.754599,8,6,0,2,11,Clement Ngoran
2001,102788,2245.739579,14,8,0,6,3,Jan Vacek
2014,103163,2245.703653,25,14,0,11,23,Tommy Haas
1989,101179,2245.676671,23,12,0,11,2,Jean Philippe Fleurian
2012,103900,2245.613537,38,21,0,17,13,David Nalbandian
1995,101792,2245.61013,54,27,0,27,3,Slava Dosedel
2002,103344,2245.573158,58,29,0,29,2,Ivan Ljubicic
1993,100763,2245.538918,59,31,0,28,4,Brad Gilbert
1989,101727,2245.469531,39,20,0,19,10,Jason Stoltenberg
2007,102905,2245.452639,50,23,0,27,3,Stefan Koubek
2001,104043,2245.436029,7,5,0,2,11,Marc Lopez
1994,101063,2245.39845,46,23,0,23,3,Jordi Arrese
2002,103529,2245.281738,8,6,0,2,8,Aisam Ul Haq Qureshi
2006,103017,2245.238614,23,14,0,9,22,Nicolas Kiefer
1987,100829,2245.13008,40,21,0,19,4,Jan Gunnarsson
2014,104665,2245.129956,46,23,0,23,2,Pablo Andujar
1989,107833,2245.053483,3,3,0,0,22,Mushaf Zia
1997,102263,2245.05261,6,5,0,1,10,Yong Il Yoon
2008,104338,2244.967453,49,28,0,21,2,Juan Monaco
1999,102061,2244.869801,11,7,0,4,9,Kevin Ullyett
2002,102998,2244.863541,54,28,0,26,2,Jan Michael Gambill
1985,100730,2244.59954,20,11,0,9,6,Florin Segarceanu
2005,104312,2244.597136,36,19,0,17,2,Andreas Seppi
1989,101036,2244.591034,36,19,0,17,4,Miloslav Mecir
2002,103632,2244.570732,20,12,0,8,7,Luis Horna
1991,101723,2244.538844,42,21,0,21,3,Magnus Larsson
2009,103498,2244.501735,41,19,0,22,2,Marat Safin
1991,101775,2244.388973,8,6,0,2,10,Frederik Fetterlein
1987,101124,2244.32417,40,23,0,17,6,Paolo Cane
1998,102247,2244.200632,59,34,0,25,0,Andrea Gaudenzi
1997,102539,2244.179113,56,26,0,30,2,Bohdan Ulihrach
2003,101965,2244.160768,45,25,0,20,2,Wayne Ferreira
1995,101510,2244.160348,30,15,0,15,3,Henrik Holm
1988,101066,2244.158827,21,11,0,10,3,Richard Matuszewski
1995,102854,2244.10701,31,17,0,14,3,Sjeng Schalken
1995,102257,2244.066455,61,36,0,25,3,Greg Rusedski
2008,104332,2244.03596,19,10,0,9,3,Philipp Petzschner
1997,102839,2243.965806,39,19,0,20,2,Nicolas Lapentti
2003,102765,2243.860479,25,14,0,11,19,Nicolas Escude
2001,103151,2243.707395,36,18,0,18,8,Mariano Zabaleta
1996,101235,2243.702003,60,31,0,29,3,Paul Haarhuis
2008,104180,2243.661427,13,7,0,6,3,Gilles Muller
1991,101727,2243.638887,40,20,0,20,3,Jason Stoltenberg
1986,100747,2243.636893,34,17,0,17,3,Glenn Layendecker
1995,102087,2243.607196,15,10,0,5,4,Oleg Ogorodov
1992,102025,2243.569777,11,7,0,4,17,Mikael Tillstrom
1990,101382,2243.565794,46,24,0,22,1,Marcelo Filippini
1993,100936,2243.538515,27,13,0,14,4,Henri Leconte
2008,104386,2243.474338,49,26,0,23,2,Janko Tipsarevic
1985,101020,2243.399249,47,25,0,22,10,Hans Schwaier
2002,101885,2243.380404,49,25,0,24,3,Wayne Arthurs
2007,104655,2243.347057,5,4,0,1,9,Pablo Cuevas
1987,101378,2243.269921,31,15,0,16,2,Tore Meinecke
2011,104868,2243.134348,13,8,0,5,12,James Ward
1999,103714,2243.084171,15,9,0,6,2,Andreas Vinciguerra
1989,101080,2243.003587,47,25,0,22,13,Lawson Duncan
1995,102035,2242.957426,63,35,0,28,3,Jonas Bjorkman
1987,101320,2242.936449,9,5,0,4,6,Magnus Gustafsson
1986,100841,2242.931709,5,4,0,1,9,Jin Sun Yoo
2000,101717,2242.925431,12,8,0,4,2,Diego Nargiso
1987,100713,2242.883415,37,19,0,18,6,John Fitzgerald
1987,101324,2242.875562,43,24,0,19,4,Ulf Stenlund
2005,102106,2242.862533,50,25,0,25,2,Davide Sanguinetti
1985,100570,2242.741288,39,20,0,19,7,Marty Davis
1990,100870,2242.541553,45,24,0,21,5,Christo Van Rensburg
1997,102286,2242.520524,16,9,0,7,2,Wayne Black
1992,101733,2242.472692,50,22,0,28,3,Jan Siemerink
2002,103852,2242.46249,34,18,0,16,3,Feliciano Lopez
2014,104594,2242.457006,44,22,0,22,4,Marinko Matosevic
1999,102271,2242.43696,58,31,0,27,2,Hicham Arazi
2001,102998,2242.318275,62,36,0,26,3,Jan Michael Gambill
1997,102783,2242.288138,7,5,0,2,18,Rainer Schuettler
2013,105554,2242.217211,10,6,0,4,11,Daniel Evans
1994,101725,2242.173724,31,17,0,14,3,Gabriel Markus
1988,101412,2242.154847,29,14,0,15,8,Shuzo Matsuoka
2012,103786,2242.024177,49,24,0,25,4,Nikolay Davydenko
1993,101142,2242.004011,54,28,0,26,3,Emilio Sanchez
1995,101235,2241.935997,59,34,0,25,3,Paul Haarhuis
2005,104925,2241.907149,22,11,0,11,2,Novak Djokovic
1995,101412,2241.853044,37,19,0,18,3,Shuzo Matsuoka
2009,104958,2241.761801,8,5,0,3,12,Carsten Ball
2005,103908,2241.750938,57,28,0,29,2,Paul Henri Mathieu
2008,104620,2241.746176,59,29,0,30,2,Simone Bolelli
2006,103105,2241.732096,45,25,0,20,3,Ruben Ramirez Hidalgo
2002,103899,2241.623713,5,4,0,1,8,Stian Boretti
1992,101349,2241.548588,3,3,0,0,35,Adam Malik
2011,105912,2241.548588,5,4,0,1,12,Diego Galeano
2006,103612,2241.547008,5,4,0,1,8,Alexey Kedryuk
1998,102029,2241.525448,46,24,0,22,11,Filip Dewulf
1985,103993,2241.485164,3,3,0,0,12,Chris Lewis
1988,101344,2241.398292,32,17,0,15,6,Bruno Oresar
2014,103720,2241.366882,36,20,0,16,9,Lleyton Hewitt
1989,101061,2241.290438,34,17,0,17,5,Jimmy Arias
1991,101105,2241.199904,7,5,0,2,10,Jose Antonio Fernandez
1992,101409,2241.17543,49,29,0,20,3,Jaime Yzaga
1988,101543,2241.152033,13,7,0,6,13,Jeff Tarango
2001,103739,2241.00137,5,4,0,1,18,Jose De Armas
1985,100744,2240.972374,37,18,0,19,1,Peter Doohan
2014,105238,2240.955656,49,27,0,22,2,Alexandr Dolgopolov
2003,103077,2240.934396,5,4,0,1,8,Konstantinos Economidis
2013,105577,2240.870007,35,17,0,18,3,Vasek Pospisil
2013,104198,2240.847228,42,20,0,22,5,Guillermo Garcia Lopez
2014,106071,2240.835845,33,17,0,16,4,Bernard Tomic
2015,106432,2240.830701,54,26,0,28,3,Borna Coric
2001,102247,2240.827072,36,17,0,19,3,Andrea Gaudenzi
1985,100446,2240.706745,50,25,0,25,5,John Sadri
1985,101374,2240.66249,13,7,0,6,5,Leonardo Lavalle
1987,110881,2240.655193,7,5,0,2,12,Shu Hua Liu
1991,102148,2240.64281,51,29,0,22,4,Fabrice Santoro
2015,105985,2240.588535,7,5,0,2,4,Darian King
2002,102839,2240.567032,61,34,0,27,2,Nicolas Lapentti
2003,102233,2240.55746,5,4,0,1,31,Leander Paes
2001,102287,2240.543033,60,32,0,28,2,Albert Portas
2003,102839,2240.515615,48,25,0,23,2,Nicolas Lapentti
1989,101235,2240.505263,16,9,0,7,2,Paul Haarhuis
1988,100796,2240.5,3,3,0,0,34,Ahmed El Mehelmy
2007,103607,2240.5,3,3,0,0,35,Victor Estrella
2005,103824,2240.493029,3,3,0,0,8,Orest Tereshchuk
1987,101158,2240.425569,12,7,0,5,10,John Frawley
2000,101320,2240.395745,31,17,0,14,3,Magnus Gustafsson
1986,101063,2240.317424,24,13,0,11,13,Jordi Arrese
1991,101914,2240.238256,6,4,0,2,3,Lars Koslowski
1987,101334,2240.216826,13,7,0,6,4,Alexander Volkov
1992,101601,2240.185374,20,11,0,9,6,Brett Steven
2012,103852,2240.165583,53,26,0,27,3,Feliciano Lopez
1989,101120,2240.139899,31,16,0,15,5,Karel Novacek
2004,103060,2240.137271,5,4,0,1,8,Alejandro Hernandez
1996,102344,2240.060301,49,24,0,25,3,Karol Kucera
1989,100752,2240.016726,38,21,0,17,10,Ramesh Krishnan
1985,100725,2239.997476,3,3,0,0,20,Michael Mortensen
2012,103720,2239.981727,30,16,0,14,5,Lleyton Hewitt
2000,102277,2239.977285,3,3,0,0,37,Bing Chao Lin
1999,102097,2239.975706,3,3,0,0,31,Naratorn Srichaphan
2001,101895,2239.975706,3,3,0,0,33,Michael Brown B395
2001,102556,2239.975706,3,3,0,0,18,Claude Ngoran
2005,110685,2239.975706,3,3,0,0,17,Gd Jones
2007,104395,2239.975706,3,3,0,0,9,Marcel Felder
2013,104368,2239.97255,5,4,0,1,34,Daniel King Turner
2004,102703,2239.936138,35,19,0,16,6,Hyung Taik Lee
1996,102854,2239.905126,52,26,0,26,3,Sjeng Schalken
1998,102703,2239.894661,3,3,0,0,18,Hyung Taik Lee
1985,100865,2239.871312,24,13,0,11,13,Marcelo Ingaramo
2015,111202,2239.838274,22,12,0,10,9,Hyeon Chung
2001,102437,2239.829359,24,13,0,11,6,Adrian Voinea
1999,103182,2239.772144,34,19,0,15,7,Markus Hipfl
1985,101030,2239.711144,18,10,0,8,6,Goran Prpic
2007,105227,2239.659819,27,14,0,13,3,Marin Cilic
1999,102320,2239.627912,3,3,0,0,18,Lazaro Navarro Batles
1999,101532,2239.592845,59,32,0,27,2,Francisco Clavet
2000,103171,2239.582304,15,8,0,7,2,Raemon Sluiter
1997,102434,2239.526705,46,20,0,26,2,Vincent Spadea
2015,104312,2239.525253,52,27,0,25,3,Andreas Seppi
1995,101495,2239.522448,6,4,0,2,12,Miguel Tobon
1985,101413,2239.452992,3,3,0,0,43,Felix Barrientos
1986,108532,2239.452992,3,3,0,0,32,Worapol Thongkamcho
1997,108844,2239.452992,3,3,0,0,33,Hamed Ul Haq
2005,104753,2239.452992,3,3,0,0,17,Woong Sun Jun
2000,103454,2239.452239,50,27,0,23,4,Nicolas Massu
1997,101651,2239.451412,3,3,0,0,19,Owen Casey
2012,108594,2239.451412,3,3,0,0,35,Johnny Arcilla
2011,104557,2239.418646,3,3,0,0,21,Andis Juska
2012,104945,2239.413345,3,3,0,0,35,James Mcgee
2011,105935,2239.392326,5,4,0,1,12,Duilio Beretta
1998,102106,2239.379793,63,33,0,30,0,Davide Sanguinetti
2012,103566,2239.343804,26,12,0,14,3,Michael Llodra
2001,103077,2239.34284,3,3,0,0,9,Konstantinos Economidis
2013,103898,2239.34163,52,27,0,25,3,Julien Benneteau
1992,102233,2239.340383,5,4,0,1,10,Leander Paes
2002,102456,2239.339396,51,26,0,25,2,Felix Mantilla
2007,101868,2239.259103,5,4,0,1,21,Dick Norman
2011,105649,2239.163384,13,8,0,5,2,Cedrik Marcel Stebe
1993,101962,2239.123496,34,19,0,15,3,Younes El Aynaoui
2005,104022,2239.069213,46,23,0,23,3,Mikhail Youzhny
1990,101735,2239.048452,50,29,0,21,2,Richard Fromberg
1997,102401,2238.987635,43,23,0,20,6,Scott Draper
2005,104571,2238.981803,23,11,0,12,3,Marcos Baghdatis
2003,102740,2238.957174,5,4,0,1,8,Francisco Rodriguez
2007,104591,2238.94895,3,3,0,0,9,Patrick Tierro
2011,105790,2238.94895,3,3,0,0,12,Yong Kyu Lim
2012,104600,2238.94895,3,3,0,0,11,Treat Conrad Huey
2015,105820,2238.94895,3,3,0,0,11,Juan Carlos Saez
1985,100836,2238.936018,13,7,0,6,9,Glenn Michibata
1999,106536,2238.933416,3,3,0,0,18,Andres Filimonov
2001,104499,2238.933416,3,3,0,0,33,Jimmy Wang
2015,103600,2238.933416,3,3,0,0,19,Mohammad Ghareeb
2002,103600,2238.928698,3,3,0,0,31,Mohammad Ghareeb
2007,102887,2238.928698,3,3,0,0,35,Ramon Delgado
2015,106426,2238.928698,3,3,0,0,19,Christian Garin
2000,104180,2238.913083,3,3,0,0,20,Gilles Muller
2006,103229,2238.904939,5,4,0,1,8,Kornel Bardoczky
2003,103812,2238.894764,28,15,0,13,2,Victor Hanescu
2007,104081,2238.892683,18,10,0,8,3,Boris Pashanski
1989,108532,2238.879713,5,4,0,1,22,Worapol Thongkamcho
1992,101962,2238.878841,7,5,0,2,10,Younes El Aynaoui
2001,102887,2238.756254,18,11,0,7,3,Ramon Delgado
1986,100820,2238.735064,5,4,0,1,26,Thierry Pham
2005,103333,2238.617624,40,17,0,23,3,Ivo Karlovic
1991,100870,2238.610706,29,15,0,14,6,Christo Van Rensburg
2000,104339,2238.517756,3,3,0,0,9,Mario Ancic
1994,102025,2238.451593,6,4,0,2,21,Mikael Tillstrom
1996,103163,2238.450695,7,4,0,3,9,Tommy Haas
2012,105590,2238.4445,5,4,0,1,11,Uladzimir Ignatik
1999,102959,2238.425072,3,3,0,0,18,Marko Tkalec
2002,103824,2238.418503,3,3,0,0,17,Orest Tereshchuk
2012,105255,2238.418503,3,3,0,0,35,Bassam Beidas
2008,101962,2238.408406,9,6,0,3,25,Younes El Aynaoui
2002,102959,2238.405983,5,4,0,1,8,Marko Tkalec
1994,101890,2238.401649,49,26,0,23,3,Jonathan Stark
2003,103632,2238.385084,39,19,0,20,7,Luis Horna
2005,104655,2238.364626,5,4,0,1,8,Pablo Cuevas
2006,101736,2238.349926,18,10,0,8,10,Andre Agassi
1995,101609,2238.342646,52,28,0,24,3,David Wheaton
2011,105053,2238.309785,58,31,0,27,3,Santiago Giraldo
1987,100517,2238.303096,3,3,0,0,28,Matt Doyle
2004,102456,2238.299459,32,17,0,15,10,Felix Mantilla
1995,102347,2238.297501,5,4,0,1,10,Dmitri Tomashevich
2014,104897,2238.253706,6,4,0,2,4,Matthias Bachinger
1991,101965,2238.201429,47,26,0,21,3,Wayne Ferreira
1994,101349,2238.152888,7,5,0,2,9,Adam Malik
1997,101733,2238.068044,52,20,0,32,2,Jan Siemerink
1999,102905,2238.049973,58,32,0,26,2,Stefan Koubek
2011,105226,2238.013206,5,4,0,1,12,Attila Balazs
2000,101727,2237.9914,35,21,0,14,7,Jason Stoltenberg
1996,102466,2237.987035,38,20,0,18,6,Jan Kroslak
1991,102018,2237.962762,5,4,0,1,18,Tamer El Sawy
1993,101413,2237.906309,3,3,0,0,36,Felix Barrientos
1985,101098,2237.875349,39,18,0,21,5,Guy Forget
1989,100628,2237.859672,41,23,0,18,9,Michiel Schapers
1993,103009,2237.832963,7,5,0,2,11,Razvan Sabau
2010,103602,2237.806808,24,15,0,9,13,Fernando Gonzalez
1986,105080,2237.761943,6,4,0,2,10,Miloslav Mecir
1998,101416,2237.751783,5,4,0,1,9,Joao Cunha Silva
1985,101381,2237.729094,48,26,0,22,6,Aaron Krickstein
1996,101776,2237.723084,44,24,0,20,3,Sandon Stolle
1996,102233,2237.714318,28,14,0,14,7,Leander Paes
2008,103656,2237.66686,47,24,0,23,3,Albert Montanes
1991,102001,2237.597273,20,11,0,9,3,German Lopez
1987,101391,2237.577918,18,10,0,8,20,Carl Uwe Steeb
2014,105936,2237.553145,11,7,0,4,4,Filip Krajinovic
1999,101965,2237.53316,54,29,0,25,2,Wayne Ferreira
1991,100997,2237.515646,9,6,0,3,12,Roger Smith
1992,101686,2237.498027,37,21,0,16,5,Franco Davin
2014,105430,2237.484301,11,7,0,4,9,Radu Albot
1999,102025,2237.47625,33,15,0,18,2,Mikael Tillstrom
1993,101900,2237.468621,53,29,0,24,3,Nicklas Kulti
2013,104604,2237.366833,5,4,0,1,11,Ruben Gonzales
1995,102703,2237.35636,5,4,0,1,31,Hyung Taik Lee
2009,104557,2237.349515,5,4,0,1,11,Andis Juska
2014,104233,2237.31243,5,4,0,1,9,Frederik Nielsen
1998,103324,2237.306388,21,11,0,10,3,Arnaud Di Pasquale
2010,104890,2237.30337,11,6,0,5,5,Andreas Haider Maurer
1998,102133,2237.301942,17,10,0,7,7,Laurence Tieleman
2001,103060,2237.289057,5,4,0,1,9,Alejandro Hernandez
1991,101138,2237.282616,25,14,0,11,3,Pat Cash
1986,100661,2237.282125,30,16,0,14,6,Damir Keretic
2008,104731,2237.247228,23,13,0,10,8,Kevin Anderson
1987,101061,2237.24579,42,22,0,20,4,Jimmy Arias
1990,101030,2237.235704,47,26,0,21,1,Goran Prpic
2014,106432,2237.216899,13,7,0,6,3,Borna Coric
2002,103813,2237.171802,54,27,0,27,2,Jarkko Nieminen
2008,103908,2237.044565,59,31,0,28,2,Paul Henri Mathieu
1997,102563,2237.021366,59,32,0,27,2,Thomas Johansson
2015,106220,2237.010292,5,4,0,1,11,Dimitar Kuzmanov
2005,103529,2236.992305,5,4,0,1,8,Aisam Ul Haq Qureshi
2011,105051,2236.98218,20,10,0,10,8,Matthew Ebden
2011,104327,2236.79237,15,9,0,6,6,Steve Darcis
1994,102201,2236.770229,28,14,0,14,4,Lionel Roux
2010,103393,2236.742731,6,4,0,2,19,Yuri Schukin
2006,102882,2236.69412,21,11,0,10,8,Mark Philippoussis
1991,101774,2236.623051,18,10,0,8,12,Todd Martin
1991,101235,2236.59679,54,28,0,26,0,Paul Haarhuis
1998,101731,2236.525935,7,5,0,2,9,Nuno Marques
2013,103285,2236.436862,33,16,0,17,0,Radek Stepanek
2007,103525,2236.407176,3,3,0,0,9,Ivan Miranda
2014,111181,2236.404321,5,4,0,1,9,Pruchya Isarow
2008,104979,2236.375205,11,6,0,5,3,Andrey Golubev
2003,102110,2236.35844,4,3,0,1,8,Daniel Nestor
1993,101746,2236.341738,55,26,0,29,3,Renzo Furlan
2012,105332,2236.29663,52,26,0,26,3,Benoit Paire
1990,101106,2236.281037,33,15,0,18,1,Peter Lundgren
2015,105064,2236.260381,60,30,0,30,3,Thomaz Bellucci
2009,103898,2236.216011,54,26,0,28,2,Julien Benneteau
1994,100954,2236.193206,38,20,0,18,3,Luiz Mattar
1995,102374,2236.152371,52,25,0,27,3,Alex Corretja
1999,102722,2236.131535,5,4,0,1,9,Attila Savolt
2011,105577,2236.071846,11,6,0,5,4,Vasek Pospisil
2007,103498,2236.0691,43,23,0,20,4,Marat Safin
1987,100900,2236.065209,8,5,0,3,13,Josef Cihak
1994,101746,2236.020221,59,31,0,28,3,Renzo Furlan
1992,101606,2236.015642,51,27,0,24,3,Alberto Mancini
2011,104025,2235.907546,7,5,0,2,12,Amer Delic
2000,101843,2235.890779,32,17,0,15,8,Sergi Bruguera
1988,105080,2235.870964,4,3,0,1,39,Miloslav Mecir
1996,102205,2235.791469,34,18,0,16,3,Sebastien Lareau
1996,101382,2235.762548,35,19,0,16,3,Marcelo Filippini
1986,101226,2235.754115,20,11,0,9,5,Johan Carlsson
1989,101460,2235.724422,9,6,0,3,5,Jose Francisco Altur
1998,103182,2235.712875,8,5,0,3,9,Markus Hipfl
2001,102863,2235.664913,9,6,0,3,7,Takao Suzuki
1988,101727,2235.641277,24,13,0,11,10,Jason Stoltenberg
2001,101774,2235.621668,25,13,0,12,12,Todd Martin
2007,103612,2235.594539,5,4,0,1,9,Alexey Kedryuk
2006,102863,2235.568104,4,3,0,1,6,Takao Suzuki
1994,101475,2235.560609,66,39,0,27,3,Carlos Costa
2004,104453,2235.501911,4,3,0,1,3,Michael Ryderstedt
2009,103171,2235.485021,5,4,0,1,24,Raemon Sluiter
1992,100284,2235.474274,33,17,0,16,3,Jimmy Connors
1998,101434,2235.455482,55,34,0,21,3,Petr Korda
1990,102148,2235.428525,31,15,0,16,2,Fabrice Santoro
1989,101096,2235.408942,23,12,0,11,3,Gary Muller
1996,102318,2235.385418,10,6,0,4,10,Andrei Pavel
2009,104198,2235.299493,55,28,0,27,3,Guillermo Garcia Lopez
2000,103193,2235.257081,12,7,0,5,14,Peter Wessels
2010,103808,2235.238843,51,26,0,25,2,Potito Starace
1988,101630,2235.20527,5,4,0,1,14,Clement Ngoran
2010,103794,2235.179533,61,30,0,31,2,Benjamin Becker
1993,101901,2235.065497,50,25,0,25,3,Chuck Adams
2000,102456,2235.001199,32,16,0,16,21,Felix Mantilla
1987,101507,2234.978311,7,4,0,3,14,Tomas Carbonell
2006,102562,2234.94994,26,13,0,13,3,Jiri Novak
2014,104926,2234.889644,66,40,0,26,2,Fabio Fognini
1992,101746,2234.842823,55,26,0,29,5,Renzo Furlan
1997,102100,2234.837984,5,4,0,1,10,Bartlomiej Dabrowski
2014,105577,2234.802765,45,21,0,24,2,Vasek Pospisil
2011,104898,2234.738249,53,27,0,26,4,Robin Haase
2007,104597,2234.689429,60,33,0,27,2,Nicolas Almagro
2004,104338,2234.604225,29,16,0,13,5,Juan Monaco
1986,100356,2234.603468,52,27,0,25,0,Paul Mcnamee
2010,105064,2234.538695,60,35,0,25,2,Thomaz Bellucci
2009,103566,2234.527915,33,17,0,16,2,Michael Llodra
1995,102497,2234.48857,5,3,0,2,18,Mashiska Washington
2004,103428,2234.427133,59,33,0,26,2,Juan Ignacio Chela
1996,102835,2234.412958,6,4,0,2,11,Luke Milligan
1987,101190,2234.340256,35,17,0,18,7,Darren Cahill
1996,101601,2234.310658,33,19,0,14,10,Brett Steven
1987,105080,2234.289206,4,3,0,1,22,Miloslav Mecir
1992,101543,2234.23917,52,28,0,24,3,Jeff Tarango
2001,101320,2234.178127,37,19,0,18,3,Magnus Gustafsson
1990,101119,2234.146681,30,14,0,16,6,Marian Vajda
1985,101113,2234.086739,39,18,0,21,2,Michael Westphal
1995,101463,2234.071991,52,25,0,27,4,Bernd Karbacher
1994,101381,2234.06689,56,30,0,26,3,Aaron Krickstein
1999,103324,2234.036896,50,24,0,26,2,Arnaud Di Pasquale
1991,101475,2234.01319,28,15,0,13,3,Carlos Costa
1993,102374,2234.002299,47,24,0,23,3,Alex Corretja
1985,101230,2233.990223,8,5,0,3,5,Andrei Chesnokov
1993,102338,2233.987368,23,12,0,11,3,Yevgeny Kafelnikov
1991,101205,2233.986071,43,22,0,21,3,Grant Connell
2015,105373,2233.985312,57,30,0,27,3,Martin Klizan
1985,100894,2233.970759,37,19,0,18,10,Francesco Cancellotti
1999,101543,2233.947981,45,21,0,24,2,Jeff Tarango
1998,102419,2233.943572,14,8,0,6,17,Christophe Van Garsse
1992,101398,2233.941622,12,7,0,5,8,Neil Borwick
1992,101377,2233.861976,46,24,0,22,5,Christian Bergstrom
1994,101249,2233.84304,52,24,0,28,3,Andrei Olhovskiy
1997,102463,2233.786958,13,7,0,6,4,Lucas Arnold Ker
1988,100747,2233.717047,17,9,0,8,2,Glenn Layendecker
2011,104098,2233.711524,38,20,0,18,3,Dmitry Tursunov
1987,101377,2233.684347,31,16,0,15,4,Christian Bergstrom
2007,104499,2233.589042,7,5,0,2,8,Jimmy Wang
2005,104252,2233.481587,46,21,0,25,3,Florian Mayer
2000,102257,2233.478389,40,19,0,21,2,Greg Rusedski
2008,102148,2233.465574,35,18,0,17,3,Fabrice Santoro
2006,104523,2233.465106,6,4,0,2,8,Frederico Gil
1991,101721,2233.39102,4,3,0,1,17,Markus Zillner
2001,103153,2233.359745,6,4,0,2,22,Gilles Elseneer
1990,101421,2233.357085,38,20,0,18,1,Veli Paloheimo
2003,102318,2233.313792,20,8,0,12,2,Andrei Pavel
1998,102796,2233.282785,59,28,0,31,0,Magnus Norman
1992,102154,2233.142478,21,11,0,10,7,Marcos Ondruska
1996,102856,2232.962782,22,12,0,10,3,Gustavo Kuerten
1999,102872,2232.887686,4,3,0,1,16,James Sekulov
1995,101473,2232.882989,4,3,0,1,10,Jozsef Krocsko
1992,100752,2232.856092,12,7,0,5,7,Ramesh Krishnan
1985,100809,2232.852564,35,17,0,18,13,Juan Aguilera
1989,101552,2232.822603,6,4,0,2,13,Xavier Daufresne
1985,100957,2232.683863,44,25,0,19,5,Greg Holmes
2010,104349,2232.656741,9,6,0,3,11,Rui Machado
1991,101789,2232.649101,8,5,0,3,15,Steve Bryan
2007,103193,2232.648676,6,4,0,2,6,Peter Wessels
1989,100876,2232.647675,9,6,0,3,22,Bong Soo Kim
1989,101971,2232.627756,16,9,0,7,2,Johan Anderson
2002,103758,2232.61187,37,20,0,17,3,Taylor Dent
1986,101649,2232.558526,16,9,0,7,4,Guillermo Perez Roldan
1985,101080,2232.540664,45,26,0,19,9,Lawson Duncan
2001,103017,2232.494363,58,29,0,29,2,Nicolas Kiefer
1995,102654,2232.433599,6,4,0,2,10,Steven Downs
1987,100485,2232.366733,7,4,0,3,8,Tsuyoshi Fukui
1993,102358,2232.363833,41,18,0,23,3,Thomas Enqvist
2011,104332,2232.312972,46,24,0,22,6,Philipp Petzschner
1992,101439,2232.29121,65,33,0,32,3,Javier Sanchez
2010,103852,2232.235758,51,27,0,24,2,Feliciano Lopez
1998,102521,2232.065634,32,16,0,16,2,Hendrik Dreekmann
2006,103600,2231.880419,6,4,0,2,18,Mohammad Ghareeb
2012,105208,2231.854628,35,17,0,18,6,Ernests Gulbis
2015,104620,2231.84956,55,28,0,27,6,Simone Bolelli
1990,101264,2231.729956,13,7,0,6,8,Michael Tauson
2008,102863,2231.709058,4,3,0,1,6,Takao Suzuki
2002,103285,2231.643575,31,17,0,14,2,Radek Stepanek
1992,100954,2231.549695,42,21,0,21,3,Luiz Mattar
1986,101686,2231.503806,15,8,0,7,4,Franco Davin
1992,101956,2231.474201,6,4,0,2,19,Mark Knowles
1994,101409,2231.415033,63,34,0,29,0,Jaime Yzaga
2009,104655,2231.384616,34,19,0,15,2,Pablo Cuevas
2005,103598,2231.370053,42,22,0,20,2,Xavier Malisse
2005,103264,2231.34527,63,37,0,26,1,Mariano Puerta
1991,101767,2231.335254,39,21,0,18,3,Lars Jonsson
1986,100934,2231.288538,41,20,0,21,3,Matt Anger
1987,101196,2231.272048,45,23,0,22,2,Derrick Rostagno
2003,103280,2231.25846,50,25,0,25,2,Martin Verkerk
2007,101885,2231.248596,6,4,0,2,22,Wayne Arthurs
2013,104338,2231.241681,48,25,0,23,8,Juan Monaco
2007,101962,2231.149476,8,5,0,3,19,Younes El Aynaoui
1989,101196,2231.120442,34,16,0,18,13,Derrick Rostagno
2013,104678,2231.104772,38,19,0,19,19,Viktor Troicki
2006,103506,2231.077145,15,9,0,6,7,Martin Vassallo Arguello
1996,102035,2230.961295,50,25,0,25,3,Jonas Bjorkman
1991,101061,2230.905362,42,23,0,19,13,Jimmy Arias
2003,102257,2230.862982,21,11,0,10,8,Greg Rusedski
1989,101440,2230.839071,23,12,0,11,2,Mark Koevermans
2008,104219,2230.721647,10,6,0,4,3,Stephane Bohli
1996,103151,2230.681613,17,9,0,8,3,Mariano Zabaleta
1988,100857,2230.679542,43,22,0,21,2,Sergio Casal
2015,104678,2230.662247,63,35,0,28,3,Viktor Troicki
1990,101117,2230.599252,46,23,0,23,1,Eric Jelen
1989,100936,2230.525149,25,12,0,13,4,Henri Leconte
1992,101138,2230.409313,9,5,0,4,22,Pat Cash
2008,105023,2230.279342,54,28,0,26,2,Sam Querrey
2009,103333,2230.248005,46,23,0,23,2,Ivo Karlovic
1990,101278,2230.229448,4,3,0,1,7,Scott Melville
2007,104557,2230.220152,4,3,0,1,9,Andis Juska
1986,101086,2230.2077,42,20,0,22,6,Ronald Agenor
1998,101793,2230.105441,43,21,0,22,2,Jim Courier
1995,102025,2230.098044,7,4,0,3,3,Mikael Tillstrom
1996,102887,2230.04928,8,5,0,3,11,Ramon Delgado
2014,105668,2229.997828,50,24,0,26,2,Jerzy Janowicz
2014,105723,2229.989775,17,9,0,8,4,Andrey Kuznetsov
1988,107181,2229.978748,4,3,0,1,34,Haseeb Aslam
1998,102765,2229.951686,45,23,0,22,3,Nicolas Escude
1996,102465,2229.951256,4,3,0,1,3,Gabriel Silberstein
1995,102617,2229.949522,6,4,0,2,10,Kim Tiilikainen
1988,100815,2229.928809,36,20,0,16,3,David Pate
1994,102167,2229.874169,11,6,0,5,3,Juan Albert Viloca Puig
2012,106026,2229.862892,6,4,0,2,11,Yuki Bhambri
1991,101374,2229.827226,12,6,0,6,6,Leonardo Lavalle
1994,102701,2229.7953,23,12,0,11,3,Marcelo Rios
2012,104919,2229.722865,28,14,0,14,12,Leonardo Mayer
1990,101120,2229.648027,60,31,0,29,1,Karel Novacek
1989,100930,2229.588594,5,3,0,2,13,Paul Vojtischek
1991,109456,2229.537238,4,3,0,1,20,Carlos Lozano
2005,104117,2229.514477,15,9,0,6,8,Giovanni Lapentti
1998,103498,2229.509179,35,17,0,18,2,Marat Safin
2004,103997,2229.479745,8,5,0,3,8,Lukasz Kubot
2003,102143,2229.46697,10,6,0,4,7,Nicolas Thomann
1991,101611,2229.425868,41,21,0,20,4,Cedric Pioline
1986,101409,2229.384046,41,21,0,20,2,Jaime Yzaga
1999,102462,2229.342324,6,4,0,2,9,Bryan Juinio
2002,103171,2229.331389,26,12,0,14,3,Raemon Sluiter
1988,100876,2229.207511,9,5,0,4,14,Bong Soo Kim
1985,101409,2229.202158,7,4,0,3,16,Jaime Yzaga
1995,101932,2229.183385,38,18,0,20,3,Jared Palmer
1995,101374,2229.156763,8,5,0,3,10,Leonardo Lavalle
1986,100946,2229.155003,46,23,0,23,3,Slobodan Zivojinovic
2001,103581,2229.139194,8,5,0,3,11,Flavio Saretta
2014,105842,2229.138495,6,4,0,2,5,Di Wu
1992,107263,2229.134445,2,2,0,0,10,Jacques Radoux
1992,108867,2229.134445,4,3,0,1,10,Serge Brueck
2000,103632,2229.101175,4,3,0,1,38,Luis Horna
2002,103936,2229.094017,4,3,0,1,17,Todor Enev
1989,101884,2229.075875,4,3,0,1,22,Frank Ofori
1991,110867,2229.013122,4,3,0,1,20,Anders Haseth
1991,101991,2229.002469,2,2,0,0,20,Mauricio Hadad
1985,105080,2228.989686,6,4,0,2,12,Miloslav Mecir
1993,101412,2228.982754,34,18,0,16,6,Shuzo Matsuoka
2001,102882,2228.932179,18,10,0,8,2,Mark Philippoussis
1986,101026,2228.931623,13,7,0,6,3,Jim Grabb
2007,103490,2228.893509,6,4,0,2,31,Santiago Ventura
2003,103285,2228.884932,52,27,0,25,2,Radek Stepanek
1994,102271,2228.861684,4,3,0,1,10,Hicham Arazi
2009,103600,2228.79133,4,3,0,1,21,Mohammad Ghareeb
2003,102887,2228.774975,12,6,0,6,8,Ramon Delgado
2015,105732,2228.745402,13,7,0,6,3,Pierre Hugues Herbert
2003,103573,2228.742076,8,5,0,3,11,Rik De Voest
1990,100752,2228.724937,42,21,0,21,1,Ramesh Krishnan
1994,101235,2228.710613,50,28,0,22,3,Paul Haarhuis
2005,103868,2228.683322,4,3,0,1,31,Ivan Navarro
1987,107468,2228.642192,2,2,0,0,28,Julian Stamatov
2000,102887,2228.641885,4,3,0,1,32,Ramon Delgado
1986,101017,2228.611731,2,2,0,0,22,Gap Taik Ro
1995,102716,2228.611523,3,2,0,1,6,Maxime Huard
2000,103227,2228.604319,2,2,0,0,20,Mariano Sanchez
1997,101601,2228.601397,43,24,0,19,5,Brett Steven
2010,105217,2228.577805,52,28,0,24,2,Thiemo De Bakker
1997,102403,2228.571302,4,3,0,1,19,Bojan Vujic
2007,104433,2228.548943,37,18,0,19,3,Frank Dancevic
1987,100740,2228.539872,7,4,0,3,5,Dan Cassidy
2002,101990,2228.511796,13,7,0,6,10,Richard Krajicek
1987,100661,2228.509393,31,15,0,16,7,Damir Keretic
2001,104098,2228.503604,4,3,0,1,38,Dmitry Tursunov
1988,101647,2228.489994,4,3,0,1,23,Byron Black
2003,103009,2228.419644,6,4,0,2,8,Razvan Sabau
1993,100955,2228.414378,4,3,0,1,6,Yahiya Doumbia
2001,103505,2228.34644,4,3,0,1,9,Vasilis Mazarakis
1996,102223,2228.326252,39,17,0,22,8,Karim Alami
1997,102905,2228.2807,6,4,0,2,11,Stefan Koubek
1993,101432,2228.279872,11,6,0,5,3,Dimitri Poliakov
2002,103324,2228.275536,12,7,0,5,9,Arnaud Di Pasquale
1987,107845,2228.271923,4,3,0,1,28,Necvet Demir
2013,106233,2228.26358,6,4,0,2,6,Dominic Thiem
2000,102192,2228.249673,4,3,0,1,22,Luis Adrian Morejon
2006,103668,2228.240441,6,4,0,2,8,Lazar Magdincev
2006,103018,2228.229136,47,22,0,25,2,Max Mirnyi
1985,101195,2228.215274,34,17,0,17,3,Amos Mansdorf
1990,101354,2228.179735,34,17,0,17,1,Andrew Sznajder
1998,101991,2228.169517,6,4,0,2,3,Mauricio Hadad
2011,103917,2228.162167,23,11,0,12,3,Nicolas Mahut
2008,104907,2228.157047,4,3,0,1,8,Jose Rubin Statham
2002,103821,2228.149035,6,4,0,2,8,Danai Udomchoke
1996,101746,2228.137044,65,35,0,30,3,Renzo Furlan
1999,102202,2228.1006,43,23,0,20,6,Kenneth Carlsen
2013,104797,2228.086792,62,32,0,30,3,Denis Istomin
2008,104312,2228.0719,60,30,0,30,2,Andreas Seppi
2013,105217,2228.067658,20,10,0,10,11,Thiemo De Bakker
2001,102655,2228.067161,4,3,0,1,18,Jimy Szymanski
1998,103598,2228.049187,15,8,0,7,3,Xavier Malisse
1986,100876,2228.047008,2,2,0,0,32,Bong Soo Kim
1992,102018,2228.047008,2,2,0,0,19,Tamer El Sawy
1995,100653,2228.047008,2,2,0,0,35,Andres Gomez
1997,100431,2228.047008,4,3,0,1,33,Mansour Bahrami
1998,102462,2228.047008,2,2,0,0,18,Bryan Juinio
2000,103504,2228.047008,4,3,0,1,37,Febi Widhiyanto
2000,108607,2228.047008,2,2,0,0,20,Andrei Luzgin
2014,106198,2228.047008,4,3,0,1,32,Hugo Dellien
2013,105030,2228.04229,2,2,0,0,11,Michael Venus
2000,103333,2228.027549,2,2,0,0,9,Ivo Karlovic
1995,102069,2228.007005,4,3,0,1,20,Andrei Rybalko
2015,103529,2228.006561,2,2,0,0,11,Aisam Ul Haq Qureshi
2015,106174,2228.006561,2,2,0,0,11,Gonzalo Lama
1995,102018,2227.988984,4,3,0,1,10,Tamer El Sawy
1988,101651,2227.97684,2,2,0,0,23,Owen Casey
1999,101651,2227.976551,4,3,0,1,18,Owen Casey
1985,100926,2227.970815,24,12,0,12,9,Ken Flach
1988,100984,2227.966096,4,3,0,1,29,Peter Wright
1992,106782,2227.9249,4,3,0,1,29,Colin Grant
2010,105961,2227.887175,2,2,0,0,22,David Souto
2008,103523,2227.864599,8,5,0,3,19,Rohan Bopanna
1987,100853,2227.753117,4,3,0,1,22,Dong Wook Song
1999,103420,2227.748725,4,3,0,1,29,Michal Tabara
1985,100393,2227.730953,10,6,0,4,20,Marcos Hocevar
1989,101481,2227.669318,33,18,0,15,9,Omar Camporese
1990,100653,2227.656123,62,38,0,24,0,Andres Gomez
1989,101063,2227.648311,43,23,0,20,2,Jordi Arrese
1997,101736,2227.602293,24,12,0,12,4,Andre Agassi
2012,105011,2227.601506,4,3,0,1,11,Illya Marchenko
2004,103507,2227.578225,39,23,0,16,4,Juan Carlos Ferrero
1994,100757,2227.57385,24,12,0,12,6,Anders Jarryd
1992,101485,2227.563578,6,4,0,2,29,Tanakorn Srichaphan
1992,101224,2227.543858,8,4,0,4,7,Kenny Thorne
1988,101017,2227.524294,2,2,0,0,39,Gap Taik Ro
1988,107824,2227.524294,2,2,0,0,34,Mohamed Dlimi
1988,107897,2227.524294,2,2,0,0,23,Orlando Lourenco
1988,108469,2227.524294,2,2,0,0,39,Victor Caldarelli
1992,106741,2227.524294,2,2,0,0,29,Christian Camradt
1996,101677,2227.524294,2,2,0,0,19,Zoran Sevcenko
1998,103499,2227.524294,2,2,0,0,18,Aqeel Khan
1999,101957,2227.524294,2,2,0,0,18,Milen Velev
2000,102036,2227.524294,4,3,0,1,37,Marco Osorio
2000,103286,2227.524294,2,2,0,0,37,Yohny Romero
2003,103053,2227.524294,2,2,0,0,17,Nikos Rovas
2006,102107,2227.524294,2,2,0,0,16,Jan Frode Andersen
1992,101191,2227.504714,38,18,0,20,3,Richey Reneberg
2007,103455,2227.503951,2,2,0,0,9,Michal Mertinak
2010,106000,2227.503922,2,2,0,0,11,Damir Dzumhur
1997,102562,2227.493298,41,21,0,20,2,Jiri Novak
2011,103514,2227.483668,2,2,0,0,12,Young Jun Kim
2013,105961,2227.482193,4,3,0,1,11,David Souto
2008,104869,2227.457711,2,2,0,0,8,Sergei Bubka
1998,102959,2227.449461,2,2,0,0,18,Marko Tkalec
1986,101332,2227.443125,4,3,0,1,9,Gilad Bloom
2010,104887,2227.443033,2,2,0,0,11,Piero Luisi
1997,101609,2227.438499,18,10,0,8,2,David Wheaton
2001,102722,2227.377447,13,8,0,5,3,Attila Savolt
1995,101481,2227.363325,10,6,0,4,9,Omar Camporese
1999,102419,2227.337985,6,4,0,2,9,Christophe Van Garsse
1989,100946,2227.30362,34,17,0,17,5,Slobodan Zivojinovic
1995,101507,2227.283265,52,26,0,26,3,Tomas Carbonell
2002,103017,2227.238632,48,20,0,28,3,Nicolas Kiefer
1987,101416,2227.230533,6,4,0,2,22,Joao Cunha Silva
2008,104583,2227.218059,2,2,0,0,8,Filip Polasek
2002,102233,2227.202664,6,4,0,2,8,Leander Paes
2014,105449,2227.173408,40,20,0,20,3,Steve Johnson
2008,103813,2227.144195,54,26,0,28,2,Jarkko Nieminen
2006,104813,2227.139263,4,3,0,1,16,Grega Zemlja
2002,103153,2227.139053,6,4,0,2,8,Gilles Elseneer
2009,108701,2227.100974,2,2,0,0,29,Juan Sebastian Cabal
1989,100747,2227.093748,35,17,0,18,5,Glenn Layendecker
2006,104112,2227.066881,5,3,0,2,7,Benjamin Balleret
1999,102247,2227.05247,29,15,0,14,7,Andrea Gaudenzi
2005,104311,2227.040683,2,2,0,0,8,Leonardo Tavares
2006,105053,2227.040567,4,3,0,1,8,Santiago Giraldo
2015,111761,2227.038395,4,3,0,1,19,Benjamin Lock
2013,103781,2227.037425,52,25,0,27,7,Jurgen Melzer
1991,101285,2227.02631,53,24,0,29,0,Thierry Champion
2006,102843,2227.021953,2,2,0,0,8,Suwandi Suwandi
2015,106237,2227.020372,2,2,0,0,11,Chieh Fu Wang
2005,103029,2227.002227,6,4,0,2,8,Mehdi Tahiri
1989,101964,2227.000797,57,31,0,26,7,Goran Ivanisevic
1985,110882,2227,2,2,0,0,49,Kelvin Ng
1986,100991,2227,2,2,0,0,32,Johnny Goudenbour
1986,101349,2227,2,2,0,0,44,Adam Malik
1986,101365,2227,2,2,0,0,44,Paul Wekesa
1986,108007,2227,2,2,0,0,32,Phillip Tuckniss
1986,108056,2227,2,2,0,0,44,Reda Galou
1987,101156,2227,2,2,0,0,51,Juan Pino
1987,107097,2227,2,2,0,0,33,Gilles Ganancia
1987,109480,2227,2,2,0,0,33,Alex Roman
1988,100368,2227,2,2,0,0,39,Haroon Ismail
1988,106941,2227,2,2,0,0,47,Eno Polo
1988,110914,2227,2,2,0,0,34,Robert Dolan
1988,110967,2227,2,2,0,0,34,Ioannis Rigas
1988,111110,2227,2,2,0,0,39,Hashim Bin Sidek
1989,100454,2227,2,2,0,0,53,Mehl Ampon
1989,110903,2227,2,2,0,0,43,Zacharie Moungnol
1989,111002,2227,2,2,0,0,53,Hani Al Ali
1991,100794,2227,2,2,0,0,48,Srinivasan Vasudevan
1991,101349,2227,2,2,0,0,25,Adam Malik
1991,101794,2227,2,2,0,0,50,Darek Nowicki
1991,102152,2227,2,2,0,0,50,Pablo Campana
1991,106527,2227,2,2,0,0,34,Andreas Fikas
1991,107534,2227,2,2,0,0,50,Kush Bhardwaj
1991,108754,2227,2,2,0,0,34,Esam Abdulaal
1991,108849,2227,2,2,0,0,25,Rohan De Silva
1992,101369,2227,4,3,0,1,29,Bent Ove Pedersen
1992,101748,2227,2,2,0,0,29,Ivan Keskinov
1992,102000,2227,4,3,0,1,44,Aki Rahunen
1992,107826,2227,4,3,0,1,35,Mohammed Khalid
1992,108810,2227,2,2,0,0,29,Khaled El Salawy
1992,110794,2227,4,3,0,1,19,Jerome Seguin
1992,110867,2227,2,2,0,0,29,Anders Haseth
1993,101651,2227,2,2,0,0,30,Owen Casey
1993,102372,2227,2,2,0,0,8,Sule Ladipo
1993,108828,2227,2,2,0,0,8,Emmanuel Udozorh
1993,110352,2227,2,2,0,0,44,Mostafa Saleh
1994,102069,2227,2,2,0,0,30,Andrei Rybalko
1994,102395,2227,2,2,0,0,30,Ville Liukko
1994,102655,2227,2,2,0,0,43,Jimy Szymanski
1994,108811,2227,4,3,0,1,19,Christophe Boggetti
1995,108810,2227,2,2,0,0,30,Khaled El Salawy
1997,101991,2227,2,2,0,0,44,Mauricio Hadad
1997,102320,2227,4,3,0,1,33,Lazaro Navarro Batles
1997,103515,2227,2,2,0,0,28,Filip Aniola
1997,108532,2227,2,2,0,0,42,Worapol Thongkamcho
1997,108585,2227,2,2,0,0,44,Americo Venero Montes
1999,102556,2227,2,2,0,0,28,Claude Ngoran
1999,102740,2227,2,2,0,0,18,Francisco Rodriguez
1999,104051,2227,2,2,0,0,18,Andrej Kracman
2000,102740,2227,2,2,0,0,47,Francisco Rodriguez
2000,103612,2227,4,3,0,1,37,Alexey Kedryuk
2001,108593,2227,2,2,0,0,40,Wing Luen Wong
2001,108603,2227,2,2,0,0,29,Helge Koll Frafjord
2002,101895,2227,4,3,0,1,31,Michael Brown B395
2002,103828,2227,2,2,0,0,31,Jean Julien Rojer
2002,104499,2227,2,2,0,0,38,Jimmy Wang
2003,103803,2227,4,3,0,1,31,Ashkan Shokoofi
2003,104496,2227,2,2,0,0,39,Luis Manuel Flores
2003,104499,2227,4,3,0,1,8,Jimmy Wang
2004,102076,2227,2,2,0,0,38,Mark Merklein
2004,102928,2227,2,2,0,0,31,Hee Seok Chung
2004,102959,2227,2,2,0,0,31,Marko Tkalec
2005,102107,2227,4,3,0,1,17,Jan Frode Andersen
2005,103612,2227,4,3,0,1,17,Alexey Kedryuk
2005,103828,2227,2,2,0,0,34,Jean Julien Rojer
2006,103504,2227,2,2,0,0,30,Febi Widhiyanto
2006,108942,2227,2,2,0,0,36,Henry Estrella
2008,104476,2227,2,2,0,0,31,Louk Sorensen
2008,104810,2227,2,2,0,0,31,Zhe Li
2008,104895,2227,2,2,0,0,38,Abdullah Maqdas
2008,105079,2227,2,2,0,0,8,Ivan Sergeyev
2009,103638,2227,2,2,0,0,11,Jhonson Garcia
2010,104823,2227,2,2,0,0,40,Bruno Rodriguez
2010,105402,2227,2,2,0,0,40,Peerakiat Siriluethaiwattana
2011,103077,2227,2,2,0,0,21,Konstantinos Economidis
2011,104162,2227,2,2,0,0,38,Deniss Pavlovs
2011,105464,2227,4,3,0,1,21,Christopher Rungkat
2011,108947,2227,2,2,0,0,21,West Nott
2012,104631,2227,2,2,0,0,35,Harshana Godamanna
2012,105066,2227,2,2,0,0,42,Grzegorz Panfil
2012,105318,2227,2,2,0,0,35,Thomas Schoorel
2012,106175,2227,2,2,0,0,42,Ricardo Rodriguez
2013,105255,2227,2,2,0,0,34,Bassam Beidas
2014,104477,2227,2,2,0,0,32,Jorge Aguilar
2014,104631,2227,4,3,0,1,32,Harshana Godamanna
2014,104895,2227,2,2,0,0,40,Abdullah Maqdas
2003,102401,2226.989659,29,13,0,16,6,Scott Draper
1996,102644,2226.987063,14,7,0,7,3,Franco Squillari
2006,108973,2226.97966,2,2,0,0,16,Carl Sundberg
1999,102467,2226.979628,2,2,0,0,34,Fazaluddin Syed
2010,108688,2226.978836,2,2,0,0,22,Martin Sayer
1988,100972,2226.977493,33,17,0,16,6,Todd Witsken
1995,102100,2226.965499,4,3,0,1,20,Bartlomiej Dabrowski
2011,105273,2226.959317,2,2,0,0,12,Mauricio Echazu
2009,103739,2226.959256,4,3,0,1,11,Jose De Armas
2008,102887,2226.95498,8,5,0,3,8,Ramon Delgado
2000,102765,2226.954462,51,28,0,23,3,Nicolas Escude
2004,103607,2226.904461,4,3,0,1,8,Victor Estrella
1985,100603,2226.88559,6,4,0,2,10,Roland Stadler
2010,104797,2226.875414,61,32,0,29,2,Denis Istomin
1996,101463,2226.864738,44,19,0,25,6,Bernd Karbacher
2013,104978,2226.863794,47,24,0,23,5,Daniel Brands
1995,102887,2226.745951,4,3,0,1,35,Ramon Delgado
1990,101178,2226.744378,10,6,0,4,5,Pieter Aldrich
2011,104673,2226.672664,4,3,0,1,12,Julio Cesar Campozano
1998,101885,2226.622108,7,4,0,3,2,Wayne Arthurs
2015,106342,2226.612296,4,3,0,1,19,Martins Podzus
2008,105259,2226.605078,2,2,0,0,8,Andrei Karatchenia
2012,104297,2226.5983,11,6,0,5,11,Rogerio Dutra Silva
1989,102031,2226.568865,4,3,0,1,37,Sandor Noszaly
2008,104871,2226.567402,19,10,0,9,2,Jeremy Chardy
2008,104368,2226.556983,6,4,0,2,8,Daniel King Turner
2014,105004,2226.553919,4,3,0,1,32,Dimitar Kutrovsky
2009,104071,2226.534057,4,3,0,1,29,Raven Klaasen
1985,100360,2226.522892,33,17,0,16,5,Brian Teacher
2005,104523,2226.516384,4,3,0,1,8,Frederico Gil
1993,101216,2226.483319,2,2,0,0,30,Olli Rahnasto
1996,102800,2226.482655,2,2,0,0,19,Nenad Zimonjic
2000,102880,2226.476066,19,9,0,10,2,Alexander Popp
1989,100890,2226.475706,2,2,0,0,43,Rashid Malik
1997,103066,2226.475706,2,2,0,0,33,Mark Nielsen
1997,106536,2226.475706,2,2,0,0,19,Andres Filimonov
1998,108588,2226.475706,2,2,0,0,18,Asim Shafik
2000,102552,2226.475706,2,2,0,0,20,Baris Ergun
2000,108596,2226.475706,4,3,0,1,40,Ramin Raziyani
2001,102448,2226.475706,2,2,0,0,33,Ali Hamadeh
2001,103583,2226.475706,2,2,0,0,18,Evghenii Plugariov
2001,103607,2226.475706,2,2,0,0,33,Victor Estrella
2001,104215,2226.475706,2,2,0,0,18,Andrei Gorban
2002,103864,2226.475706,2,2,0,0,17,Mohamed Mamoun
2003,103505,2226.475706,2,2,0,0,17,Vasilis Mazarakis
2003,103828,2226.475706,2,2,0,0,31,Jean Julien Rojer
2003,103875,2226.475706,2,2,0,0,31,Anoosha Shahgholi
2003,108628,2226.475706,2,2,0,0,8,Jhonnatan Medina Alvarez
2004,104501,2226.475706,2,2,0,0,31,Xin Yuan Yu
2005,104247,2226.475706,2,2,0,0,17,Sebo Kiss
2005,104582,2226.475706,2,2,0,0,17,Rok Jarc
2005,104591,2226.475706,4,3,0,1,17,Patrick Tierro
2006,103936,2226.475706,2,2,0,0,16,Todor Enev
2006,104907,2226.475706,2,2,0,0,30,Jose Rubin Statham
2007,103586,2226.475706,2,2,0,0,19,Mariusz Fyrstenberg
2007,103690,2226.475706,2,2,0,0,9,Marcin Matkowski
2007,104826,2226.475706,2,2,0,0,35,Federico Sansonetti
2007,108960,2226.475706,2,2,0,0,35,Michael Lai
2008,104008,2226.475706,2,2,0,0,31,Carlos Avellan
2009,104352,2226.475706,2,2,0,0,21,Colin Obrien
2009,104499,2226.475706,2,2,0,0,42,Jimmy Wang
2009,104996,2226.475706,2,2,0,0,21,Alexander Blom
2009,105311,2226.475706,2,2,0,0,21,Joao Sousa
2010,105226,2226.475706,2,2,0,0,22,Attila Balazs
2011,104299,2226.475706,2,2,0,0,21,Hiu Tung Yu
2011,104839,2226.475706,2,2,0,0,21,Yassine Idmbarek
2011,105590,2226.475706,4,3,0,1,21,Uladzimir Ignatik
2012,105541,2226.475706,2,2,0,0,35,Alex Llompart
2014,104604,2226.475706,2,2,0,0,32,Ruben Gonzales
2015,105070,2226.475706,2,2,0,0,11,Hans Podlipnik Castillo
2009,110685,2226.458509,2,2,0,0,21,Gd Jones
2008,102839,2226.458002,35,17,0,18,3,Nicolas Lapentti
2010,103531,2226.455366,4,3,0,1,22,Thomas Oger
2003,102830,2226.442091,2,2,0,0,31,Paulo Carvallo
2002,103421,2226.434962,2,2,0,0,38,Peter Handoyo
2000,103813,2226.425044,4,3,0,1,2,Jarkko Nieminen
2009,104026,2226.424881,5,3,0,2,6,Joachim Johansson
1985,100502,2226.418596,22,10,0,12,6,Vincent Van Patten
2003,108593,2226.414904,4,3,0,1,8,Wing Luen Wong
1992,101167,2226.402646,4,3,0,1,35,Jaime Cortes
2003,103607,2226.401052,4,3,0,1,8,Victor Estrella
1985,101138,2226.394815,21,12,0,9,24,Pat Cash
2010,104332,2226.389803,40,21,0,19,13,Philipp Petzschner
1998,102826,2226.36874,4,3,0,1,9,Muhammad Khaliq Siddiq
2005,103997,2226.330826,4,3,0,1,14,Lukasz Kubot
1994,101888,2226.316779,52,25,0,27,3,Daniel Vacek
2004,104294,2226.262321,4,3,0,1,10,Hao Lu
1992,101884,2226.2565,4,3,0,1,19,Frank Ofori
1993,101373,2226.254653,30,14,0,16,3,Karsten Braasch
2006,105208,2226.228545,6,4,0,2,3,Ernests Gulbis
1994,102344,2226.187109,26,13,0,13,3,Karol Kucera
2001,102737,2226.165664,4,3,0,1,18,Gergely Kisgyorgy
1994,101659,2226.144627,34,17,0,17,5,Jan Apell
1996,101970,2226.137745,4,3,0,1,19,Iztok Bozic
1988,100646,2226.117326,15,8,0,7,9,Claudio Panatta
2005,102450,2226.106302,41,23,0,18,3,Tim Henman
2002,102563,2226.101857,52,29,0,23,1,Thomas Johansson
1989,101185,2226.082926,40,21,0,19,7,Mark Woodforde
1988,101120,2226.076365,26,13,0,13,13,Karel Novacek
1992,101382,2226.056253,50,28,0,22,3,Marcelo Filippini
1994,101582,2226.055935,51,24,0,27,3,Gilbert Schaller
1998,102131,2226.0329,4,3,0,1,41,Alistair Hunt
1997,102765,2226.030581,12,6,0,6,3,Nicolas Escude
1988,100792,2226.021567,4,3,0,1,29,Adrian Marcu
2005,104527,2226.015683,32,16,0,16,2,Stanislas Wawrinka
2001,102544,2226.012548,6,4,0,2,18,Pablo Bianchi
2001,102202,2225.996736,16,9,0,7,8,Kenneth Carlsen
1999,102830,2225.992127,4,3,0,1,18,Paulo Carvallo
1995,101563,2225.991703,2,2,0,0,43,Joseph Lizardo
2005,103826,2225.990533,2,2,0,0,17,Carlos Palencia
2009,104618,2225.989998,4,3,0,1,21,Devin Mullings
2014,104770,2225.974828,2,2,0,0,9,Martin Fischer
1989,101156,2225.973243,4,3,0,1,43,Juan Pino
2003,102131,2225.972456,2,2,0,0,31,Alistair Hunt
2001,103593,2225.971755,2,2,0,0,18,Marcelo Barboza
2007,104200,2225.971755,2,2,0,0,19,Juan Manuel Elizondo
2014,103821,2225.971755,2,2,0,0,9,Danai Udomchoke
1988,110897,2225.952992,4,3,0,1,34,Greig Rodger
1989,110900,2225.952992,4,3,0,1,28,Jean Yves Job
1991,101101,2225.952992,4,3,0,1,42,Richard Ashby
1992,102152,2225.952992,2,2,0,0,35,Pablo Campana
1993,102018,2225.952992,4,3,0,1,21,Tamer El Sawy
1993,108814,2225.952992,4,3,0,1,21,Konstantinos Effraimoglou
1994,101979,2225.952992,4,3,0,1,36,Ricardo Mena
1994,102068,2225.952992,4,3,0,1,36,Omer Rashid
1994,102362,2225.952992,2,2,0,0,19,Amro Ghoneim
1994,102538,2225.952992,4,3,0,1,19,Tuomas Ketola
1994,102826,2225.952992,4,3,0,1,36,Muhammad Khaliq Siddiq
1994,102887,2225.952992,2,2,0,0,36,Ramon Delgado
1995,101171,2225.952992,4,3,0,1,35,Armando Perez
2002,103746,2225.952992,4,3,0,1,8,Miguel Gallardo Valles
2003,108644,2225.952992,4,3,0,1,20,Patrick Chucri
2004,104655,2225.952992,4,3,0,1,31,Pablo Cuevas
2006,103175,2225.952992,2,2,0,0,30,Toshihide Matsui
2006,104421,2225.952992,2,2,0,0,30,Martin Vilarrubi
2007,104763,2225.952992,4,3,0,1,35,Rafael Arevalo
2008,103286,2225.952992,4,3,0,1,31,Yohny Romero
2008,108693,2225.952992,2,2,0,0,31,Romano Tatuhey
2010,105132,2225.952992,4,3,0,1,22,Jurgen Zopp
2012,104920,2225.952992,2,2,0,0,35,Denys Molchanov
2013,105985,2225.952992,4,3,0,1,34,Darian King
2014,105464,2225.952992,2,2,0,0,28,Christopher Rungkat
2014,111453,2225.952992,2,2,0,0,32,Mikael Torpegaard
2015,125571,2225.952992,2,2,0,0,19,Christian Garay
2000,103529,2225.951412,4,3,0,1,37,Aisam Ul Haq Qureshi
2004,103050,2225.951412,2,2,0,0,31,Shahab Hassani Nafez
2013,103821,2225.951412,4,3,0,1,34,Danai Udomchoke
2000,108604,2225.947871,2,2,0,0,20,Pascal Schaul
2007,104467,2225.93691,2,2,0,0,19,Lamine Ouahab
1999,102263,2225.935875,2,2,0,0,40,Yong Il Yoon
2010,103529,2225.934203,4,3,0,1,22,Aisam Ul Haq Qureshi
2002,103273,2225.932744,2,2,0,0,8,Dong Hyun Kim
1993,108816,2225.929141,2,2,0,0,21,Isaac Donkor
1998,100943,2225.926468,4,3,0,1,18,Girts Dzelde
1998,106536,2225.926468,4,3,0,1,18,Andres Filimonov
1991,101719,2225.911017,21,11,0,10,3,Frederic Fontang
2002,102740,2225.895329,4,3,0,1,31,Francisco Rodriguez
2015,104494,2225.890643,4,3,0,1,19,Adrian Ungur
1996,101318,2225.851082,48,26,0,22,6,Javier Frana
1989,101485,2225.843047,6,4,0,2,22,Tanakorn Srichaphan
2001,103421,2225.830484,2,2,0,0,9,Peter Handoyo
1998,101947,2225.779443,16,8,0,8,10,Vincenzo Santopadre
2014,104797,2225.775827,54,28,0,26,2,Denis Istomin
1995,102247,2225.774454,60,32,0,28,4,Andrea Gaudenzi
2007,104535,2225.736888,4,3,0,1,19,Daniel Garza
2004,104081,2225.709828,6,4,0,2,8,Boris Pashanski
2015,105385,2225.690064,45,22,0,23,5,Donald Young
2008,104305,2225.674452,7,4,0,3,6,Luka Gregorc
1994,101123,2225.665745,27,13,0,14,3,Alexander Mronz
1988,107833,2225.654018,6,4,0,2,23,Mushaf Zia
1986,100901,2225.638199,34,18,0,16,3,Paul Annacone
1995,102152,2225.617589,2,2,0,0,10,Pablo Campana
1992,101809,2225.591479,6,4,0,2,19,Nicolas Pereira
1989,100841,2225.581275,4,3,0,1,37,Jin Sun Yoo
1986,101109,2225.571307,14,7,0,7,6,Tarik Benhabiles
1998,102077,2225.570846,4,3,0,1,9,Alexander Shvec
1994,102372,2225.568567,6,4,0,2,17,Sule Ladipo
1988,101500,2225.557515,41,21,0,20,2,Christian Saceanu
2009,103851,2225.551619,4,3,0,1,21,Conor Niland
2006,104869,2225.544422,2,2,0,0,8,Sergei Bubka
2001,101991,2225.509383,4,3,0,1,33,Mauricio Hadad
1996,102201,2225.505844,33,14,0,19,4,Lionel Roux
2010,104660,2225.47979,52,27,0,25,2,Sergiy Stakhovsky
2006,104247,2225.478047,6,4,0,2,8,Sebo Kiss
1986,110782,2225.433416,4,3,0,1,39,Djamel Boudjemline
1998,102285,2225.428698,2,2,0,0,18,Nasser Ghanim Al Khulaifi
1999,102277,2225.428698,4,3,0,1,34,Bing Chao Lin
2002,104027,2225.428698,4,3,0,1,31,Pablo Gonzalez
2015,200274,2225.428698,2,2,0,0,19,Alex Diaz
2003,103514,2225.412181,2,2,0,0,8,Young Jun Kim
1991,102318,2225.387474,2,2,0,0,34,Andrei Pavel
2007,102318,2225.340959,29,14,0,15,3,Andrei Pavel
2012,104673,2225.337608,4,3,0,1,11,Julio Cesar Campozano
1997,102987,2225.335818,4,3,0,1,4,Andre Sa
1999,101563,2225.321129,6,4,0,2,9,Joseph Lizardo
1993,101406,2225.311685,2,2,0,0,21,Wojtek Kowalski
1988,101318,2225.308468,34,16,0,18,2,Javier Frana
1986,100759,2225.289003,29,15,0,14,3,Danie Visser
1985,101017,2225.28181,4,3,0,1,12,Gap Taik Ro
2009,103888,2225.265901,39,21,0,18,13,Mardy Fish
1989,101284,2225.221707,8,4,0,4,10,Lars Anders Wahlgren
2011,105842,2225.21821,4,3,0,1,9,Di Wu
1992,101249,2225.197727,34,16,0,18,3,Andrei Olhovskiy
2007,103444,2225.188073,4,3,0,1,9,Jean Rene Lisnard
1985,100905,2225.164264,43,22,0,21,4,Sammy Giammalva Jr
2004,103151,2225.156251,48,26,0,22,2,Mariano Zabaleta
2014,104586,2225.066662,59,30,0,29,2,Lukas Rosol
2005,103781,2225.064798,52,26,0,26,3,Jurgen Melzer
1991,101590,2225.051511,4,3,0,1,34,Eui Jong Chang
1987,100809,2225.029501,15,7,0,8,2,Juan Aguilera
2003,103333,2225.008459,16,9,0,7,3,Ivo Karlovic
1995,102223,2224.999501,31,16,0,15,3,Karim Alami
2011,104251,2224.995951,2,2,0,0,12,Ti Chen
1990,101233,2224.982815,44,25,0,19,1,Alex Antonitsch
2000,102469,2224.976881,6,4,0,2,9,Solon Peppas
2011,104655,2224.972964,26,13,0,13,27,Pablo Cuevas
1993,102029,2224.961201,14,8,0,6,11,Filip Dewulf
2007,104386,2224.947301,41,19,0,22,2,Janko Tipsarevic
1999,103602,2224.930909,4,3,0,1,13,Fernando Gonzalez
1993,101022,2224.919005,13,7,0,6,5,Kelly Jones
1985,100619,2224.908248,4,3,0,1,26,George Kalovelonis
2005,104895,2224.906769,4,3,0,1,17,Abdullah Maqdas
1986,107897,2224.905983,4,3,0,1,38,Orlando Lourenco
1987,107629,2224.905983,4,3,0,1,33,Manuel Tolentino
1988,106580,2224.905983,4,3,0,1,39,Arjun Fernando
1989,108056,2224.905983,4,3,0,1,44,Reda Galou
1989,110852,2224.905983,4,3,0,1,43,Umesha Wallooppillai
1991,110905,2224.905983,4,3,0,1,42,Fred Kangwa
1992,100991,2224.905983,4,3,0,1,19,Johnny Goudenbour
1992,101506,2224.905983,2,2,0,0,19,Eoin Collins
1994,108532,2224.905983,4,3,0,1,36,Worapol Thongkamcho
1995,102097,2224.905983,4,3,0,1,35,Naratorn Srichaphan
1995,108595,2224.905983,4,3,0,1,35,Mohammed Reza Tavakoli
1995,108847,2224.905983,2,2,0,0,35,Jahanbakhsh Souri
1998,102537,2224.905983,4,3,0,1,18,Melvin Tong
2013,104677,2224.905983,4,3,0,1,34,Artem Sitak
2013,105499,2224.905983,4,3,0,1,34,Christopher Diaz Figueroa
1985,100401,2224.888322,4,3,0,1,26,Sean Sorensen
2008,104467,2224.88486,4,3,0,1,25,Lamine Ouahab
2014,105273,2224.876238,4,3,0,1,32,Mauricio Echazu
1998,108686,2224.873563,4,3,0,1,18,Alejandro Aramburu Acuna
1997,102549,2224.8733,4,3,0,1,19,Rolandas Murashka
1999,102811,2224.869251,2,2,0,0,18,Dusan Vemic
1996,108753,2224.867284,2,2,0,0,34,Othman Al Anazi
1996,101979,2224.86404,4,3,0,1,34,Ricardo Mena
2008,104724,2224.864038,30,15,0,15,3,Eduardo Schwank
2013,104349,2224.855138,4,3,0,1,11,Rui Machado
2010,104371,2224.853385,2,2,0,0,22,Ivo Minar
2010,104171,2224.84681,4,3,0,1,23,Richard Bloomfield
1998,103197,2224.831015,4,3,0,1,18,John Doran
2009,104952,2224.814727,4,3,0,1,21,Martin Pedersen
2002,101976,2224.810417,4,3,0,1,17,Federico Dondo
2001,103525,2224.783763,4,3,0,1,9,Ivan Miranda
2015,104797,2224.774551,47,23,0,24,6,Denis Istomin
1985,100440,2224.744713,24,11,0,13,1,Eddie Edwards
2008,104025,2224.670738,15,8,0,7,6,Amer Delic
1990,101746,2224.645452,17,9,0,8,6,Renzo Furlan
2003,104745,2224.600487,25,14,0,11,3,Rafael Nadal
2002,102035,2224.572277,44,21,0,23,3,Jonas Bjorkman
2004,102233,2224.535279,4,3,0,1,31,Leander Paes
1991,101276,2224.525685,36,16,0,20,12,Horacio De La Pena
1989,101664,2224.478501,4,3,0,1,37,Andras Lanyi
2015,105299,2224.443751,4,3,0,1,19,Dzmitry Zhyrmont
1993,101468,2224.437162,9,5,0,4,18,Gerard Solves
2003,103824,2224.394209,4,3,0,1,17,Orest Tereshchuk
2013,104631,2224.386408,4,3,0,1,34,Harshana Godamanna
2014,103499,2224.386408,4,3,0,1,32,Aqeel Khan
2003,103103,2224.354067,52,26,0,26,2,Dominik Hrbaty
1985,108356,2224.348362,6,4,0,2,20,Tarek El Sakka
2003,103225,2224.256863,7,4,0,3,8,Simon Larose
1999,101976,2224.253228,4,3,0,1,18,Federico Dondo
2006,104792,2224.209566,39,20,0,19,2,Gael Monfils
1995,102401,2224.140644,26,13,0,13,3,Scott Draper
1999,102110,2224.109151,35,18,0,17,6,Daniel Nestor
1997,101979,2224.107813,4,3,0,1,33,Ricardo Mena
2008,104571,2224.098893,26,14,0,12,2,Marcos Baghdatis
1998,102556,2224.093508,6,4,0,2,9,Claude Ngoran
1995,102372,2224.086663,6,4,0,2,20,Sule Ladipo
2012,103908,2224.002197,31,14,0,17,3,Paul Henri Mathieu
2002,104180,2223.99692,4,3,0,1,17,Gilles Muller
2013,111575,2223.91527,6,4,0,2,4,Karen Khachanov
2002,102983,2223.903893,4,3,0,1,14,Henrik Andersson
1987,101630,2223.898868,4,3,0,1,46,Clement Ngoran
1987,110786,2223.898868,4,3,0,1,46,Antoine Beugre
1989,101022,2223.897591,18,10,0,8,3,Kelly Jones
2014,105877,2223.886543,4,3,0,1,32,Emilio Gomez
1996,101609,2223.882848,27,12,0,15,12,David Wheaton
2008,103428,2223.871632,24,12,0,12,24,Juan Ignacio Chela
2014,105499,2223.871495,4,3,0,1,32,Christopher Diaz Figueroa
2009,104112,2223.866833,4,3,0,1,21,Benjamin Balleret
2012,104395,2223.835568,4,3,0,1,35,Marcel Felder
1996,102100,2223.829925,6,4,0,2,10,Bartlomiej Dabrowski
1993,101485,2223.827828,6,4,0,2,30,Tanakorn Srichaphan
2005,103835,2223.82582,56,28,0,28,3,Filippo Volandri
1989,100984,2223.78032,2,2,0,0,37,Peter Wright
2002,103812,2223.728833,8,5,0,3,8,Victor Hanescu
1992,108756,2223.723011,4,3,0,1,19,Goudjo Gbedey
2013,105062,2223.680518,12,6,0,6,6,Mikhail Kukushkin
1985,101309,2223.653931,5,3,0,2,16,Jay Berger
1987,100782,2223.574881,37,16,0,21,2,Pablo Arraya
1991,100923,2223.574822,54,28,0,26,3,Wally Masur
2005,104360,2223.544998,4,3,0,1,14,Adam Chadaj
1988,100905,2223.543825,33,17,0,16,3,Sammy Giammalva Jr
2008,104534,2223.509107,38,16,0,22,6,Dudi Sela
2010,105471,2223.496854,6,4,0,2,11,Cesar Ramirez
1998,102466,2223.459262,20,9,0,11,2,Jan Kroslak
1989,101334,2223.430959,38,20,0,18,4,Alexander Volkov
2006,105041,2223.383365,2,2,0,0,8,Lukas Lacko
1985,100623,2223.312225,6,4,0,2,19,Roger Knapp
2003,102338,2223.297353,55,29,0,26,3,Yevgeny Kafelnikov
2003,103226,2223.261549,4,3,0,1,17,Walid Jallali
2014,106233,2223.213836,46,22,0,24,2,Dominic Thiem
1988,108823,2223.212944,6,4,0,2,23,Tintus Arianto Wibowo
2004,102107,2223.162894,6,4,0,2,3,Jan Frode Andersen
1994,101733,2223.161307,37,18,0,19,6,Jan Siemerink
2010,104655,2223.149933,43,21,0,22,4,Pablo Cuevas
2004,102286,2223.125585,4,3,0,1,31,Wayne Black
1992,100997,2223.093795,8,5,0,3,9,Roger Smith
1994,100800,2223.004362,8,5,0,3,4,Diego Perez
1996,101969,2223.003125,3,2,0,1,6,Orlin Stanoytchev
1989,101948,2222.994369,37,18,0,19,5,Pete Sampras
2002,102556,2222.986692,6,4,0,2,8,Claude Ngoran
1993,101727,2222.95223,48,25,0,23,1,Jason Stoltenberg
1991,100991,2222.944438,6,4,0,2,20,Johnny Goudenbour
1998,101902,2222.899512,7,4,0,3,5,Stephane Huet
1996,102104,2222.883144,52,26,0,26,3,Christian Ruud
2012,104252,2222.847489,50,23,0,27,3,Florian Mayer
2011,103997,2222.834076,34,17,0,17,4,Lukasz Kubot
1986,100548,2222.830818,5,3,0,2,2,Ivan Kley
2013,104273,2222.788043,49,23,0,26,3,Edouard Roger Vasselin
2009,105095,2222.787708,35,18,0,17,3,Evgeny Korolev
1997,102419,2222.738573,11,6,0,5,5,Christophe Van Garsse
1993,102263,2222.703253,4,3,0,1,30,Yong Il Yoon
2006,104259,2222.697711,45,24,0,21,3,Philipp Kohlschreiber
1989,101932,2222.668596,5,3,0,2,16,Jared Palmer
1995,102233,2222.666866,18,9,0,9,6,Leander Paes
2009,104978,2222.628361,12,7,0,5,4,Daniel Brands
2009,104292,2222.627958,8,5,0,3,11,Izak Van Der Merwe
1999,103454,2222.608267,6,4,0,2,9,Nicolas Massu
1986,100383,2222.560615,4,3,0,1,8,Peter Mcnamara
2001,102035,2222.54863,49,23,0,26,3,Jonas Bjorkman
1985,100326,2222.54706,25,14,0,11,1,Russell Simpson
1990,101285,2222.411433,31,15,0,16,1,Thierry Champion
1999,102770,2222.378268,43,21,0,22,3,John Van Lottum
2004,103808,2222.35574,20,11,0,9,3,Potito Starace
2015,105539,2222.277957,12,6,0,6,6,Evgeny Donskoy
1997,102104,2222.259461,54,29,0,25,2,Christian Ruud
2003,102863,2222.244365,10,6,0,4,6,Takao Suzuki
2009,103997,2222.09485,18,9,0,9,2,Lukasz Kubot
2003,103337,2222.070136,4,3,0,1,7,Ben Qiang Zhu
2004,104339,2222.027947,51,27,0,24,2,Mario Ancic
1985,101014,2222.013904,5,3,0,2,21,John Ross
1991,106580,2221.978377,6,4,0,2,20,Arjun Fernando
2012,103534,2221.977824,3,2,0,1,26,Nicolas Devilder
1989,108867,2221.937895,6,4,0,2,28,Serge Brueck
1998,102446,2221.934423,48,24,0,24,2,Andrei Medvedev
2007,103632,2221.913633,32,16,0,16,9,Luis Horna
2007,104308,2221.872188,7,4,0,3,9,Michal Przysiezny
2013,103813,2221.861823,59,32,0,27,3,Jarkko Nieminen
1995,101439,2221.715702,65,33,0,32,3,Javier Sanchez
1991,100936,2221.713851,23,11,0,12,1,Henri Leconte
1987,100764,2221.664591,5,3,0,2,24,Gabriel Urpi
2008,105217,2221.640172,6,4,0,2,8,Thiemo De Bakker
1986,101022,2221.543178,10,5,0,5,5,Kelly Jones
2000,103786,2221.515638,4,3,0,1,21,Nikolay Davydenko
1993,102223,2221.502185,6,4,0,2,21,Karim Alami
1987,100921,2221.255966,5,3,0,2,19,Patrice Kuchna
1992,101890,2221.251447,38,19,0,19,7,Jonathan Stark
1995,101285,2221.246512,7,4,0,3,25,Thierry Champion
1986,100652,2221.236007,22,11,0,11,2,Cassio Motta
1991,101746,2221.176939,48,22,0,26,8,Renzo Furlan
1998,102271,2221.095988,53,25,0,28,3,Hicham Arazi
1989,100800,2221.066529,37,19,0,18,2,Diego Perez
2009,104330,2221.002649,14,8,0,6,4,Rajeev Ram
2003,101990,2221.002639,21,11,0,10,21,Richard Krajicek
2005,102967,2221.002125,5,3,0,2,3,Marc Gicquel
2010,104312,2220.991012,52,24,0,28,4,Andreas Seppi
1987,100923,2220.983941,58,35,0,23,6,Wally Masur
1987,101166,2220.966326,5,3,0,2,3,Gustavo Garetto
1992,101332,2220.937522,32,16,0,16,3,Gilad Bloom
2014,105657,2220.915741,13,7,0,6,4,Marius Copil
1986,100368,2220.901997,6,4,0,2,32,Haroon Ismail
1989,101337,2220.901634,33,17,0,16,4,Martin Strelba
1993,101145,2220.87328,3,2,0,1,9,Jonathan Canter
1992,101596,2220.849003,6,4,0,2,10,Mohamed Ridaoui
1993,100954,2220.777637,42,19,0,23,4,Luiz Mattar
1993,102031,2220.770252,5,3,0,2,6,Sandor Noszaly
2007,103812,2220.756807,17,8,0,9,9,Victor Hanescu
1987,100321,2220.755992,16,8,0,8,0,Vijay Amritraj
2001,104022,2220.715766,40,20,0,20,3,Mikhail Youzhny
1996,102463,2220.668024,5,3,0,2,3,Lucas Arnold Ker
2003,102202,2220.659907,41,19,0,22,3,Kenneth Carlsen
1998,103248,2220.641085,7,4,0,3,9,Harel Levy
1991,101156,2220.629153,4,3,0,1,10,Juan Pino
1991,101165,2220.629153,4,3,0,1,10,Mario Tabares
1985,101387,2220.613813,7,4,0,3,15,Claudio Pistolesi
1999,103819,2220.606118,30,13,0,17,5,Roger Federer
2012,103401,2220.567143,3,2,0,1,20,Jan Hernych
1997,101735,2220.537726,44,19,0,25,5,Richard Fromberg
1994,101495,2220.496243,8,5,0,3,11,Miguel Tobon
1988,101948,2220.456911,20,10,0,10,3,Pete Sampras
2007,104076,2220.456188,38,19,0,19,3,Jose Acasuso
1989,101861,2220.42899,5,3,0,2,9,Thomas Buchmayer
2012,104804,2220.42107,4,3,0,1,11,Amir Weintraub
2015,104999,2220.406697,15,7,0,8,5,Mischa Zverev
2014,104229,2220.351195,47,24,0,23,2,Yen Hsun Lu
1988,101337,2220.294395,5,3,0,2,9,Martin Strelba
1994,101735,2220.287635,53,25,0,28,3,Richard Fromberg
2005,103096,2220.243477,39,18,0,21,2,Arnaud Clement
2002,102780,2220.189088,3,2,0,1,14,Frederic Niemeyer
2007,102179,2220.175173,6,4,0,2,21,Antony Dupuis
2014,104297,2220.113093,5,3,0,2,9,Rogerio Dutra Silva
1986,100923,2220.112329,33,17,0,16,3,Wally Masur
1992,101481,2220.067584,53,30,0,23,4,Omar Camporese
1993,102030,2220.048278,5,3,0,2,23,Andrew Foster
2011,103401,2220.035956,5,3,0,2,26,Jan Hernych
1993,101647,2220.014334,43,21,0,22,3,Byron Black
2008,104559,2219.998706,25,13,0,12,3,Teymuraz Gabashvili
1986,100663,2219.957206,28,14,0,14,6,Marcel Freeman
2010,104471,2219.939278,15,8,0,7,6,Ivan Dodig
2003,102100,2219.929237,3,2,0,1,14,Bartlomiej Dabrowski
1998,102477,2219.902174,3,2,0,1,10,Gaston Etlis
2013,105332,2219.883438,62,32,0,30,3,Benoit Paire
2003,103739,2219.880546,5,3,0,2,8,Jose De Armas
1997,102466,2219.878785,32,18,0,14,2,Jan Kroslak
2000,103598,2219.729242,14,7,0,7,14,Xavier Malisse
1991,101413,2219.705174,10,6,0,4,10,Felix Barrientos
2004,103598,2219.678328,49,23,0,26,2,Xavier Malisse
2000,101373,2219.59911,3,2,0,1,25,Karsten Braasch
1985,100797,2219.586034,35,17,0,18,5,Ben Testerman
1998,103720,2219.499864,19,10,0,9,6,Lleyton Hewitt
2011,105643,2219.464596,5,3,0,2,20,Federico Delbonis
2015,104978,2219.396814,3,2,0,1,5,Daniel Brands
2004,104792,2219.386039,5,3,0,2,2,Gael Monfils
1990,101377,2219.373058,36,17,0,19,0,Christian Bergstrom
1985,100970,2219.357671,14,7,0,7,6,Stefan Eriksson
1998,103018,2219.301446,6,4,0,2,9,Max Mirnyi
1992,101511,2219.29835,47,22,0,25,6,Horst Skoff
1987,101096,2219.259907,30,15,0,15,3,Gary Muller
2012,104997,2219.217264,18,8,0,10,3,Igor Sijsling
2014,104180,2219.200629,12,6,0,6,3,Gilles Muller
1989,101387,2219.193078,24,12,0,12,13,Claudio Pistolesi
1998,102410,2219.156283,3,2,0,1,17,David Caldwell
1988,101730,2219.154949,3,2,0,1,3,Piet Norval
1990,101123,2219.153834,22,11,0,11,1,Alexander Mronz
1998,102053,2219.066435,20,10,0,10,13,Brian Macphie
2001,102796,2219.062655,46,25,0,21,15,Magnus Norman
2002,103781,2219.031398,21,10,0,11,5,Jurgen Melzer
2005,104395,2218.999873,6,4,0,2,8,Marcel Felder
1989,101430,2218.993649,5,3,0,2,14,Sergio Cortes
2002,102107,2218.962745,5,3,0,2,8,Jan Frode Andersen
2010,103598,2218.927639,45,22,0,23,2,Xavier Malisse
1996,102524,2218.885259,13,7,0,6,7,Neville Godwin
2004,103204,2218.864033,7,4,0,3,10,Hugo Armando
1987,100570,2218.863147,33,16,0,17,7,Marty Davis
1999,103451,2218.859303,5,3,0,2,13,Bjorn Phau
1993,101377,2218.851018,46,23,0,23,3,Christian Bergstrom
2002,102259,2218.8243,27,14,0,13,6,Jerome Golmard
2005,104417,2218.809609,34,16,0,18,6,Robin Soderling
2002,103888,2218.808585,22,11,0,11,6,Mardy Fish
2007,104154,2218.78723,23,12,0,11,7,Paul Capdeville
2005,103857,2218.733824,5,3,0,2,3,Igor Kunitsyn
1989,101021,2218.732712,3,2,0,1,3,Dean Botha
1996,101938,2218.727262,7,4,0,3,11,Bernardo Mota
1989,101482,2218.669984,7,4,0,3,7,Markus Zoecke
1997,101185,2218.646911,54,26,0,28,3,Mark Woodforde
1991,101344,2218.629099,5,3,0,2,30,Bruno Oresar
1999,103103,2218.562633,71,39,0,32,2,Dominik Hrbaty
1996,102154,2218.53527,41,19,0,22,3,Marcos Ondruska
2008,105062,2218.533342,7,4,0,3,3,Mikhail Kukushkin
1999,102184,2218.487474,45,22,0,23,2,David Prinosil
1986,101035,2218.47494,12,7,0,5,9,Menno Oosting
2005,102456,2218.385534,29,14,0,15,10,Felix Mantilla
1998,102473,2218.360307,5,3,0,2,8,Thomas Schiessling
2012,105550,2218.354177,6,4,0,2,0,Guido Pella
2008,104250,2218.334729,10,6,0,4,8,Prakash Amritraj
2003,104214,2218.308725,8,4,0,4,3,Igor Andreev
1992,101917,2218.306003,8,4,0,4,22,Grant Stafford
1998,102950,2218.300402,40,20,0,20,2,Fernando Vicente
1987,101185,2218.286891,25,12,0,13,3,Mark Woodforde
1997,102301,2218.28343,3,2,0,1,16,Sebastien Leblanc
1999,102753,2218.26004,3,2,0,1,16,Wolfgang Schranz
2004,102783,2218.243498,56,27,0,29,2,Rainer Schuettler
1993,101871,2218.230205,3,2,0,1,35,Alexander Reichel
1985,101226,2218.193381,7,4,0,3,9,Johan Carlsson
2006,104234,2218.176194,5,3,0,2,8,Predrag Rusevski
2004,103527,2218.165546,5,3,0,2,17,Julien Jeanpierre
1998,103166,2218.112732,9,5,0,4,9,Vladimir Voltchkov
1994,102234,2218.103437,23,12,0,11,3,Oliver Gross
2015,104655,2218.082043,55,29,0,26,3,Pablo Cuevas
2010,103990,2218.062335,43,20,0,23,6,Tommy Robredo
2004,102300,2218.03812,8,4,0,4,6,Gouichi Motomura
1988,101772,2217.985045,5,3,0,2,14,Andrei Cherkasov
1994,101348,2217.936333,3,2,0,1,42,Dave Randall
1996,101788,2217.925808,5,3,0,2,12,Doug Flach
1995,102796,2217.868378,5,3,0,2,9,Magnus Norman
1991,101889,2217.846587,48,23,0,25,0,Todd Woodbridge
2010,104071,2217.841203,6,4,0,2,23,Raven Klaasen
1987,100844,2217.831907,7,4,0,3,10,Jerome Potier
1991,101835,2217.816561,5,3,0,2,24,Arne Thoms
2004,103573,2217.811726,5,3,0,2,5,Rik De Voest
2008,104022,2217.811422,50,28,0,22,2,Mikhail Youzhny
1990,100788,2217.763358,3,2,0,1,27,Joseph Russell
1986,100690,2217.750718,3,2,0,1,19,Marco Armellini
2001,102107,2217.717761,7,4,0,3,18,Jan Frode Andersen
2006,103538,2217.709108,3,2,0,1,7,James Auckland
2008,103451,2217.664011,7,3,0,4,6,Bjorn Phau
2011,104076,2217.655881,3,2,0,1,40,Jose Acasuso
1996,103118,2217.651421,3,2,0,1,11,Ion Moldovan
2003,104433,2217.637125,3,2,0,1,8,Frank Dancevic
1987,100524,2217.623688,3,2,0,1,33,Shozo Shiraishi
2006,103292,2217.609435,47,26,0,21,3,Gaston Gaudio
1988,100903,2217.583448,3,2,0,1,26,Mike Lee
2007,104898,2217.570623,25,13,0,12,6,Robin Haase
1993,101789,2217.552171,16,7,0,9,6,Steve Bryan
2001,103821,2217.549269,7,4,0,3,7,Danai Udomchoke
1991,100628,2217.545733,11,6,0,5,7,Michiel Schapers
1989,101234,2217.542259,29,15,0,14,22,Patrik Kuhnen
1990,100815,2217.515653,31,16,0,15,4,David Pate
2008,104327,2217.51526,44,21,0,23,3,Steve Darcis
1999,102548,2217.462099,44,21,0,23,7,Juan Antonio Marin
1986,101439,2217.461674,3,2,0,1,13,Javier Sanchez
1992,101649,2217.420353,42,24,0,18,4,Guillermo Perez Roldan
2003,104386,2217.380006,9,5,0,4,8,Janko Tipsarevic
2003,102701,2217.37829,25,14,0,11,17,Marcelo Rios
2000,102783,2217.3295,49,22,0,27,2,Rainer Schuettler
2015,104535,2217.307096,3,2,0,1,36,Daniel Garza
2009,102863,2217.259945,3,2,0,1,8,Takao Suzuki
1996,101864,2217.252906,6,3,0,3,4,Fernon Wibier
2001,102233,2217.208363,9,5,0,4,5,Leander Paes
1994,101016,2217.187038,3,2,0,1,11,Marcos Aurelio Gorriz
1990,101000,2217.185077,5,3,0,2,7,Carl Limberger
2007,104639,2217.162753,7,4,0,3,12,Wayne Odesnik
2002,103580,2217.157748,5,3,0,2,14,Alexander Peya
1996,102433,2217.109793,3,2,0,1,21,Mose Navarra
2012,103333,2217.089665,33,16,0,17,6,Ivo Karlovic
1988,101421,2217.087254,3,2,0,1,6,Veli Paloheimo
1989,101889,2217.016927,12,6,0,6,10,Todd Woodbridge
2009,104095,2216.936922,4,2,0,2,2,David Guez
2008,103472,2216.934819,3,2,0,1,17,Karim Maamoun
1997,101543,2216.918872,60,31,0,29,2,Jeff Tarango
2013,104291,2216.909422,3,2,0,1,34,Malek Jaziri
2006,104214,2216.881687,27,14,0,13,2,Igor Andreev
1999,103151,2216.877163,59,28,0,31,3,Mariano Zabaleta
1993,101829,2216.858163,10,5,0,5,9,Federico Sanchez
2009,105099,2216.856716,3,2,0,1,43,Antonio Veic
1994,101507,2216.852633,55,28,0,27,3,Tomas Carbonell
1998,101468,2216.812262,5,3,0,2,23,Gerard Solves
2014,105526,2216.728844,32,15,0,17,4,Jan Lennard Struff
1990,100923,2216.725338,46,24,0,22,1,Wally Masur
1996,102863,2216.700241,3,2,0,1,32,Takao Suzuki
2003,103084,2216.665185,9,5,0,4,7,Guillermo Canas
2001,102469,2216.603918,5,3,0,2,9,Solon Peppas
1987,101686,2216.59189,31,14,0,17,3,Franco Davin
1999,102563,2216.566018,47,22,0,25,2,Thomas Johansson
1991,101369,2216.549001,3,2,0,1,20,Bent Ove Pedersen
2002,102617,2216.526766,3,2,0,1,15,Kim Tiilikainen
1990,101036,2216.510618,17,9,0,8,17,Miloslav Mecir
1986,101236,2216.506742,5,3,0,2,22,Krassimir Lazarov
1986,100452,2216.505059,26,13,0,13,3,Bill Scanlon
1993,101270,2216.50094,3,2,0,1,7,Thomas Gollwitzer
2004,105259,2216.498979,1,1,0,0,8,Andrei Karatchenia
1992,101590,2216.466388,11,6,0,5,10,Eui Jong Chang
2006,103166,2216.464721,3,2,0,1,30,Vladimir Voltchkov
2005,104589,2216.446705,7,4,0,3,21,Chris Guccione
1988,101334,2216.439822,19,9,0,10,4,Alexander Volkov
2005,103722,2216.438306,20,10,0,10,2,Florent Serra
1994,102250,2216.429601,5,3,0,2,10,Emanuel Couto
2004,103920,2216.42168,3,2,0,1,8,Sanchai Ratiwatana
1994,101809,2216.414629,30,15,0,15,3,Nicolas Pereira
1994,101195,2216.306359,49,22,0,27,3,Amos Mansdorf
2000,102925,2216.301564,30,14,0,16,13,Justin Gimelstob
2001,103103,2216.283074,61,31,0,30,2,Dominik Hrbaty
1992,101507,2216.276794,40,21,0,19,6,Tomas Carbonell
1990,101265,2216.220605,25,13,0,12,1,Patrick Mcenroe
2001,102021,2216.204742,37,16,0,21,6,Michael Chang
2009,103843,2216.168436,23,10,0,13,2,Marco Chiudinelli
1994,101906,2216.165571,8,5,0,3,30,Yasufumi Yamamoto
2001,103252,2216.152844,58,32,0,26,2,Alberto Martin
1993,101605,2216.106412,5,3,0,2,30,Jiu Hua Zhang
1991,101764,2216.034033,5,3,0,2,10,Yu Hui Lien
1999,103224,2215.994236,1,1,0,0,28,Zeljko Tosic
2006,104308,2215.914146,7,4,0,3,14,Michal Przysiezny
1998,102437,2215.892295,21,11,0,10,7,Adrian Voinea
1994,100936,2215.88906,34,17,0,17,6,Henri Leconte
1997,103264,2215.867149,3,2,0,1,2,Mariano Puerta
1995,101479,2215.816651,3,2,0,1,37,TJ Middleton
1994,102226,2215.812835,11,6,0,5,12,David Witt
2000,101885,2215.8126,33,14,0,19,2,Wayne Arthurs
1993,101926,2215.760226,5,3,0,2,3,Andrei Merinov
1986,100300,2215.753669,3,2,0,1,45,Jose Higueras
1990,101862,2215.730118,3,2,0,1,1,Maurice Ruah
1996,102950,2215.697791,6,3,0,3,8,Fernando Vicente
1985,101185,2215.684523,10,6,0,4,1,Mark Woodforde
2003,102369,2215.67583,15,8,0,7,10,Julien Boutter
1999,103709,2215.658565,7,4,0,3,13,Kristian Pless
1988,110975,2215.615046,1,1,0,0,23,Andy Brothers
1989,101105,2215.60149,3,2,0,1,22,Jose Antonio Fernandez
2007,102558,2215.594189,3,2,0,1,9,Eric Taino
1997,101495,2215.580338,7,4,0,3,3,Miguel Tobon
1987,101149,2215.569627,5,3,0,2,10,Morten Christensen
2010,104714,2215.543072,10,5,0,5,5,Julian Reister
1992,108532,2215.541763,1,1,0,0,29,Worapol Thongkamcho
1989,101106,2215.53378,26,12,0,14,5,Peter Lundgren
2009,104600,2215.533369,3,2,0,1,11,Treat Conrad Huey
2008,104076,2215.533173,53,27,0,26,0,Jose Acasuso
2003,103185,2215.527469,3,2,0,1,14,Mike Bryan
2008,104501,2215.523318,3,2,0,1,12,Xin Yuan Yu
1985,101264,2215.513975,3,2,0,1,12,Michael Tauson
2011,104297,2215.50351,5,3,0,2,13,Rogerio Dutra Silva
1986,100905,2215.498565,32,14,0,18,3,Sammy Giammalva Jr
1996,101997,2215.496186,5,3,0,2,8,Marzio Martelli
2005,104019,2215.495853,17,8,0,9,2,Kristof Vliegen
2001,102087,2215.491436,7,4,0,3,9,Oleg Ogorodov
2008,104523,2215.486883,9,5,0,4,10,Frederico Gil
1988,100517,2215.468827,3,2,0,1,23,Matt Doyle
1992,102286,2215.466274,3,2,0,1,10,Wayne Black
1988,101285,2215.453671,25,11,0,14,7,Thierry Champion
1992,101957,2215.445292,3,2,0,1,8,Milen Velev
2005,102811,2215.384256,5,3,0,2,15,Dusan Vemic
1985,101344,2215.372607,11,6,0,5,14,Bruno Oresar
1994,101133,2215.360275,5,3,0,2,16,Patrick Baur
2012,103188,2215.335213,22,11,0,11,12,Michael Russell
2003,102087,2215.317499,3,2,0,1,31,Oleg Ogorodov
2005,103986,2215.314866,3,2,0,1,8,Radoslav Lukaev
2013,103900,2215.310157,11,6,0,5,35,David Nalbandian
1998,102957,2215.308196,5,3,0,2,9,Vadim Kutsenko
2004,102644,2215.298311,19,10,0,9,10,Franco Squillari
1997,102093,2215.286138,52,24,0,28,2,Martin Damm
1985,100831,2215.282662,3,2,0,1,10,Rick Rudeen
1985,101119,2215.255965,29,15,0,14,6,Marian Vajda
1998,102233,2215.253129,25,13,0,12,2,Leander Paes
2013,104505,2215.227169,3,2,0,1,4,Konstantin Kravchuk
1991,102093,2215.216516,3,2,0,1,12,Martin Damm
1993,101792,2215.203047,31,16,0,15,3,Slava Dosedel
2004,104542,2215.202947,4,2,0,2,2,Jo Wilfried Tsonga
1991,100676,2215.199703,14,7,0,7,4,Yannick Noah
1986,100810,2215.195114,5,3,0,2,8,Paul Chamberlin
1997,102227,2215.176182,41,18,0,23,2,Sargis Sargsian
2002,102477,2215.131938,6,3,0,3,9,Gaston Etlis
1989,101534,2215.122988,7,4,0,3,20,Libor Nemecek
1990,101797,2215.10968,5,3,0,2,3,Jacco Eltingh
2003,104229,2215.091488,5,3,0,2,8,Yen Hsun Lu
1991,101462,2215.079102,20,9,0,11,3,Francisco Roig
1995,102536,2215.066823,3,2,0,1,35,James Greenhalgh
2006,108647,2215.066584,1,1,0,0,8,Anton Tsymbalov
1999,101723,2215.059081,34,16,0,18,2,Magnus Larsson
1993,101061,2215.034502,9,5,0,4,16,Jimmy Arias
1991,106936,2215.030855,3,2,0,1,18,Emile Ngoran
2006,104027,2215.030676,3,2,0,1,8,Pablo Gonzalez
2015,105954,2215.011847,3,2,0,1,11,Peter Nagy
1990,101439,2215.002188,45,22,0,23,1,Javier Sanchez
1998,101717,2214.999878,12,6,0,6,0,Diego Nargiso
2000,102395,2214.998652,7,4,0,3,9,Ville Liukko
2015,103499,2214.990222,5,3,0,2,11,Aqeel Khan
1993,101956,2214.989531,11,6,0,5,3,Mark Knowles
1995,102287,2214.987511,7,4,0,3,8,Albert Portas
2004,103913,2214.97836,3,2,0,1,23,Ian Flanagan
2004,104008,2214.975982,3,2,0,1,18,Carlos Avellan
1995,103166,2214.961975,5,3,0,2,3,Vladimir Voltchkov
1987,100942,2214.954153,53,29,0,24,6,Thierry Tulasne
2005,102834,2214.942406,25,13,0,12,3,Paul Goldstein
1994,101826,2214.899474,3,2,0,1,15,Alex Lopez Moron
1997,102202,2214.887345,54,26,0,28,2,Kenneth Carlsen
2012,104965,2214.859574,5,3,0,2,19,Pavol Cervenak
1996,102247,2214.854787,59,30,0,29,6,Andrea Gaudenzi
2008,104217,2214.846855,8,4,0,4,6,Simon Stadler
1989,101233,2214.830511,22,11,0,11,5,Alex Antonitsch
2002,103007,2214.824956,3,2,0,1,8,Mounir El Aarej
1991,101668,2214.749145,3,2,0,1,7,Peter Nyborg
1993,102563,2214.715877,3,2,0,1,7,Thomas Johansson
1991,101016,2214.649076,7,4,0,3,3,Marcos Aurelio Gorriz
2008,103444,2214.632278,7,4,0,3,8,Jean Rene Lisnard
1991,102119,2214.623503,3,2,0,1,10,Chih Jung Chen
1996,101475,2214.593597,52,27,0,25,8,Carlos Costa
1994,102706,2214.587437,1,1,0,0,30,Wei Yu Su
2004,103824,2214.548588,3,2,0,1,18,Orest Tereshchuk
2004,103905,2214.548588,3,2,0,1,31,Ricardo Chile Fonte
2006,104210,2214.548588,3,2,0,1,30,Ryan Russell
2006,104702,2214.548588,3,2,0,1,30,Michael Leong
2007,104299,2214.548588,3,2,0,1,35,Hiu Tung Yu
2011,108764,2214.548588,3,2,0,1,21,Chris Brandi
2013,103600,2214.548588,3,2,0,1,34,Mohammad Ghareeb
2015,104631,2214.548588,3,2,0,1,19,Harshana Godamanna
2000,101235,2214.548582,1,1,0,0,22,Paul Haarhuis
1987,100648,2214.547008,1,1,0,0,41,Sadiq Abdullahi
1988,109940,2214.547008,1,1,0,0,47,Ernesto Lingen
1995,102272,2214.547008,1,1,0,0,20,Branislav Galik
2000,108606,2214.547008,1,1,0,0,20,Gert Vilms
2001,104229,2214.547008,3,2,0,1,33,Yen Hsun Lu
2005,104561,2214.547008,1,1,0,0,17,Jae Sung An
2008,101979,2214.547008,1,1,0,0,31,Ricardo Mena
2009,104496,2214.547008,1,1,0,0,21,Luis Manuel Flores
2009,105386,2214.547008,1,1,0,0,21,Janez Semrajc
2013,104910,2214.547008,1,1,0,0,34,Tihomir Grozdanov
2005,104086,2214.535402,3,2,0,1,8,Mikhail Filima
2004,104136,2214.526757,1,1,0,0,8,Santiago Gonzalez
1986,100853,2214.519137,3,2,0,1,9,Dong Wook Song
2009,102887,2214.493723,3,2,0,1,38,Ramon Delgado
2001,104386,2214.480138,3,2,0,1,18,Janko Tipsarevic
1995,100991,2214.472458,5,3,0,2,10,Johnny Goudenbour
2012,106150,2214.468382,3,2,0,1,11,Jeson Patrombon
2012,108717,2214.464235,3,2,0,1,11,Francis Casey Alcantara
1993,101249,2214.445933,57,27,0,30,3,Andrei Olhovskiy
1988,101506,2214.432217,1,1,0,0,23,Eoin Collins
2009,105590,2214.420054,3,2,0,1,21,Uladzimir Ignatik
2000,104117,2214.412573,3,2,0,1,22,Giovanni Lapentti
1992,101647,2214.383537,34,16,0,18,6,Byron Black
2009,104167,2214.370626,5,3,0,2,37,Todd Widom
2011,104292,2214.364368,5,3,0,2,12,Izak Van Der Merwe
1990,101185,2214.339411,24,12,0,12,1,Mark Woodforde
1993,102093,2214.332751,38,16,0,22,3,Martin Damm
1987,101434,2214.244977,3,2,0,1,19,Petr Korda
1992,102235,2214.217478,8,4,0,4,12,Tommy Ho
2002,103739,2214.198415,5,3,0,2,8,Jose De Armas
2010,104523,2214.178425,25,12,0,13,5,Frederico Gil
1991,101448,2214.177835,5,3,0,2,8,Tasos Bavelas
2008,102959,2214.167709,3,2,0,1,17,Marko Tkalec
2000,102025,2214.153369,40,20,0,20,7,Mikael Tillstrom
2009,103682,2214.119441,3,2,0,1,21,Kyu Tae Im
2013,104594,2214.113541,44,19,0,25,8,Marinko Matosevic
1994,101506,2214.102563,3,2,0,1,19,Eoin Collins
2012,103598,2214.100782,45,21,0,24,5,Xavier Malisse
1995,101833,2214.07813,39,18,0,21,3,Michael Tebbutt
2010,103252,2214.072973,9,5,0,4,31,Alberto Martin
2010,104112,2214.059283,5,3,0,2,22,Benjamin Balleret
2003,102811,2214.052436,3,2,0,1,18,Dusan Vemic
1999,102104,2214.052035,41,22,0,19,10,Christian Ruud
2002,103225,2214.045282,3,2,0,1,14,Simon Larose
1994,102537,2214.044634,1,1,0,0,36,Melvin Tong
2008,105011,2214.043844,1,1,0,0,8,Illya Marchenko
1998,103110,2214.035621,3,2,0,1,20,Daniele Bracciali
1999,102689,2214.028866,3,2,0,1,22,Martin Spottl
1988,106576,2214.024294,3,2,0,1,34,Arafat Chekrouni
1989,110823,2214.024294,1,1,0,0,28,Usman Rahim
1993,102444,2214.024294,1,1,0,0,21,Scott Barron
1998,103050,2214.024294,1,1,0,0,18,Shahab Hassani Nafez
1998,103167,2214.024294,1,1,0,0,34,Jocelyn Robichaud
2002,198661,2214.024294,1,1,0,0,17,Luis Felipe Noriega
2003,102969,2214.024294,1,1,0,0,17,Sergei Yaroshenko
2003,103407,2214.024294,1,1,0,0,31,Matt Klinger
2003,104251,2214.024294,1,1,0,0,8,Ti Chen
2004,104753,2214.024294,1,1,0,0,31,Woong Sun Jun
2007,103682,2214.024294,1,1,0,0,35,Kyu Tae Im
2007,104702,2214.024294,3,2,0,1,35,Michael Leong
2009,108909,2214.024294,3,2,0,1,21,Jalil Khan
2011,103682,2214.024294,1,1,0,0,21,Kyu Tae Im
2012,103746,2214.024294,1,1,0,0,35,Miguel Gallardo Valles
2013,105334,2214.024294,1,1,0,0,34,Luis David Martinez
2014,123983,2214.024294,1,1,0,0,9,Nerman Fatic
2002,103877,2214.022715,5,3,0,2,8,Mike Scheidweiler
2002,107098,2214.022715,3,2,0,1,8,Gilles Kremer
2010,104738,2214.019781,3,2,0,1,34,Caio Zampieri
2006,104196,2214.008236,5,3,0,2,27,Carlos Cuadrado
1999,103007,2214.003922,3,2,0,1,9,Mounir El Aarej
2009,108594,2214.003284,1,1,0,0,11,Johnny Arcilla
2010,104731,2214.002155,32,14,0,18,7,Kevin Anderson
1993,108595,2213.983579,3,2,0,1,36,Mohammed Reza Tavakoli
2006,104495,2213.974145,1,1,0,0,8,Florin Mergea
2010,105079,2213.964874,3,2,0,1,40,Ivan Sergeyev
2000,103066,2213.96321,5,3,0,2,37,Mark Nielsen
2014,104804,2213.93007,1,1,0,0,32,Amir Weintraub
1999,103457,2213.918994,1,1,0,0,9,Petr Kralert
2002,104421,2213.894964,3,2,0,1,17,Martin Vilarrubi
1992,101651,2213.888069,5,3,0,2,17,Owen Casey
2003,103821,2213.860321,7,4,0,3,7,Danai Udomchoke
1987,100727,2213.846396,3,2,0,1,25,Raul Antonio Viver
1995,102669,2213.82459,3,2,0,1,7,Noam Behr
1985,100280,2213.804367,30,13,0,17,9,Wojtek Fibak
2008,103169,2213.800108,40,19,0,21,3,Oscar Hernandez
2006,103157,2213.792276,5,3,0,2,30,Arvind Parmar
1993,101324,2213.771066,3,2,0,1,32,Ulf Stenlund
2002,103242,2213.756737,3,2,0,1,9,Juan Giner
2007,102860,2213.751423,49,24,0,25,3,Agustin Calleri
1997,102703,2213.749362,5,3,0,2,10,Hyung Taik Lee
1997,102226,2213.748789,3,2,0,1,27,David Witt
2011,105149,2213.719908,5,3,0,2,21,Reda El Amrani
1988,100954,2213.708476,39,19,0,20,2,Luiz Mattar
1998,102656,2213.706896,1,1,0,0,34,Tommi Lenho
1997,102287,2213.689483,39,22,0,17,2,Albert Portas
2014,104312,2213.687395,55,25,0,30,3,Andreas Seppi
1989,100532,2213.669145,22,12,0,10,16,Johan Kriek
2010,104314,2213.666162,9,5,0,4,13,Brian Dabul
2014,111202,2213.656431,3,2,0,1,9,Hyeon Chung
2014,102967,2213.65641,3,2,0,1,39,Marc Gicquel
2001,101970,2213.65605,3,2,0,1,9,Iztok Bozic
1990,101434,2213.644699,49,23,0,26,1,Petr Korda
2013,105497,2213.637987,3,2,0,1,11,Jose Hernandez
2010,105408,2213.624586,1,1,0,0,22,Soren Wedege
2002,102763,2213.575924,1,1,0,0,14,Benjamin Cassaigne
2002,103252,2213.57115,48,23,0,25,3,Alberto Martin
1986,100972,2213.548296,28,13,0,15,6,Todd Witsken
2000,102808,2213.544853,3,2,0,1,8,Kalle Flygt
2009,103427,2213.521951,3,2,0,1,21,Yew Ming Si
2010,104934,2213.520372,1,1,0,0,22,Thomas Kromann
2013,105239,2213.516626,1,1,0,0,34,Daniel Glancy
1998,102607,2213.515122,3,2,0,1,3,Juan Balcells
2007,103600,2213.504291,5,3,0,2,9,Mohammad Ghareeb
2001,101976,2213.50005,3,2,0,1,18,Federico Dondo
1985,100221,2213.5,1,1,0,0,43,Carlos Kirmayr
1985,100955,2213.5,1,1,0,0,31,Yahiya Doumbia
1985,107020,2213.5,1,1,0,0,26,Fotis Vazeos
1985,107833,2213.5,1,1,0,0,43,Mushaf Zia
1985,108055,2213.5,1,1,0,0,43,Raymond Suarez
1986,101064,2213.5,3,2,0,1,50,David Lewis
1986,107020,2213.5,1,1,0,0,32,Fotis Vazeos
1986,107778,2213.5,1,1,0,0,32,Michael Nugent
1986,107824,2213.5,1,1,0,0,44,Mohamed Dlimi
1986,107918,2213.5,1,1,0,0,44,Panomkorn Pladchunil
1986,108189,2213.5,1,1,0,0,26,Ruslon Rainov
1986,110859,2213.5,1,1,0,0,32,Milen Yanakiev
1986,110880,2213.5,1,1,0,0,32,Wei You
1986,110963,2213.5,1,1,0,0,32,Ioannis Kabakoglou
1986,110967,2213.5,1,1,0,0,32,Ioannis Rigas
1987,100401,2213.5,1,1,0,0,34,Sean Sorensen
1987,110990,2213.5,1,1,0,0,46,Rodrigo Rafael
1988,100919,2213.5,1,1,0,0,39,Khalid Outaleb
1988,101268,2213.5,3,2,0,1,29,Audun Jensen
1988,107804,2213.5,1,1,0,0,34,Mihai Vanta
1988,110840,2213.5,1,1,0,0,47,Tomas Rodriguez Sanchez
1989,101596,2213.5,1,1,0,0,28,Mohamed Ridaoui
1989,107516,2213.5,1,1,0,0,53,Kimmo Hurme
1989,111020,2213.5,1,1,0,0,53,Khaled Ashkanani
1990,100548,2213.5,3,2,0,1,34,Ivan Kley
1991,100754,2213.5,1,1,0,0,50,Rafael Avalos Brenes
1991,101938,2213.5,1,1,0,0,50,Bernardo Mota
1991,101973,2213.5,1,1,0,0,34,Viktor Nagy
1991,102331,2213.5,1,1,0,0,25,Ilou Lonfo
1991,102362,2213.5,1,1,0,0,25,Amro Ghoneim
1991,106870,2213.5,1,1,0,0,42,Dermot Sweeney
1991,107586,2213.5,1,1,0,0,25,Lui Pang
1991,110876,2213.5,1,1,0,0,50,Norbert Oduor
1992,100890,2213.5,3,2,0,1,35,Rashid Malik
1992,101122,2213.5,1,1,0,0,29,Alberto Paris
1992,101545,2213.5,1,1,0,0,44,Tomasz Iwanski
1992,106576,2213.5,1,1,0,0,19,Arafat Chekrouni
1992,111030,2213.5,1,1,0,0,35,Laith Azzouni
1993,101755,2213.5,1,1,0,0,30,Derek Farren
1993,102078,2213.5,1,1,0,0,44,Jorge Gonzalez
1993,102152,2213.5,3,2,0,1,36,Pablo Campana
1993,108161,2213.5,1,1,0,0,44,Roland So
1993,108469,2213.5,1,1,0,0,36,Victor Caldarelli
1993,109440,2213.5,1,1,0,0,44,Jin Yen Chiang
1993,110944,2213.5,1,1,0,0,21,Bassel Rahmy
1994,103060,2213.5,1,1,0,0,36,Alejandro Hernandez
1994,107689,2213.5,1,1,0,0,43,Mark Gurr
1994,108355,2213.5,1,1,0,0,30,Taras Beiko
1995,101651,2213.5,1,1,0,0,20,Owen Casey
1995,101938,2213.5,1,1,0,0,35,Bernardo Mota
1995,102138,2213.5,1,1,0,0,35,Alexander Tabares
1995,102655,2213.5,1,1,0,0,43,Jimy Szymanski
1995,103018,2213.5,1,1,0,0,20,Max Mirnyi
1996,100431,2213.5,3,2,0,1,34,Mansour Bahrami
1996,101367,2213.5,1,1,0,0,34,Igor Saric
1996,102140,2213.5,1,1,0,0,29,Bruno Fragoso
1996,102811,2213.5,1,1,0,0,19,Dusan Vemic
1996,103187,2213.5,1,1,0,0,28,Hisham Hemeda
1996,107586,2213.5,3,2,0,1,34,Lui Pang
1996,108595,2213.5,3,2,0,1,34,Mohammed Reza Tavakoli
1996,108826,2213.5,1,1,0,0,28,Isaac Tetteh Quaye
1997,100682,2213.5,1,1,0,0,33,Ernie Fernandez
1997,101156,2213.5,3,2,0,1,33,Juan Pino
1997,101386,2213.5,1,1,0,0,33,Glenn Wilson
1997,101444,2213.5,1,1,0,0,44,Bonit Wiryawan
1997,101630,2213.5,1,1,0,0,28,Clement Ngoran
1997,101638,2213.5,1,1,0,0,40,Sean Karam
1997,102190,2213.5,1,1,0,0,10,Philippe Moggio
1997,102331,2213.5,1,1,0,0,28,Ilou Lonfo
1997,102617,2213.5,3,2,0,1,19,Kim Tiilikainen
1997,102656,2213.5,1,1,0,0,19,Tommi Lenho
1997,103187,2213.5,1,1,0,0,19,Hisham Hemeda
1997,103287,2213.5,1,1,0,0,28,Krystian Pfeiffer
1997,103323,2213.5,1,1,0,0,28,Thomas Heyerdahl
1997,103568,2213.5,1,1,0,0,28,Valentin Sanon
1997,108588,2213.5,1,1,0,0,33,Asim Shafik
1997,108596,2213.5,3,2,0,1,33,Ramin Raziyani
1997,108846,2213.5,1,1,0,0,33,Syed Nasir Sherazi
1998,102085,2213.5,1,1,0,0,41,Sasa Hirszon
1998,102100,2213.5,3,2,0,1,18,Bartlomiej Dabrowski
1998,102320,2213.5,3,2,0,1,18,Lazaro Navarro Batles
1998,102543,2213.5,3,2,0,1,18,Chia Yen Tsai
1998,102598,2213.5,1,1,0,0,27,Nouhoun Sangare
1998,103155,2213.5,1,1,0,0,18,Ivo Bratanov
1998,103296,2213.5,1,1,0,0,18,Ivaylo Traykov
1998,103318,2213.5,1,1,0,0,41,Zeljko Krajan
1998,103525,2213.5,1,1,0,0,34,Ivan Miranda
1998,103739,2213.5,1,1,0,0,34,Jose De Armas
1998,104051,2213.5,1,1,0,0,18,Andrej Kracman
1998,108583,2213.5,1,1,0,0,18,Daniel Chavez Morales
1998,108822,2213.5,1,1,0,0,27,Andrej Krasevec
1999,100943,2213.5,1,1,0,0,18,Girts Dzelde
1999,101991,2213.5,3,2,0,1,34,Mauricio Hadad
1999,102100,2213.5,1,1,0,0,28,Bartlomiej Dabrowski
1999,102331,2213.5,1,1,0,0,18,Ilou Lonfo
1999,102787,2213.5,1,1,0,0,9,Si Bruce Li
1999,103155,2213.5,1,1,0,0,28,Ivo Bratanov
1999,103229,2213.5,1,1,0,0,28,Kornel Bardoczky
1999,103936,2213.5,1,1,0,0,28,Todor Enev
1999,108603,2213.5,1,1,0,0,28,Helge Koll Frafjord
1999,108794,2213.5,1,1,0,0,28,Arthur Konan
1999,108850,2213.5,1,1,0,0,42,Renouk Wijemanne
1999,108877,2213.5,1,1,0,0,28,Helge Rosjo
2000,101831,2213.5,1,1,0,0,20,Mustafa Azkara
2000,101862,2213.5,1,1,0,0,47,Maurice Ruah
2000,102997,2213.5,1,1,0,0,47,Hermes Gamonal
2000,103439,2213.5,1,1,0,0,37,Dimitri Mazur
2000,103690,2213.5,1,1,0,0,33,Marcin Matkowski
2000,103905,2213.5,1,1,0,0,37,Ricardo Chile Fonte
2000,104243,2213.5,1,1,0,0,37,Oscar Posada
2000,104395,2213.5,1,1,0,0,37,Marcel Felder
2001,102331,2213.5,1,1,0,0,18,Ilou Lonfo
2001,102668,2213.5,1,1,0,0,33,Tapio Nurminen
2001,102756,2213.5,1,1,0,0,40,Eduardo Rincon
2001,103050,2213.5,1,1,0,0,40,Shahab Hassani Nafez
2001,103198,2213.5,1,1,0,0,29,Justin Bower
2001,103529,2213.5,3,2,0,1,33,Aisam Ul Haq Qureshi
2001,103600,2213.5,3,2,0,1,33,Mohammad Ghareeb
2001,103659,2213.5,1,1,0,0,33,Wei Jen Cheng
2001,104268,2213.5,1,1,0,0,33,Alejandro Falla
2001,104339,2213.5,1,1,0,0,33,Mario Ancic
2001,108588,2213.5,1,1,0,0,33,Asim Shafik
2001,108612,2213.5,1,1,0,0,29,Sergei Cuptov
2001,108619,2213.5,1,1,0,0,40,Jad Ayoub
2001,108637,2213.5,1,1,0,0,33,Nomi Qamar
2002,102433,2213.5,1,1,0,0,31,Mose Navarra
2002,102725,2213.5,1,1,0,0,26,Kasper Warming
2002,102811,2213.5,1,1,0,0,26,Dusan Vemic
2002,102969,2213.5,1,1,0,0,17,Sergei Yaroshenko
2002,103205,2213.5,1,1,0,0,38,Emilio Daniel Baez Britez
2002,103499,2213.5,3,2,0,1,8,Aqeel Khan
2002,103612,2213.5,3,2,0,1,31,Alexey Kedryuk
2002,103645,2213.5,1,1,0,0,17,Balazs Veress
2002,104008,2213.5,1,1,0,0,17,Carlos Avellan
2002,104175,2213.5,1,1,0,0,26,Matija Zgaga
2002,104260,2213.5,1,1,0,0,17,Johny De Leon
2002,104268,2213.5,1,1,0,0,31,Alejandro Falla
2002,104348,2213.5,3,2,0,1,31,Dias Doskarayev
2002,108603,2213.5,1,1,0,0,26,Helge Koll Frafjord
2002,108637,2213.5,1,1,0,0,38,Nomi Qamar
2002,108640,2213.5,1,1,0,0,26,Mik Ledvonova
2002,108647,2213.5,1,1,0,0,38,Anton Tsymbalov
2002,108648,2213.5,1,1,0,0,38,Michael Mora
2002,108656,2213.5,1,1,0,0,31,Simon Shen
2002,108664,2213.5,1,1,0,0,17,Martin Stiegwardt
2003,102250,2213.5,1,1,0,0,31,Emanuel Couto
2003,102617,2213.5,1,1,0,0,17,Kim Tiilikainen
2003,102843,2213.5,1,1,0,0,31,Suwandi Suwandi
2003,103020,2213.5,1,1,0,0,39,Guillermo Carter
2003,103205,2213.5,1,1,0,0,39,Emilio Daniel Baez Britez
2003,103460,2213.5,1,1,0,0,39,Konstantin Don Gruber
2003,103594,2213.5,1,1,0,0,39,Oliver Marach
2003,103998,2213.5,1,1,0,0,39,Mario Monroy
2003,104051,2213.5,1,1,0,0,31,Andrej Kracman
2003,104136,2213.5,1,1,0,0,31,Santiago Gonzalez
2003,104592,2213.5,1,1,0,0,31,Ilija Bozoljac
2003,104658,2213.5,1,1,0,0,39,Gustavo Ramirez
2003,108600,2213.5,1,1,0,0,31,Sean Cooper
2003,108678,2213.5,1,1,0,0,39,Eddy Gonzalez Gonzalez
2003,108889,2213.5,1,1,0,0,31,Marc Vilanova
2003,108894,2213.5,1,1,0,0,17,Pau Gerbaud Farras
2003,108903,2213.5,1,1,0,0,8,Laurent Hild
2004,103065,2213.5,1,1,0,0,18,Kepler Orellana
2004,103682,2213.5,1,1,0,0,38,Kyu Tae Im
2004,103727,2213.5,1,1,0,0,38,Daniel Langre
2004,103899,2213.5,1,1,0,0,31,Stian Boretti
2004,104011,2213.5,1,1,0,0,38,Lefteris Alexiou
2004,104086,2213.5,1,1,0,0,31,Mikhail Filima
2004,104251,2213.5,3,2,0,1,31,Ti Chen
2004,104474,2213.5,1,1,0,0,8,Leonardo Kirche
2004,104478,2213.5,1,1,0,0,38,Hyun Woo Nam
2004,104738,2213.5,1,1,0,0,18,Caio Zampieri
2004,106886,2213.5,1,1,0,0,18,Dmitro Tolok
2004,108645,2213.5,1,1,0,0,38,Musaad Al Jazzaf
2004,108679,2213.5,1,1,0,0,38,Jose Bernard
2004,108916,2213.5,1,1,0,0,38,Ricardo Gonzalez Diaz
2004,108919,2213.5,1,1,0,0,31,Michael Ray Pallares Gonzalez
2005,101889,2213.5,1,1,0,0,34,Todd Woodbridge
2005,103053,2213.5,1,1,0,0,17,Nikos Rovas
2005,103600,2213.5,3,2,0,1,17,Mohammad Ghareeb
2005,103946,2213.5,1,1,0,0,34,Bruno Soares
2005,104136,2213.5,1,1,0,0,34,Santiago Gonzalez
2005,104260,2213.5,1,1,0,0,26,Johny De Leon
2005,104383,2213.5,1,1,0,0,34,Diogo Rocha
2005,104869,2213.5,3,2,0,1,8,Sergei Bubka
2005,104875,2213.5,1,1,0,0,34,Denes Lukacs
2005,108607,2213.5,1,1,0,0,34,Andrei Luzgin
2005,108942,2213.5,1,1,0,0,17,Henry Estrella
2006,102928,2213.5,1,1,0,0,36,Hee Seok Chung
2006,102959,2213.5,1,1,0,0,16,Marko Tkalec
2006,103153,2213.5,1,1,0,0,30,Gilles Elseneer
2006,104113,2213.5,1,1,0,0,36,Carlos Salamanca
2006,104479,2213.5,1,1,0,0,36,Sarvar Ikramov
2006,104882,2213.5,1,1,0,0,30,Blaz Kavcic
2006,108672,2213.5,1,1,0,0,16,William Lock
2006,108682,2213.5,1,1,0,0,16,Stephen Nugent
2006,108925,2213.5,1,1,0,0,30,Ahmad Rabeea Muhammad
2006,108953,2213.5,1,1,0,0,36,Juan Lorenzo Gonzalez
2006,108964,2213.5,1,1,0,0,36,Faisal Aidil
2007,103544,2213.5,1,1,0,0,41,Andy Ram
2007,103657,2213.5,1,1,0,0,35,Ivo Klec
2007,103789,2213.5,1,1,0,0,41,Irakli Labadze
2007,103921,2213.5,1,1,0,0,41,Sonchat Ratiwatana
2007,104040,2213.5,1,1,0,0,41,Adam Thompson
2007,104162,2213.5,1,1,0,0,35,Deniss Pavlovs
2007,104236,2213.5,1,1,0,0,35,Rouzbeh Kamran
2007,104421,2213.5,1,1,0,0,41,Martin Vilarrubi
2007,104454,2213.5,1,1,0,0,41,Murad Inoyatov
2007,104907,2213.5,3,2,0,1,35,Jose Rubin Statham
2007,104928,2213.5,1,1,0,0,41,Sun Yong Kim Jr
2007,104942,2213.5,1,1,0,0,41,Roman Recarte
2007,104965,2213.5,1,1,0,0,35,Pavol Cervenak
2007,105085,2213.5,1,1,0,0,19,Artem Smirnov
2007,105216,2213.5,3,2,0,1,35,Yuichi Sugita
2007,105497,2213.5,1,1,0,0,41,Jose Hernandez
2007,108593,2213.5,1,1,0,0,41,Wing Luen Wong
2007,108930,2213.5,1,1,0,0,41,Juan Carlos Ramirez
2008,103066,2213.5,1,1,0,0,31,Mark Nielsen
2008,103229,2213.5,3,2,0,1,17,Kornel Bardoczky
2008,104059,2213.5,1,1,0,0,31,Rasmus Norby
2008,104162,2213.5,1,1,0,0,38,Deniss Pavlovs
2008,104402,2213.5,1,1,0,0,17,Clement Morel
2008,104658,2213.5,1,1,0,0,8,Gustavo Ramirez
2008,104875,2213.5,1,1,0,0,17,Denes Lukacs
2008,105074,2213.5,1,1,0,0,38,Ruben Bemelmans
2008,105177,2213.5,1,1,0,0,31,Aditya Hari Sasongko
2008,105386,2213.5,1,1,0,0,17,Janez Semrajc
2008,108688,2213.5,1,1,0,0,38,Martin Sayer
2008,108942,2213.5,1,1,0,0,38,Henry Estrella
2009,103529,2213.5,1,1,0,0,38,Aisam Ul Haq Qureshi
2009,103612,2213.5,1,1,0,0,21,Alexey Kedryuk
2009,103864,2213.5,1,1,0,0,21,Mohamed Mamoun
2009,103865,2213.5,1,1,0,0,38,Prima Simpatiaji
2009,104008,2213.5,1,1,0,0,29,Carlos Avellan
2009,104040,2213.5,1,1,0,0,38,Adam Thompson
2009,104051,2213.5,1,1,0,0,38,Andrej Kracman
2009,104162,2213.5,1,1,0,0,38,Deniss Pavlovs
2009,104311,2213.5,1,1,0,0,21,Leonardo Tavares
2009,104609,2213.5,1,1,0,0,21,Omar Hedayet
2009,105079,2213.5,1,1,0,0,38,Ivan Sergeyev
2009,105122,2213.5,1,1,0,0,38,Karlis Lejnieks
2009,105456,2213.5,1,1,0,0,29,Sergio Galdos
2009,105488,2213.5,1,1,0,0,21,Jose Benitez
2009,105967,2213.5,1,1,0,0,21,Henri Laaksonen
2009,106664,2213.5,1,1,0,0,21,Brian Hung
2009,108688,2213.5,3,2,0,1,21,Martin Sayer
2009,108728,2213.5,1,1,0,0,21,Cheuk Wai Hui
2010,103286,2213.5,1,1,0,0,40,Yohny Romero
2010,104113,2213.5,1,1,0,0,40,Carlos Salamanca
2010,104305,2213.5,1,1,0,0,40,Luka Gregorc
2010,104489,2213.5,1,1,0,0,40,Barry King
2010,104585,2213.5,1,1,0,0,22,Gyorgy Balazs
2010,104909,2213.5,3,2,0,1,22,Sunu Wahyu Trijati
2010,105155,2213.5,1,1,0,0,40,Pedro Sousa
2010,105431,2213.5,1,1,0,0,40,Ariel Behar
2010,105442,2213.5,1,1,0,0,22,Sebastien Vidal
2010,105456,2213.5,1,1,0,0,40,Sergio Galdos
2010,105464,2213.5,3,2,0,1,22,Christopher Rungkat
2010,105625,2213.5,1,1,0,0,40,Alvaro Raposo De Oliveira
2010,105641,2213.5,1,1,0,0,22,Blaz Rola
2010,105912,2213.5,1,1,0,0,40,Diego Galeano
2010,108701,2213.5,1,1,0,0,40,Juan Sebastian Cabal
2010,108715,2213.5,1,1,0,0,40,Nicolas Salama
2010,108742,2213.5,1,1,0,0,40,Siu Fai Kelvin Lam
2011,103043,2213.5,1,1,0,0,21,Coenie Van Wyk
2011,103607,2213.5,3,2,0,1,21,Victor Estrella
2011,103875,2213.5,1,1,0,0,38,Anoosha Shahgholi
2011,103946,2213.5,1,1,0,0,21,Bruno Soares
2011,104146,2213.5,1,1,0,0,38,Jonathan Chu
2011,104901,2213.5,1,1,0,0,21,Vladimir Ivanov
2011,104945,2213.5,1,1,0,0,38,James Mcgee
2011,104996,2213.5,3,2,0,1,21,Alexander Blom
2011,105012,2213.5,1,1,0,0,38,Alexander Bury
2011,105036,2213.5,1,1,0,0,38,Hyun Joon Kim
2011,105428,2213.5,1,1,0,0,21,Marcus Daniell
2011,105456,2213.5,1,1,0,0,38,Sergio Galdos
2011,105681,2213.5,1,1,0,0,38,Soong Jae Cho
2011,105773,2213.5,1,1,0,0,21,Bruno Abdel Nour
2011,105830,2213.5,1,1,0,0,21,Hicham Khaddari
2011,105916,2213.5,1,1,0,0,38,Marton Fucsovics
2011,108701,2213.5,1,1,0,0,5,Juan Sebastian Cabal
2011,108980,2213.5,1,1,0,0,38,Luis Delgado
2012,104858,2213.5,1,1,0,0,42,Enrique Olivares
2012,105012,2213.5,1,1,0,0,11,Alexander Bury
2012,105145,2213.5,3,2,0,1,35,Jaak Poldma
2012,105386,2213.5,1,1,0,0,42,Janez Semrajc
2012,105488,2213.5,1,1,0,0,42,Jose Benitez
2012,105688,2213.5,1,1,0,0,42,Manuel Sanchez
2012,105747,2213.5,3,2,0,1,35,Karim Mohamed Maamoun
2012,105790,2213.5,1,1,0,0,42,Yong Kyu Lim
2012,105933,2213.5,1,1,0,0,11,Roberto Quiroz
2012,105946,2213.5,1,1,0,0,42,Liang Chi Huang
2012,106309,2213.5,1,1,0,0,35,Wisnu Adi Nugroho
2012,107552,2213.5,3,2,0,1,35,Laurent Bram
2012,108644,2213.5,1,1,0,0,35,Patrick Chucri
2012,108783,2213.5,1,1,0,0,35,Daniel Llarenas
2012,108784,2213.5,1,1,0,0,35,Kevin Kung
2013,103967,2213.5,1,1,0,0,11,Michael Lammer
2013,104479,2213.5,1,1,0,0,41,Sarvar Ikramov
2013,104523,2213.5,1,1,0,0,34,Frederico Gil
2013,105456,2213.5,1,1,0,0,41,Sergio Galdos
2013,105630,2213.5,1,1,0,0,41,Tomislav Ternar
2013,105707,2213.5,1,1,0,0,11,Nicolaas Scholtz
2013,106000,2213.5,3,2,0,1,34,Damir Dzumhur
2013,106034,2213.5,1,1,0,0,41,Yasutaka Uchiyama
2013,106220,2213.5,1,1,0,0,34,Dimitar Kuzmanov
2013,106227,2213.5,1,1,0,0,41,Ji Sung Nam
2013,106350,2213.5,1,1,0,0,41,Andre Gaspar Murta
2013,108701,2213.5,1,1,0,0,34,Juan Sebastian Cabal
2013,108717,2213.5,1,1,0,0,34,Francis Casey Alcantara
2013,111181,2213.5,1,1,0,0,41,Pruchya Isarow
2013,125781,2213.5,1,1,0,0,34,Rogelio Siller
2014,103600,2213.5,3,2,0,1,32,Mohammad Ghareeb
2014,104600,2213.5,1,1,0,0,40,Treat Conrad Huey
2014,104803,2213.5,1,1,0,0,40,Younes Rachidi
2014,104910,2213.5,1,1,0,0,40,Tihomir Grozdanov
2014,105031,2213.5,1,1,0,0,40,Saketh Myneni
2014,105177,2213.5,1,1,0,0,40,Aditya Hari Sasongko
2014,106194,2213.5,1,1,0,0,37,Nutthanon Kadchapanan
2014,109336,2213.5,1,1,0,0,32,Ayoub Chakrouni
2014,124063,2213.5,1,1,0,0,40,Santiago Maresca
2014,126209,2213.5,1,1,0,0,32,Peter Bertran
2014,134302,2213.5,1,1,0,0,40,Mantas Bugailiskis
2014,144775,2213.5,1,1,0,0,37,Linh Giang Trinh
2015,104600,2213.5,1,1,0,0,36,Treat Conrad Huey
2015,104909,2213.5,1,1,0,0,36,Sunu Wahyu Trijati
2015,104910,2213.5,1,1,0,0,19,Tihomir Grozdanov
2015,105273,2213.5,1,1,0,0,19,Mauricio Echazu
2015,105334,2213.5,1,1,0,0,36,Luis David Martinez
2015,105464,2213.5,1,1,0,0,36,Christopher Rungkat
2015,105790,2213.5,1,1,0,0,36,Yong Kyu Lim
2015,105961,2213.5,3,2,0,1,19,David Souto
2015,106249,2213.5,1,1,0,0,36,Joao Domingues
2015,108717,2213.5,1,1,0,0,36,Francis Casey Alcantara
2015,108780,2213.5,1,1,0,0,36,Lofo Ramiaramanana
2015,122321,2213.5,1,1,0,0,11,Marat Deviatiarov
2015,126473,2213.5,1,1,0,0,19,Aljaz Radinski
2015,200537,2213.5,1,1,0,0,4,Nicolas Xiviller
1992,101352,2213.492355,3,2,0,1,31,Jae Sik Kim
2015,106033,2213.492188,3,2,0,1,19,Romain Arneodo
2012,104823,2213.479628,1,1,0,0,11,Bruno Rodriguez
1995,101884,2213.477809,3,2,0,1,20,Frank Ofori
2000,104051,2213.47766,5,3,0,2,9,Andrej Kracman
2013,105386,2213.471697,1,1,0,0,11,Janez Semrajc
1999,101591,2213.466257,3,2,0,1,20,Danny Sapsford
1998,102812,2213.460839,3,2,0,1,18,Jicham Zaatini
1986,110982,2213.459572,3,2,0,1,22,Sombat Uamongkol
1994,101368,2213.446041,5,3,0,2,5,Christian Miniussi
2005,104928,2213.444518,3,2,0,1,8,Sun Yong Kim Jr
1995,102556,2213.440617,5,3,0,2,20,Claude Ngoran
2000,108582,2213.426159,3,2,0,1,37,Luis Perez Chete
2003,102300,2213.424367,7,4,0,3,6,Gouichi Motomura
1996,102135,2213.403165,16,8,0,8,3,Emilio Benfele Alvarez
2011,105023,2213.382573,27,12,0,15,4,Sam Querrey
2001,103402,2213.380913,3,2,0,1,18,Peter Clarke
1988,101717,2213.374688,24,11,0,13,2,Diego Nargiso
2014,104952,2213.373016,5,3,0,2,9,Martin Pedersen
2015,105967,2213.372399,5,3,0,2,5,Henri Laaksonen
2005,102286,2213.356275,1,1,0,0,8,Wayne Black
1992,101955,2213.346185,26,13,0,13,3,Luis Herrera
2009,103248,2213.343354,7,4,0,3,11,Harel Levy
1996,102327,2213.309925,5,3,0,2,10,Adam Skrzypczak
1996,102395,2213.308046,3,2,0,1,10,Ville Liukko
1986,100515,2213.304317,16,8,0,8,3,Shlomo Glickstein
2004,104571,2213.298464,4,2,0,2,11,Marcos Baghdatis
1994,102104,2213.283664,8,4,0,4,15,Christian Ruud
2014,105952,2213.248392,3,2,0,1,18,Renzo Olivo
1991,100553,2213.185171,5,3,0,2,12,Nduka Odizor
2011,105111,2213.172664,3,2,0,1,12,Ivan Endara
2013,105238,2213.160277,52,25,0,27,3,Alexandr Dolgopolov
2014,105790,2213.158238,3,2,0,1,9,Yong Kyu Lim
2011,105579,2213.151748,7,4,0,3,10,Kittipong Wachiramanowong
1989,101507,2213.145036,30,15,0,15,2,Tomas Carbonell
2003,103250,2213.135085,3,2,0,1,38,Rodolphe Cadart
2000,101932,2213.132776,4,2,0,2,4,Jared Palmer
2012,105004,2213.131699,3,2,0,1,40,Dimitar Kutrovsky
2005,103503,2213.120421,17,8,0,9,3,Robin Vik
2015,103594,2213.116184,1,1,0,0,19,Oliver Marach
1997,103166,2213.097763,3,2,0,1,19,Vladimir Voltchkov
1986,100543,2213.093059,6,3,0,3,7,Peter Elter
1996,101884,2213.089853,3,2,0,1,19,Frank Ofori
2003,102968,2213.085541,3,2,0,1,7,Jonathan Erlich
2002,104019,2213.07623,3,2,0,1,14,Kristof Vliegen
1997,102167,2213.068339,46,20,0,26,2,Juan Albert Viloca Puig
2005,102959,2213.060665,3,2,0,1,8,Marko Tkalec
1992,102097,2213.03676,5,3,0,2,29,Naratorn Srichaphan
1998,101957,2213.019154,3,2,0,1,18,Milen Velev
2005,104797,2213.016393,3,2,0,1,26,Denis Istomin
1985,107468,2213.016332,1,1,0,0,31,Julian Stamatov
2005,103316,2213.014827,1,1,0,0,17,Victor Romero
2013,105271,2213.009239,1,1,0,0,11,Gonzalo Escobar
1989,101191,2213.007989,44,23,0,21,3,Richey Reneberg
2009,105497,2212.996078,3,2,0,1,11,Jose Hernandez
1988,100356,2212.996049,5,3,0,2,50,Paul Mcnamee
1996,102632,2212.993284,1,1,0,0,10,Michal Gawlowski
2007,105208,2212.992678,24,10,0,14,3,Ernests Gulbis
2013,104112,2212.987088,5,3,0,2,32,Benjamin Balleret
1996,108277,2212.982655,1,1,0,0,19,Srdan Muskatirovic
1985,100253,2212.980102,18,9,0,9,9,Tom Gullikson
2001,101495,2212.978747,3,2,0,1,33,Miguel Tobon
2011,104775,2212.977285,3,2,0,1,21,Adam Kellner
2013,104557,2212.977285,3,2,0,1,34,Andis Juska
2014,105656,2212.977285,3,2,0,1,32,Marcelo Arevalo
1986,107205,2212.975706,3,2,0,1,26,Hisham Nasser
1994,108832,2212.975706,1,1,0,0,36,Thorsten Poelzl
1995,102656,2212.975706,1,1,0,0,20,Tommi Lenho
1997,101167,2212.975706,1,1,0,0,33,Jaime Cortes
1997,101416,2212.975706,3,2,0,1,19,Joao Cunha Silva
1997,101764,2212.975706,3,2,0,1,33,Yu Hui Lien
1997,102556,2212.975706,3,2,0,1,19,Claude Ngoran
1997,108818,2212.975706,1,1,0,0,19,Givi Samkharadze
1998,102740,2212.975706,1,1,0,0,18,Francisco Rodriguez
1998,102956,2212.975706,3,2,0,1,18,Sultan Khalfan
1998,106991,2212.975706,3,2,0,1,18,Farshad Talavar
1998,108845,2212.975706,3,2,0,1,18,Farhad Tadayon
1999,102448,2212.975706,3,2,0,1,34,Ali Hamadeh
1999,108791,2212.975706,1,1,0,0,18,Oskars Vaskis
2000,101976,2212.975706,3,2,0,1,37,Federico Dondo
2000,103287,2212.975706,3,2,0,1,20,Krystian Pfeiffer
2000,103875,2212.975706,1,1,0,0,40,Anoosha Shahgholi
2001,102713,2212.975706,1,1,0,0,40,Jing Zhu Yang
2001,102812,2212.975706,3,2,0,1,33,Jicham Zaatini
2001,103053,2212.975706,1,1,0,0,18,Nikos Rovas
2001,108631,2212.975706,1,1,0,0,33,Wen Lung Chang
2002,101970,2212.975706,3,2,0,1,17,Iztok Bozic
2002,102942,2212.975706,3,2,0,1,17,Vladimir Pavicevic
2002,103590,2212.975706,3,2,0,1,31,Michael Quintero
2002,104138,2212.975706,3,2,0,1,17,Henry Adjei Darko
2002,104299,2212.975706,1,1,0,0,31,Hiu Tung Yu
2002,108658,2212.975706,1,1,0,0,31,Yanquiel Medina Sobrino
2002,108667,2212.975706,1,1,0,0,17,Kwasi Ahenkora
2002,117349,2212.975706,1,1,0,0,17,F EGYIR
2003,103197,2212.975706,3,2,0,1,17,John Doran
2003,103472,2212.975706,3,2,0,1,17,Karim Maamoun
2003,103905,2212.975706,3,2,0,1,31,Ricardo Chile Fonte
2004,102811,2212.975706,1,1,0,0,18,Dusan Vemic
2004,103803,2212.975706,3,2,0,1,31,Ashkan Shokoofi
2004,108594,2212.975706,3,2,0,1,31,Johnny Arcilla
2004,108928,2212.975706,1,1,0,0,31,Saeid Ahmadvand
2005,103505,2212.975706,3,2,0,1,17,Vasilis Mazarakis
2005,104308,2212.975706,1,1,0,0,17,Michal Przysiezny
2006,103891,2212.975706,3,2,0,1,16,Alexandros Jakupovic
2006,104887,2212.975706,1,1,0,0,8,Piero Luisi
2007,102233,2212.975706,1,1,0,0,35,Leander Paes
2007,104673,2212.975706,3,2,0,1,35,Julio Cesar Campozano
2008,104299,2212.975706,3,2,0,1,31,Hiu Tung Yu
2008,104813,2212.975706,1,1,0,0,17,Grega Zemlja
2009,103630,2212.975706,3,2,0,1,21,Martijn Van Haasteren
2009,105738,2212.975706,1,1,0,0,38,Tsung Hua Yang
2010,104249,2212.975706,1,1,0,0,30,Marcelo Melo
2010,106198,2212.975706,1,1,0,0,22,Hugo Dellien
2010,108744,2212.975706,1,1,0,0,22,Rodrigo Rappaccioli
2010,108746,2212.975706,1,1,0,0,22,Austen Childs
2011,103638,2212.975706,3,2,0,1,21,Jhonson Garcia
2012,103523,2212.975706,1,1,0,0,35,Rohan Bopanna
2012,106169,2212.975706,1,1,0,0,35,Vladyslav Manafov
2014,108786,2212.975706,1,1,0,0,32,Seanon Williams
2015,200272,2212.975706,1,1,0,0,19,Jean Jacques Rakotohasy
1985,101256,2212.966256,7,4,0,3,1,Mark Kratzmann
2000,103590,2212.965094,1,1,0,0,9,Michael Quintero
2001,103544,2212.960539,1,1,0,0,9,Andy Ram
2006,104342,2212.958629,1,1,0,0,16,Matias Silva
2015,103902,2212.957785,1,1,0,0,36,Jan Mertl
2001,103828,2212.957644,3,2,0,1,33,Jean Julien Rojer
2002,103220,2212.956883,1,1,0,0,8,Oh Hee Kwon
2004,104609,2212.955397,1,1,0,0,18,Omar Hedayet
2005,105273,2212.955366,1,1,0,0,8,Mauricio Echazu
2004,101889,2212.955107,1,1,0,0,8,Todd Woodbridge
2011,105030,2212.953927,3,2,0,1,21,Michael Venus
1994,101696,2212.948743,3,2,0,1,26,Federico Mordegan
2009,103908,2212.945664,57,28,0,29,2,Paul Henri Mathieu
1995,101585,2212.944861,1,1,0,0,35,Fabio Silberberg
2009,104813,2212.937844,7,4,0,3,11,Grega Zemlja
2005,104046,2212.935028,3,2,0,1,8,Bostjan Osabnik
1994,101835,2212.92703,6,3,0,3,3,Arne Thoms
2007,103590,2212.897123,1,1,0,0,9,Michael Quintero
1996,101156,2212.894969,3,2,0,1,34,Juan Pino
1987,101014,2212.887238,17,8,0,9,5,John Ross
2005,103428,2212.885587,54,28,0,26,3,Juan Ignacio Chela
2011,105573,2212.885217,1,1,0,0,12,Henri Kontinen
1998,102148,2212.863981,57,29,0,28,2,Fabrice Santoro
2002,102882,2212.845795,28,14,0,14,10,Mark Philippoussis
1992,101312,2212.83159,12,6,0,6,12,Robbie Weiss
2015,120401,2212.827152,3,2,0,1,19,Tucker Vorster
2015,104695,2212.821059,3,2,0,1,19,Fritz Wolmarans
2013,104500,2212.813551,25,13,0,12,8,Somdev Devvarman
1992,101298,2212.808746,39,16,0,23,5,Jonas Svensson
1992,101233,2212.793243,30,14,0,16,3,Alex Antonitsch
1985,101026,2212.744653,8,4,0,4,13,Jim Grabb
2004,103420,2212.683011,8,4,0,4,3,Michal Tabara
2007,103668,2212.681539,3,2,0,1,9,Lazar Magdincev
2000,102375,2212.681325,3,2,0,1,13,Dinu Pescariu
2006,102811,2212.669302,5,3,0,2,15,Dusan Vemic
1999,108585,2212.663314,3,2,0,1,9,Americo Venero Montes
1987,100730,2212.655337,5,3,0,2,20,Florin Segarceanu
2001,101723,2212.65483,20,10,0,10,3,Magnus Larsson
2011,103110,2212.651366,1,1,0,0,12,Daniele Bracciali
1987,100837,2212.630649,25,12,0,13,4,Jeremy Bates
2008,110685,2212.610867,3,2,0,1,8,Gd Jones
2007,103393,2212.610291,7,4,0,3,11,Yuri Schukin
1991,100995,2212.604298,38,17,0,21,3,Eduardo Masso
1992,101073,2212.603691,39,18,0,21,3,Martin Jaite
1987,102021,2212.580083,8,4,0,4,11,Michael Chang
2003,103504,2212.572158,3,2,0,1,31,Febi Widhiyanto
1992,101235,2212.56388,66,35,0,31,3,Paul Haarhuis
2007,104813,2212.560992,3,2,0,1,19,Grega Zemlja
1998,102223,2212.547977,42,21,0,21,2,Karim Alami
1993,101532,2212.544377,47,21,0,26,3,Francisco Clavet
2008,103638,2212.532487,3,2,0,1,31,Jhonson Garcia
1991,101735,2212.529412,42,22,0,20,8,Richard Fromberg
2008,104992,2212.514178,3,2,0,1,8,Syrym Abdukhalikov
1997,106843,2212.512902,1,1,0,0,19,David Katcharava
2008,103184,2212.492656,1,1,0,0,38,Bob Bryan
2005,103184,2212.491205,1,1,0,0,34,Bob Bryan
2004,104342,2212.490644,3,2,0,1,8,Matias Silva
2000,103296,2212.479344,3,2,0,1,20,Ivaylo Traykov
2005,103525,2212.473243,3,2,0,1,8,Ivan Miranda
2005,104342,2212.473243,1,1,0,0,8,Matias Silva
2007,104561,2212.471755,3,2,0,1,9,Jae Sung An
2000,102076,2212.471059,3,2,0,1,20,Mark Merklein
1991,101073,2212.468853,48,25,0,23,3,Martin Jaite
2001,102444,2212.467725,1,1,0,0,18,Scott Barron
1994,101367,2212.463145,1,1,0,0,10,Igor Saric
2015,105806,2212.45811,3,2,0,1,19,Mirza Basic
2002,103413,2212.457025,3,2,0,1,8,Genius Chidzikwe
1985,101154,2212.45662,17,9,0,8,5,Simon Youl
1985,100761,2212.452992,5,3,0,2,10,Danny Saltz
1985,100911,2212.452992,3,2,0,1,10,Dominik Guido Utzinger
1986,108823,2212.452992,3,2,0,1,32,Tintus Arianto Wibowo
1988,101770,2212.452992,3,2,0,1,29,Lech Sidor
1989,107827,2212.452992,3,2,0,1,44,Moncef Zehar
1991,109002,2212.452992,3,2,0,1,25,Tung Yi Kho
1991,110828,2212.452992,3,2,0,1,25,Wai Yaw Liu
1992,111002,2212.452992,3,2,0,1,35,Hani Al Ali
1993,108849,2212.452992,3,2,0,1,36,Rohan De Silva
1993,111047,2212.452992,1,1,0,0,36,Lasith Dissanayake
1994,102097,2212.452992,3,2,0,1,36,Naratorn Srichaphan
1995,101156,2212.452992,3,2,0,1,35,Juan Pino
1996,101495,2212.452992,3,2,0,1,11,Miguel Tobon
1997,102543,2212.452992,3,2,0,1,33,Chia Yen Tsai
1998,101156,2212.452992,1,1,0,0,18,Juan Pino
1998,101651,2212.452992,1,1,0,0,18,Owen Casey
1998,102993,2212.452992,1,1,0,0,18,Michal Chmela
1998,108854,2212.452992,1,1,0,0,18,George Mcgill
2000,101662,2212.452992,3,2,0,1,37,Selvam Veerasingam
2000,101989,2212.452992,1,1,0,0,20,Patrik Langvardt
2001,101662,2212.452992,3,2,0,1,33,Selvam Veerasingam
2001,103273,2212.452992,1,1,0,0,33,Dong Hyun Kim
2003,103050,2212.452992,1,1,0,0,31,Shahab Hassani Nafez
2003,103923,2212.452992,1,1,0,0,17,Radoslaw Nijaki
2004,104591,2212.452992,1,1,0,0,31,Patrick Tierro
2004,108597,2212.452992,1,1,0,0,31,Adelo Abadia
2005,103739,2212.452992,3,2,0,1,26,Jose De Armas
2005,104501,2212.452992,1,1,0,0,17,Xin Yuan Yu
2005,104557,2212.452992,3,2,0,1,17,Andis Juska
2006,103899,2212.452992,3,2,0,1,16,Stian Boretti
2007,103828,2212.452992,1,1,0,0,35,Jean Julien Rojer
2009,104887,2212.452992,3,2,0,1,21,Piero Luisi
2011,104112,2212.452992,3,2,0,1,21,Benjamin Balleret
2011,104863,2212.452992,3,2,0,1,21,Olivier Sajous
2012,105877,2212.452992,1,1,0,0,11,Emilio Gomez
2013,104901,2212.452992,3,2,0,1,34,Vladimir Ivanov
2013,105273,2212.452992,3,2,0,1,34,Mauricio Echazu
2013,107098,2212.452992,1,1,0,0,34,Gilles Kremer
2013,122047,2212.452992,1,1,0,0,34,Luciano Ramazzini
2014,106387,2212.452992,1,1,0,0,32,Mazen Osama
2015,105541,2212.452992,3,2,0,1,19,Alex Llompart
1986,110141,2212.451412,3,2,0,1,32,Chang Rung Wu
2010,105379,2212.451412,3,2,0,1,34,Aljaz Bedene
2012,104146,2212.451412,3,2,0,1,35,Jonathan Chu
2013,105349,2212.451412,3,2,0,1,34,Harri Heliovaara
1995,102077,2212.451307,1,1,0,0,20,Alexander Shvec
2007,103808,2212.449135,51,26,0,25,2,Potito Starace
2000,102650,2212.447635,3,2,0,1,21,Roberto Carretero
2002,103142,2212.438031,1,1,0,0,17,Mohamed Wafa
2013,106026,2212.432764,3,2,0,1,34,Yuki Bhambri
1991,100689,2212.427288,25,12,0,13,3,Tim Mayotte
2009,104589,2212.421643,16,8,0,8,12,Chris Guccione
2015,111797,2212.417411,5,3,0,2,16,Nicolas Jarry
2006,102233,2212.416823,1,1,0,0,30,Leander Paes
2000,117348,2212.415755,1,1,0,0,9,Y WANG
1998,102448,2212.413821,3,2,0,1,18,Ali Hamadeh
1989,100967,2212.413223,26,12,0,14,2,Dan Goldie
2006,104700,2212.405768,3,2,0,1,8,Daniel Vallverdu
2012,104535,2212.372426,5,3,0,2,11,Daniel Garza
2012,105226,2212.363991,9,5,0,4,19,Attila Balazs
1994,101686,2212.346657,38,18,0,20,3,Franco Davin
1989,101071,2212.327047,31,15,0,16,5,Tom Nijssen
2002,103145,2212.308113,5,3,0,2,8,Amir Hadad
2012,104025,2212.286029,5,3,0,2,35,Amer Delic
2009,104919,2212.223233,36,18,0,18,3,Leonardo Mayer
2005,102987,2212.205537,3,2,0,1,34,Andre Sa
1997,102250,2212.205213,5,3,0,2,10,Emanuel Couto
1999,103031,2212.18092,21,10,0,11,7,Julian Alonso
2013,104673,2212.142007,3,2,0,1,11,Julio Cesar Campozano
1985,100428,2212.111717,3,2,0,1,45,Gene Mayer
1998,101862,2212.097703,3,2,0,1,17,Maurice Ruah
2007,104869,2212.092601,3,2,0,1,19,Sergei Bubka
2015,105032,2212.081302,41,19,0,22,8,Samuel Groth
2004,102997,2212.07963,3,2,0,1,8,Hermes Gamonal
2011,104424,2212.072932,14,7,0,7,9,Go Soeda
2006,102904,2212.050476,3,2,0,1,37,Leos Friedl
1989,110794,2212.036099,5,3,0,2,29,Jerome Seguin
2005,102860,2212.004575,43,22,0,21,3,Agustin Calleri
2009,104368,2211.990909,5,3,0,2,11,Daniel King Turner
2008,105339,2211.976078,5,3,0,2,7,Yan Bai
2009,103850,2211.972773,3,2,0,1,43,Sebastian Decoud
2000,102528,2211.952905,1,1,0,0,20,Carlos Drada
2002,102737,2211.948068,3,2,0,1,17,Gergely Kisgyorgy
1985,110833,2211.933416,3,2,0,1,43,Huang Jung Hsu
2009,103499,2211.928698,3,2,0,1,21,Aqeel Khan
1990,100892,2211.913322,5,3,0,2,28,Alexandre Hocevar
2009,104179,2211.903631,3,2,0,1,38,Bruno Echagaray
2013,105790,2211.880896,1,1,0,0,34,Yong Kyu Lim
1994,102588,2211.84315,13,6,0,7,3,Lars Rehmann
1992,101270,2211.838108,4,2,0,2,6,Thomas Gollwitzer
2001,102548,2211.822065,14,7,0,7,17,Juan Antonio Marin
2015,105238,2211.797413,52,26,0,26,3,Alexandr Dolgopolov
2010,104952,2211.793886,3,2,0,1,22,Martin Pedersen
1994,101422,2211.791509,3,2,0,1,21,Mark Kaplan
2011,103851,2211.785488,6,3,0,3,13,Conor Niland
2004,104585,2211.781429,3,2,0,1,8,Gyorgy Balazs
2009,103184,2211.768197,1,1,0,0,21,Bob Bryan
2004,103319,2211.733315,26,13,0,13,3,Jeff Morrison
2010,104494,2211.729127,5,3,0,2,10,Adrian Ungur
2003,102880,2211.723371,17,9,0,8,6,Alexander Popp
1985,100780,2211.704952,35,16,0,19,5,Mike De Palmer
1987,101448,2211.699358,5,3,0,2,27,Tasos Bavelas
1998,102524,2211.68659,14,7,0,7,10,Neville Godwin
2010,104868,2211.662527,10,5,0,5,20,James Ward
1996,102615,2211.634066,10,5,0,5,6,Dennis Van Scheppingen
2010,105166,2211.631185,8,4,0,4,11,Peter Polansky
1986,100870,2211.630216,26,13,0,13,3,Christo Van Rensburg
2006,104179,2211.621153,3,2,0,1,8,Bruno Echagaray
2013,106071,2211.616602,47,25,0,22,3,Bernard Tomic
2009,104225,2211.581436,4,2,0,2,0,Jan Hajek
1988,101154,2211.58039,34,16,0,18,3,Simon Youl
1989,106580,2211.565469,5,3,0,2,28,Arjun Fernando
1988,100395,2211.558991,1,1,0,0,39,Victor Pecci
2015,104586,2211.533451,50,20,0,30,3,Lukas Rosol
2004,104252,2211.529011,38,19,0,19,3,Florian Mayer
2011,103990,2211.527965,34,20,0,14,6,Tommy Robredo
2002,102928,2211.496455,3,2,0,1,8,Hee Seok Chung
1991,101226,2211.477294,12,6,0,6,7,Johan Carlsson
1989,100661,2211.466713,5,3,0,2,38,Damir Keretic
1991,101432,2211.456122,23,12,0,11,3,Dimitri Poliakov
2015,106175,2211.44643,5,3,0,2,11,Ricardo Rodriguez
2003,102148,2211.433179,40,17,0,23,2,Fabrice Santoro
1987,100825,2211.432277,6,3,0,3,22,Hugo Chapacu
2001,103877,2211.4241,5,3,0,2,9,Mike Scheidweiler
2015,105877,2211.413668,3,2,0,1,11,Emilio Gomez
2013,105060,2211.409977,3,2,0,1,18,Aldin Setkic
1996,106536,2211.409122,3,2,0,1,19,Andres Filimonov
1999,108852,2211.409122,3,2,0,1,34,Asiri Iddamalgoda
2008,108960,2211.409122,3,2,0,1,31,Michael Lai
1987,101382,2211.400646,9,5,0,4,3,Marcelo Filippini
2005,103468,2211.395586,5,3,0,2,20,Harsh Mankad
2014,103285,2211.388176,35,17,0,18,10,Radek Stepanek
1996,101098,2211.382285,49,26,0,23,3,Guy Forget
2003,103638,2211.373552,5,3,0,2,8,Jhonson Garcia
1999,102567,2211.361147,14,7,0,7,2,George Bastl
2013,104395,2211.360455,3,2,0,1,34,Marcel Felder
1990,101249,2211.351064,8,4,0,4,1,Andrei Olhovskiy
2000,102143,2211.34228,4,2,0,2,6,Nicolas Thomann
2008,104349,2211.32643,7,4,0,3,8,Rui Machado
1999,101964,2211.310824,48,22,0,26,2,Goran Ivanisevic
2001,101965,2211.30771,39,18,0,21,2,Wayne Ferreira
2004,103857,2211.297751,4,2,0,2,3,Igor Kunitsyn
2014,105806,2211.277082,5,3,0,2,9,Mirza Basic
2005,103066,2211.253237,5,3,0,2,8,Mark Nielsen
1991,101124,2211.250687,16,8,0,8,7,Paolo Cane
2003,103908,2211.217497,39,16,0,23,2,Paul Henri Mathieu
1991,101725,2211.213277,21,11,0,10,3,Gabriel Markus
1997,102024,2211.208475,54,24,0,30,2,Hernan Gumy
1992,101889,2211.135432,48,25,0,23,3,Todd Woodbridge
2009,103454,2211.096523,21,9,0,12,11,Nicolas Massu
1989,100618,2211.086584,30,14,0,16,3,Leif Shiras
2011,105561,2211.054601,3,2,0,1,11,Alessandro Giannessi
2011,104233,2211.048293,7,4,0,3,12,Frederik Nielsen
1989,101255,2211.035784,3,2,0,1,40,Greg Van Emburgh
1988,100809,2211.032043,24,11,0,13,5,Juan Aguilera
2012,105657,2211.010986,8,4,0,4,6,Marius Copil
2006,108628,2211.006861,5,3,0,2,8,Jhonnatan Medina Alvarez
2007,103096,2211.004161,50,24,0,26,2,Arnaud Clement
1986,100321,2210.999613,18,9,0,9,10,Vijay Amritraj
2014,103451,2210.930929,5,3,0,2,38,Bjorn Phau
2004,102306,2210.926675,8,4,0,4,3,Michael Kohlmann
1999,102179,2210.906989,19,9,0,10,6,Antony Dupuis
2010,105777,2210.901315,5,3,0,2,22,Grigor Dimitrov
2006,103865,2210.886408,5,3,0,2,8,Prima Simpatiaji
2013,105155,2210.866882,3,2,0,1,30,Pedro Sousa
2009,103632,2210.838522,3,2,0,1,11,Luis Horna
1998,102655,2210.827807,5,3,0,2,9,Jimy Szymanski
1998,103065,2210.827807,5,3,0,2,9,Kepler Orellana
2009,105062,2210.826215,14,7,0,7,5,Mikhail Kukushkin
2010,104735,2210.799625,15,7,0,8,3,Tobias Kamke
1995,101701,2210.78033,11,6,0,5,6,Bing Pan
2013,103607,2210.766472,3,2,0,1,11,Victor Estrella
2003,101938,2210.754019,3,2,0,1,30,Bernardo Mota
1993,101515,2210.735648,2,1,0,1,7,Donald Johnson
1998,103227,2210.734852,3,2,0,1,9,Mariano Sanchez
1996,102703,2210.72965,5,3,0,2,31,Hyung Taik Lee
2005,103936,2210.719018,5,3,0,2,8,Todor Enev
1993,101722,2210.706652,6,3,0,3,11,Han Cheol Shin
1989,101543,2210.694752,21,10,0,11,2,Jeff Tarango
1993,101511,2210.683817,39,19,0,20,6,Horst Skoff
1993,101353,2210.669694,3,2,0,1,6,Lionel Barthez
2008,105173,2210.669345,6,3,0,3,2,Adrian Mannarino
2002,103239,2210.658354,3,2,0,1,14,Marcus Sarstrand
2014,104467,2210.628168,3,2,0,1,31,Lamine Ouahab
1996,101958,2210.589517,2,1,0,1,21,Pierre Bouteyre
1987,100792,2210.584596,5,3,0,2,22,Adrian Marcu
2005,104813,2210.570912,3,2,0,1,8,Grega Zemlja
2013,105946,2210.552816,3,2,0,1,11,Liang Chi Huang
1986,107560,2210.541738,3,2,0,1,26,Leeh Bienkowski
2012,105583,2210.529222,3,2,0,1,31,Dusan Lajovic
1995,101203,2210.526495,5,3,0,2,10,Adrian Graimprey
1994,101084,2210.520579,50,25,0,25,3,Jakob Hlasek
1997,102911,2210.515114,4,2,0,2,11,Andrei Stoliarov
1994,101311,2210.488826,6,3,0,3,6,Kent Kinnear
2015,105490,2210.46013,5,3,0,2,11,Jui Chen Hung
1990,101409,2210.43797,38,18,0,20,1,Jaime Yzaga
1989,110818,2210.422544,5,3,0,2,28,Shovon Jamaly
2009,104070,2210.411246,4,2,0,2,12,Jesse Witten
1985,100448,2210.397867,2,1,0,1,16,Bruce Foxworth
2007,103978,2210.391576,7,4,0,3,9,Rabie Chaki
2000,102562,2210.350629,54,27,0,27,3,Jiri Novak
1986,100648,2210.335769,3,2,0,1,26,Sadiq Abdullahi
1992,101437,2210.324872,3,2,0,1,31,Seung Ho Ji
1991,101026,2210.310117,42,19,0,23,3,Jim Grabb
2013,105807,2210.293679,14,7,0,7,5,Pablo Carreno Busta
1988,101119,2210.271087,40,17,0,23,2,Marian Vajda
1996,102085,2210.269649,8,4,0,4,10,Sasa Hirszon
1993,102139,2210.261843,4,2,0,2,7,Eyal Ran
2015,103607,2210.255931,40,20,0,20,7,Victor Estrella
1990,100689,2210.229548,37,18,0,19,1,Tim Mayotte
2007,104797,2210.198107,3,2,0,1,35,Denis Istomin
2014,106026,2210.191957,7,4,0,3,9,Yuki Bhambri
1992,101362,2210.148998,8,4,0,4,6,Stephane Simian
1993,101391,2210.148752,44,21,0,23,3,Carl Uwe Steeb
2015,105030,2210.101387,7,4,0,3,19,Michael Venus
1992,101703,2210.092688,30,14,0,16,3,Guillaume Raoux
2000,102106,2210.090687,41,18,0,23,2,Davide Sanguinetti
2012,105217,2210.0904,6,3,0,3,11,Thiemo De Bakker
1988,101204,2210.077752,3,2,0,1,22,Eric Amend
1994,102277,2210.066569,9,5,0,4,10,Bing Chao Lin
1994,101377,2210.058982,32,15,0,17,5,Christian Bergstrom
1990,101004,2210.04574,28,13,0,15,9,Jim Pugh
2014,104349,2210.028924,3,2,0,1,9,Rui Machado
2001,103580,2210.019871,4,2,0,2,13,Alexander Peya
1999,102533,2210.009417,30,15,0,15,2,Jens Knippschild
2008,104281,2210.001333,2,1,0,1,10,Ryler Deheart
1987,101178,2209.976937,2,1,0,1,3,Pieter Aldrich
2003,102615,2209.952029,12,6,0,6,6,Dennis Van Scheppingen
1999,101897,2209.933316,56,28,0,28,3,Fernando Meligeni
2004,102887,2209.91187,7,4,0,3,8,Ramon Delgado
2008,104198,2209.884645,44,22,0,22,3,Guillermo Garcia Lopez
1997,102359,2209.829507,10,5,0,5,21,Andrew Richardson
2012,104736,2209.799924,3,2,0,1,11,Farrukh Dustov
1995,101806,2209.783641,47,23,0,24,3,Marc Kevin Goellner
2003,103970,2209.765541,47,20,0,27,3,David Ferrer
2012,105300,2209.757443,3,2,0,1,34,Sergio Gutierrez Ferrol
1986,107085,2209.753406,3,2,0,1,4,Gerardo Vacarezza
2009,104882,2209.713399,5,3,0,2,11,Blaz Kavcic
1996,102263,2209.677289,5,3,0,2,31,Yong Il Yoon
1986,100957,2209.657198,32,16,0,16,3,Greg Holmes
1994,102152,2209.648579,5,3,0,2,36,Pablo Campana
2011,104471,2209.634445,51,26,0,25,3,Ivan Dodig
1990,101441,2209.616394,8,4,0,4,4,Martin Sinner
1988,100924,2209.589305,31,15,0,16,4,Jorge Lozano
2004,103898,2209.580884,29,14,0,15,3,Julien Benneteau
2003,103590,2209.573089,3,2,0,1,9,Michael Quintero
2003,102959,2209.550918,3,2,0,1,17,Marko Tkalec
2013,104312,2209.546556,59,30,0,29,3,Andreas Seppi
1999,101735,2209.524181,31,15,0,16,6,Richard Fromberg
1988,100829,2209.518867,28,13,0,15,6,Jan Gunnarsson
2010,104593,2209.510805,43,18,0,25,4,Daniel Gimeno Traver
1992,100652,2209.507236,10,5,0,5,3,Cassio Motta
2015,103917,2209.481901,22,11,0,11,3,Nicolas Mahut
1985,101012,2209.477287,4,2,0,2,27,Massimiliano Narducci
1989,100896,2209.461604,19,9,0,10,5,Miguel Nido
1986,101354,2209.451632,8,4,0,4,9,Andrew Sznajder
2000,103751,2209.41347,2,1,0,1,2,Jonas Froberg
1986,100431,2209.384152,9,5,0,4,9,Mansour Bahrami
1998,101900,2209.311244,6,3,0,3,5,Nicklas Kulti
1995,101816,2209.302469,13,6,0,7,12,Steve Campbell
2001,103672,2209.291385,3,2,0,1,11,Ricardo Mello
2004,104755,2209.289247,28,13,0,15,5,Richard Gasquet
2011,105777,2209.272003,43,18,0,25,7,Grigor Dimitrov
2007,103843,2209.27024,6,3,0,3,3,Marco Chiudinelli
1999,103193,2209.25591,27,12,0,15,2,Peter Wessels
1997,101717,2209.250273,5,2,0,3,5,Diego Nargiso
1985,101274,2209.235483,4,2,0,2,10,Udo Riglewski
1986,101050,2209.223852,6,3,0,3,8,Martin Laurendeau
2002,103444,2209.199048,10,5,0,5,9,Jean Rene Lisnard
2004,103694,2209.198991,43,19,0,24,3,Olivier Rochus
1988,101237,2209.182224,11,6,0,5,2,Danilo Marcelino
1987,100850,2209.156665,2,1,0,1,16,Wayne Hearn
1998,102300,2209.140784,9,5,0,4,9,Gouichi Motomura
2010,103525,2209.14004,5,3,0,2,22,Ivan Miranda
1989,101205,2209.139939,19,8,0,11,8,Grant Connell
2008,103344,2209.138091,39,20,0,19,2,Ivan Ljubicic
2013,104308,2209.101377,23,10,0,13,3,Michal Przysiezny
2015,104559,2209.074395,39,17,0,22,3,Teymuraz Gabashvili
2015,105657,2209.051126,12,6,0,6,19,Marius Copil
2009,104547,2209.050156,10,5,0,5,3,Horacio Zeballos
1993,101543,2209.039831,50,24,0,26,3,Jeff Tarango
2014,104252,2209.004416,15,8,0,7,33,Florian Mayer
2000,102556,2208.995967,5,3,0,2,9,Claude Ngoran
1985,101110,2208.974373,8,4,0,4,13,David De Miguel
1992,101524,2208.969091,2,1,0,1,21,Stephan Rhode
2009,104312,2208.929279,55,24,0,31,2,Andreas Seppi
1999,103248,2208.87116,4,2,0,2,9,Harel Levy
2005,102863,2208.861661,7,4,0,3,6,Takao Suzuki
1995,101901,2208.823971,11,6,0,5,28,Chuck Adams
1989,101330,2208.791142,5,3,0,2,19,Tim Donovan
2013,106401,2208.78607,4,2,0,2,11,Nick Kyrgios
1987,101232,2208.677711,4,2,0,2,4,Nicklas Kroon
2014,104945,2208.634173,3,2,0,1,10,James Mcgee
2015,104327,2208.593406,25,12,0,13,6,Steve Darcis
1992,101383,2208.586057,2,1,0,1,14,Stephane Sansoni
1999,103598,2208.569128,22,12,0,10,9,Xavier Malisse
2010,104665,2208.522187,16,8,0,8,4,Pablo Andujar
2002,102925,2208.462465,11,5,0,6,10,Justin Gimelstob
2008,104003,2208.459755,6,3,0,3,5,Victor Crivoi
2001,102344,2208.458785,27,12,0,15,2,Karol Kucera
2004,102202,2208.455756,34,15,0,19,3,Kenneth Carlsen
1993,102562,2208.450908,2,1,0,1,18,Jiri Novak
2010,105339,2208.436385,2,1,0,1,7,Yan Bai
2006,103701,2208.37178,4,2,0,2,17,Diego Hartfield
1989,101462,2208.362331,13,6,0,7,5,Francisco Roig
2005,104154,2208.349032,4,2,0,2,8,Paul Capdeville
1992,101582,2208.300044,6,3,0,3,7,Gilbert Schaller
2004,103451,2208.296473,9,5,0,4,6,Bjorn Phau
1987,101511,2208.296019,46,23,0,23,2,Horst Skoff
1989,101243,2208.23625,28,14,0,14,13,Roberto Azar
2007,104112,2208.206011,7,4,0,3,9,Benjamin Balleret
2009,105657,2208.200683,3,2,0,1,10,Marius Copil
1989,100518,2208.198456,7,4,0,3,30,Ricardo Acuna
2011,104965,2208.184322,5,3,0,2,12,Pavol Cervenak
1987,100490,2208.158519,20,10,0,10,4,Jaroslav Navratil
1987,101161,2208.153158,2,1,0,1,21,Thomas Haldin
1987,100866,2208.131393,4,2,0,2,10,Shahar Perkiss
2001,102167,2208.091741,7,4,0,3,32,Juan Albert Viloca Puig
1991,101251,2208.075775,4,2,0,2,6,Eric Winogradsky
2010,104433,2208.074539,6,3,0,3,11,Frank Dancevic
2003,102905,2208.049014,47,22,0,25,3,Stefan Koubek
1996,101406,2208.036017,6,3,0,3,15,Wojtek Kowalski
2008,102788,2208.033851,2,1,0,1,23,Jan Vacek
1996,102394,2208.014371,39,18,0,21,6,Johan Van Herck
2003,102869,2207.92129,19,10,0,9,7,Galo Blanco
2009,104273,2207.884462,5,2,0,3,8,Edouard Roger Vasselin
2000,103003,2207.865194,2,1,0,1,4,Jean Francois Bachelot
1986,100742,2207.824684,45,22,0,23,3,Christo Steyn
1994,100997,2207.815579,13,6,0,7,12,Roger Smith
1990,100676,2207.793309,43,22,0,21,0,Yannick Noah
2013,104229,2207.7877,35,17,0,18,8,Yen Hsun Lu
1995,101955,2207.77967,15,7,0,8,10,Luis Herrera
1989,100607,2207.770025,34,18,0,16,5,Eduardo Bengoechea
1998,101150,2207.768177,51,23,0,28,0,Gianluca Pozzi
1991,101174,2207.763001,16,8,0,8,4,Fernando Roese
2006,104589,2207.711885,8,4,0,4,30,Chris Guccione
1987,101609,2207.710628,6,3,0,3,16,David Wheaton
1998,101688,2207.708221,10,5,0,5,2,Geoff Grant
1988,100592,2207.698071,8,4,0,4,3,Robert Vant Hof
2003,103835,2207.691472,37,18,0,19,3,Filippo Volandri
1990,102235,2207.657747,4,2,0,2,9,Tommy Ho
1994,102202,2207.65417,45,22,0,23,3,Kenneth Carlsen
2004,104230,2207.634985,3,2,0,1,25,Daniel Koellerer
1996,103060,2207.633984,14,7,0,7,3,Alejandro Hernandez
2013,103786,2207.628749,45,22,0,23,8,Nikolay Davydenko
1997,101805,2207.62236,4,2,0,2,18,David Nainkin
2005,102925,2207.608726,17,8,0,9,6,Justin Gimelstob
2014,105376,2207.602922,17,8,0,9,6,Peter Gojowczyk
1990,101727,2207.588247,36,17,0,19,5,Jason Stoltenberg
2009,105208,2207.571475,46,20,0,26,5,Ernests Gulbis
2008,103857,2207.53228,27,13,0,14,3,Igor Kunitsyn
1986,101180,2207.520691,4,2,0,2,28,Jose Clavet
1995,102521,2207.505417,31,14,0,17,3,Hendrik Dreekmann
2000,102539,2207.499202,33,16,0,17,2,Bohdan Ulihrach
1986,100377,2207.479913,2,1,0,1,24,Colin Dowdeswell
2007,104262,2207.477945,2,1,0,1,26,Flavio Cipolla
2006,104678,2207.46399,2,1,0,1,6,Viktor Troicki
2008,104763,2207.458224,6,3,0,3,12,Rafael Arevalo
1990,100899,2207.424137,2,1,0,1,15,Jorgen Windahl
1993,102367,2207.399134,2,1,0,1,19,Nicolas Kischkewitz
1987,100990,2207.375634,49,24,0,25,2,Milan Srejber
2003,102456,2207.375594,49,27,0,22,2,Felix Mantilla
1987,108532,2207.352682,4,2,0,2,22,Worapol Thongkamcho
1994,102110,2207.351336,16,8,0,8,11,Daniel Nestor
1998,101897,2207.339605,41,19,0,22,2,Fernando Meligeni
1999,103781,2207.337485,2,1,0,1,6,Jurgen Melzer
1997,102394,2207.322202,33,14,0,19,2,Johan Van Herck
2006,103401,2207.275709,38,17,0,21,3,Jan Hernych
2015,104229,2207.245791,41,19,0,22,7,Yen Hsun Lu
2009,103752,2207.2405,30,15,0,15,3,Simon Greul
1989,100844,2207.226864,20,10,0,10,5,Jerome Potier
1998,101788,2207.192733,6,3,0,3,15,Doug Flach
1993,101448,2207.166872,5,3,0,2,9,Tasos Bavelas
1996,101462,2207.160277,8,4,0,4,23,Francisco Roig
2012,105113,2207.14503,2,1,0,1,6,Patrik Rosenholm
1988,100586,2207.141363,20,11,0,9,22,Eliot Teltscher
2015,103926,2207.08008,5,3,0,2,1,Daniel Munoz De La Nava
1994,102060,2207.058862,2,1,0,1,13,Ignacio Martinez
2005,104676,2207.05026,2,1,0,1,16,Andreas Beck
1997,101816,2207.017053,16,8,0,8,11,Steve Campbell
1999,103990,2207.008964,4,2,0,2,10,Tommy Robredo
1989,100962,2206.99217,18,8,0,10,5,Thomas Hogstedt
2008,103435,2206.986479,2,1,0,1,22,Massimo Dellacqua
1992,100653,2206.956188,24,12,0,12,21,Andres Gomez
2015,106390,2206.905865,2,1,0,1,28,Matteo Donati
1995,102227,2206.904113,4,2,0,2,13,Sargis Sargsian
1988,101430,2206.898056,2,1,0,1,25,Sergio Cortes
2003,103065,2206.892505,4,2,0,2,8,Kepler Orellana
1997,103216,2206.873828,2,1,0,1,25,Clemens Trimmel
1993,102394,2206.870989,2,1,0,1,3,Johan Van Herck
2001,104417,2206.837562,2,1,0,1,3,Robin Soderling
1998,101235,2206.778787,41,21,0,20,2,Paul Haarhuis
1988,101900,2206.745503,7,3,0,4,6,Nicklas Kulti
1985,100834,2206.695827,2,1,0,1,10,Karsten Schulz
2011,104926,2206.683938,53,25,0,28,3,Fabio Fognini
2013,103401,2206.681002,10,5,0,5,19,Jan Hernych
1991,101311,2206.678952,4,2,0,2,12,Kent Kinnear
1990,101576,2206.678136,2,1,0,1,5,Ryuso Tsujino
2015,104338,2206.67474,40,21,0,19,16,Juan Monaco
2002,102770,2206.668347,8,4,0,4,3,John Van Lottum
2010,104999,2206.638661,32,14,0,18,5,Mischa Zverev
2014,105217,2206.635976,15,7,0,8,9,Thiemo De Bakker
2004,103484,2206.629563,28,15,0,13,10,James Blake
1995,102450,2206.621165,18,9,0,9,6,Tim Henman
1990,100759,2206.618222,10,5,0,5,5,Danie Visser
1999,102703,2206.613684,7,4,0,3,7,Hyung Taik Lee
2012,104926,2206.608173,46,22,0,24,5,Fabio Fognini
2010,106026,2206.583529,2,1,0,1,9,Yuki Bhambri
2013,104871,2206.583134,47,22,0,25,3,Jeremy Chardy
2014,105062,2206.582336,43,16,0,27,3,Mikhail Kukushkin
1999,103060,2206.575185,8,4,0,4,9,Alejandro Hernandez
1989,101024,2206.538326,4,2,0,2,9,Christian Geyer
1996,102694,2206.514271,12,6,0,6,14,Lars Burgsmuller
2000,102110,2206.512811,17,8,0,9,2,Daniel Nestor
1996,101991,2206.50616,28,14,0,14,3,Mauricio Hadad
2005,103175,2206.498379,2,1,0,1,9,Toshihide Matsui
1994,101889,2206.472039,34,15,0,19,5,Todd Woodbridge
2012,105053,2206.463336,42,21,0,21,12,Santiago Giraldo
2014,103607,2206.448543,19,9,0,10,4,Victor Estrella
1998,102722,2206.44587,9,5,0,4,9,Attila Savolt
2009,102839,2206.431185,25,11,0,14,11,Nicolas Lapentti
2005,104812,2206.421208,5,2,0,3,10,Scoville Jenkins
1987,100635,2206.388226,19,9,0,10,6,Mark Dickson
2011,103752,2206.381885,6,3,0,3,33,Simon Greul
1987,100951,2206.345291,10,5,0,5,19,Alessandro De Minicis
1985,100518,2206.344755,20,10,0,10,10,Ricardo Acuna
2002,103468,2206.342933,6,3,0,3,8,Harsh Mankad
1990,101226,2206.319438,10,5,0,5,9,Johan Carlsson
2014,105053,2206.318369,58,29,0,29,2,Santiago Giraldo
1995,102146,2206.259489,40,18,0,22,3,Jordi Burillo
1995,101543,2206.254175,42,18,0,24,3,Jeff Tarango
1992,100866,2206.251303,2,1,0,1,7,Shahar Perkiss
1998,101507,2206.249892,10,5,0,5,8,Tomas Carbonell
2005,102800,2206.243398,2,1,0,1,21,Nenad Zimonjic
1992,101792,2206.226032,6,3,0,3,12,Slava Dosedel
1995,102212,2206.188518,4,2,0,2,9,Corrado Borroni
1989,101546,2206.183712,4,2,0,2,19,Mike Brown
2006,104305,2206.180996,2,1,0,1,9,Luka Gregorc
1992,101356,2206.151528,2,1,0,1,14,Buff Farrow
2000,104053,2206.133566,9,4,0,5,14,Andy Roddick
1995,102776,2206.11369,10,5,0,5,12,Andrew Ilie
2003,102934,2206.08754,4,2,0,2,23,Nicolas Coutelot
2001,103114,2206.072648,21,11,0,10,7,Martin Lee
1988,100551,2206.037926,25,12,0,13,3,Brad Drewett
1992,101861,2206.03254,6,3,0,3,6,Thomas Buchmayer
2015,106298,2205.985241,26,12,0,14,3,Lucas Pouille
1995,101805,2205.974977,9,4,0,5,6,David Nainkin
2007,104251,2205.970382,2,1,0,1,8,Ti Chen
1987,100997,2205.954965,6,3,0,3,16,Roger Smith
1994,102233,2205.943035,9,4,0,5,9,Leander Paes
1986,100564,2205.927035,4,2,0,2,8,Cary Stansbury
1988,101420,2205.925501,2,1,0,1,20,Vaclav Roubicek
1993,101473,2205.909989,6,3,0,3,9,Jozsef Krocsko
2006,102179,2205.909952,4,2,0,2,21,Antony Dupuis
1990,100995,2205.899779,11,5,0,6,1,Eduardo Masso
1992,102257,2205.881788,4,2,0,2,18,Greg Rusedski
1988,102001,2205.876252,2,1,0,1,16,German Lopez
2008,103566,2205.854641,44,23,0,21,3,Michael Llodra
2005,102783,2205.851451,42,18,0,24,5,Rainer Schuettler
2010,104327,2205.830214,12,6,0,6,5,Steve Darcis
2010,104898,2205.824963,21,9,0,12,3,Robin Haase
1987,108243,2205.81915,2,1,0,1,19,Sergio Ribeiro
1994,102318,2205.818696,4,2,0,2,11,Andrei Pavel
2008,103862,2205.797478,4,2,0,2,3,Michail Elgin
1997,101613,2205.795296,11,6,0,5,30,Malivai Washington
2001,102192,2205.778964,2,1,0,1,9,Luis Adrian Morejon
2006,103843,2205.753483,10,5,0,5,3,Marco Chiudinelli
1996,102722,2205.740643,2,1,0,1,10,Attila Savolt
2010,105015,2205.710468,6,3,0,3,18,Franco Skugor
2010,103926,2205.693964,2,1,0,1,29,Daniel Munoz De La Nava
1998,101889,2205.675541,44,21,0,23,2,Todd Woodbridge
1988,101226,2205.675364,7,3,0,4,6,Johan Carlsson
1993,102215,2205.654413,2,1,0,1,25,Joshua Eagle
2013,103565,2205.65038,4,2,0,2,13,Stephane Robert
1997,102146,2205.635409,18,8,0,10,2,Jordi Burillo
1986,101033,2205.632107,2,1,0,1,13,John Letts
1992,101725,2205.631554,39,18,0,21,3,Gabriel Markus
1989,100928,2205.609442,17,8,0,9,18,Barry Moir
2012,104460,2205.586423,9,4,0,5,20,Dustin Brown
2001,103133,2205.582571,2,1,0,1,19,Olivier Mutis
2007,104397,2205.5825,4,2,0,2,18,Laurent Recouderc
2007,103529,2205.565074,8,4,0,4,8,Aisam Ul Haq Qureshi
2003,102061,2205.562438,2,1,0,1,8,Kevin Ullyett
1992,102047,2205.55121,2,1,0,1,8,Pier Gauthier
1993,101430,2205.546627,17,9,0,8,5,Sergio Cortes
1987,100833,2205.527498,20,10,0,10,11,Marc Flur
1997,102537,2205.521545,4,2,0,2,32,Melvin Tong
1993,101226,2205.485848,4,2,0,2,20,Johan Carlsson
2015,105668,2205.484927,48,24,0,24,5,Jerzy Janowicz
1994,100926,2205.467481,2,1,0,1,15,Ken Flach
1985,100522,2205.452594,4,2,0,2,10,Chris Dunk
2007,105385,2205.448906,6,3,0,3,12,Donald Young
2009,104076,2205.444178,42,21,0,21,7,Jose Acasuso
1993,101861,2205.437115,4,2,0,2,6,Thomas Buchmayer
1985,100716,2205.361416,2,1,0,1,21,Norm Schellenger
1996,102491,2205.347092,26,12,0,14,3,Alex Radulescu
2006,105223,2205.328368,22,10,0,12,3,Juan Martin Del Potro
1994,101543,2205.295509,50,23,0,27,6,Jeff Tarango
1988,101788,2205.290763,2,1,0,1,20,Doug Flach
1986,100780,2205.271583,21,9,0,12,3,Mike De Palmer
2005,103105,2205.253399,10,5,0,5,9,Ruben Ramirez Hidalgo
1985,100714,2205.251715,17,9,0,8,1,Broderick Dyke
1992,101805,2205.248983,2,1,0,1,15,David Nainkin
1994,101027,2205.246611,2,1,0,1,11,Jaroslav Bulant
2004,103166,2205.237548,11,5,0,6,5,Vladimir Voltchkov
2001,103781,2205.235507,2,1,0,1,6,Jurgen Melzer
1995,103017,2205.232478,6,3,0,3,5,Nicolas Kiefer
2010,104477,2205.226003,4,2,0,2,22,Jorge Aguilar
2000,102910,2205.21444,2,1,0,1,34,Salvador Navarro
1988,100785,2205.214283,4,2,0,2,15,Jesus Colas
1989,101529,2205.114,23,11,0,12,4,Michael Stich
1989,101109,2205.095299,4,2,0,2,14,Tarik Benhabiles
2010,103035,2205.093141,2,1,0,1,31,Alessio Di Mauro
2000,103324,2205.086825,42,17,0,25,3,Arnaud Di Pasquale
2011,105270,2205.064091,2,1,0,1,27,Maxime Teixeira
1996,101929,2205.061086,4,2,0,2,6,Joost Winnink
2008,105992,2205.049927,2,1,0,1,30,Ryan Harrison
2006,102033,2205.047602,2,1,0,1,16,Abdelhak Hameurlaine
1985,100844,2204.991946,9,4,0,5,11,Jerome Potier
1991,102302,2204.98338,4,2,0,2,12,Marcelo Saliola
1999,101727,2204.956559,36,18,0,18,11,Jason Stoltenberg
1989,101119,2204.95138,31,14,0,17,7,Marian Vajda
1989,107861,2204.949894,2,1,0,1,14,Nicolas Romero
2010,104534,2204.938671,36,16,0,20,9,Dudi Sela
1991,101961,2204.910982,2,1,0,1,30,Martin Stringari
1989,101956,2204.899665,9,5,0,4,18,Mark Knowles
1998,102723,2204.863736,2,1,0,1,2,Eduardo Medica
2000,102201,2204.853406,8,4,0,4,16,Lionel Roux
1987,100945,2204.847001,4,2,0,2,3,Craig Campbell
1997,101917,2204.825019,43,21,0,22,5,Grant Stafford
1994,101822,2204.806881,2,1,0,1,18,Luis Lobo
1995,102132,2204.800577,2,1,0,1,27,Ivan Baron
1997,102785,2204.800123,4,2,0,2,14,Glenn Weiner
2006,104999,2204.795876,6,3,0,3,5,Mischa Zverev
2007,105137,2204.775671,2,1,0,1,18,Pere Riba
2006,103666,2204.764129,4,2,0,2,16,Ilia Kushev
2003,102169,2204.759301,2,1,0,1,14,Michael Joyce
2004,103908,2204.758326,21,10,0,11,2,Paul Henri Mathieu
1990,101205,2204.745234,40,19,0,21,5,Grant Connell
2013,104026,2204.732294,2,1,0,1,6,Joachim Johansson
1993,100752,2204.726496,9,4,0,5,11,Ramesh Krishnan
1997,101417,2204.711438,4,2,0,2,3,Mario Rincon
1988,101475,2204.694218,4,2,0,2,5,Carlos Costa
1995,101391,2204.692147,28,12,0,16,3,Carl Uwe Steeb
1985,100337,2204.682955,19,9,0,10,1,Mark Edmondson
2009,103096,2204.659839,34,14,0,20,2,Arnaud Clement
1991,101059,2204.657075,4,2,0,2,17,Richard Vogel
2006,104871,2204.640785,4,2,0,2,22,Jeremy Chardy
1994,101026,2204.628481,38,18,0,20,6,Jim Grabb
1990,101733,2204.628455,9,5,0,4,4,Jan Siemerink
1998,102436,2204.593176,4,2,0,2,16,Borut Urh
1999,103018,2204.589211,30,15,0,15,2,Max Mirnyi
1995,102925,2204.583111,2,1,0,1,13,Justin Gimelstob
1990,101660,2204.540573,2,1,0,1,10,Francisco Montana
1997,101475,2204.539582,43,20,0,23,2,Carlos Costa
2003,104014,2204.530326,2,1,0,1,19,Lee Childs
2000,102250,2204.520777,2,1,0,1,9,Emanuel Couto
1999,101932,2204.502088,2,1,0,1,13,Jared Palmer
1996,102839,2204.489119,35,16,0,19,3,Nicolas Lapentti
2010,104967,2204.468467,2,1,0,1,19,Alexander Sadecky
1998,102506,2204.425695,4,2,0,2,31,Quino Munoz
1988,101388,2204.41031,2,1,0,1,13,Gerardo Mirad
2010,103812,2204.410076,50,26,0,24,4,Victor Hanescu
1986,101247,2204.409165,2,1,0,1,24,Stephen Botfield
1987,101971,2204.40805,2,1,0,1,11,Johan Anderson
1990,101096,2204.407077,39,19,0,20,1,Gary Muller
2014,105047,2204.37823,2,1,0,1,19,Tim Puetz
1996,102107,2204.374878,2,1,0,1,10,Jan Frode Andersen
1986,101301,2204.338575,2,1,0,1,20,Jan Willem Lodder
2008,103850,2204.328438,4,2,0,2,24,Sebastian Decoud
1999,102720,2204.328359,8,4,0,4,11,Tomas Zib
2013,105080,2204.313866,2,1,0,1,6,Miloslav Mecir
1987,100616,2204.295661,2,1,0,1,38,Andy Kohlberg
2006,103702,2204.294964,2,1,0,1,15,Stefano Ianni
2002,102077,2204.291307,2,1,0,1,3,Alexander Shvec
2011,104633,2204.288424,2,1,0,1,11,Mathieu Rodrigues
2002,102473,2204.271451,2,1,0,1,15,Thomas Schiessling
2006,105095,2204.253605,16,8,0,8,3,Evgeny Korolev
1986,100711,2204.238298,9,4,0,5,10,Pedro Rebolledo
2005,104209,2204.22029,2,1,0,1,5,Rainer Eitzinger
2010,103967,2204.173865,6,3,0,3,11,Michael Lammer
2007,102987,2204.134343,2,1,0,1,9,Andre Sa
2014,103813,2204.130527,53,26,0,27,3,Jarkko Nieminen
1987,101029,2204.111645,41,19,0,22,2,Ricki Osterthun
2008,103607,2204.108395,4,2,0,2,15,Victor Estrella
1988,101680,2204.106384,4,2,0,2,14,Zeeshan Ali
1994,102881,2204.106074,2,1,0,1,16,David Skoch
1985,101074,2204.105894,4,2,0,2,13,Carlos Di Laura
1998,102869,2204.077188,45,20,0,25,2,Galo Blanco
2015,123755,2204.073099,2,1,0,1,18,Daniel Elahi Galan Riveros
1989,101914,2204.070855,2,1,0,1,21,Lars Koslowski
2010,105223,2204.067405,6,3,0,3,8,Juan Martin Del Potro
2012,104256,2204.049895,2,1,0,1,10,Clement Reix
1998,102669,2204.045738,2,1,0,1,11,Noam Behr
1995,102394,2204.035794,12,6,0,6,7,Johan Van Herck
2008,104216,2204.022934,9,4,0,5,10,Maximo Gonzalez
1994,108596,2204.014645,6,3,0,3,30,Ramin Raziyani
1986,101178,2204.01246,2,1,0,1,3,Pieter Aldrich
1987,101012,2204.010648,2,1,0,1,29,Massimiliano Narducci
1996,101490,2204.00924,2,1,0,1,11,Daniel Orsanic
1993,101398,2204.00906,28,13,0,15,6,Neil Borwick
1991,101058,2204.00149,2,1,0,1,8,Francisco Yunis
1996,101591,2203.975455,11,5,0,6,11,Danny Sapsford
2009,102967,2203.964244,46,21,0,25,4,Marc Gicquel
1991,101195,2203.959427,50,21,0,29,3,Amos Mansdorf
2003,104607,2203.956459,4,2,0,2,6,Tomas Berdych
2013,109520,2203.954947,2,1,0,1,11,Herkko Pollanen
1988,101461,2203.949772,2,1,0,1,10,Brett Custer
2008,103747,2203.939675,2,1,0,1,19,Dominik Meffert
2004,104371,2203.938455,2,1,0,1,17,Ivo Minar
2005,102886,2203.918861,4,2,0,2,18,Frantisek Cermak
1989,107172,2203.913268,2,1,0,1,20,Harald Mair
2006,104136,2203.907806,6,3,0,3,8,Santiago Gonzalez
1990,101598,2203.901486,2,1,0,1,14,Eduardo Velez
1986,101186,2203.886903,2,1,0,1,18,Desmond Tyson
2000,102162,2203.858391,43,19,0,24,2,Chris Woodruff
2002,101897,2203.819692,44,20,0,24,5,Fernando Meligeni
1999,101806,2203.802874,8,4,0,4,9,Marc Kevin Goellner
1990,101224,2203.799702,2,1,0,1,29,Kenny Thorne
2013,103808,2203.792873,2,1,0,1,28,Potito Starace
1989,100898,2203.784805,6,3,0,3,22,Robinson Ureta
1991,101900,2203.752883,44,20,0,24,3,Nicklas Kulti
2006,103746,2203.716062,4,2,0,2,30,Miguel Gallardo Valles
2014,109737,2203.715415,2,1,0,1,32,Markos Kalovelonis
2005,102558,2203.700972,2,1,0,1,6,Eric Taino
1994,101806,2203.699802,52,22,0,30,6,Marc Kevin Goellner
2011,104804,2203.686656,4,2,0,2,12,Amir Weintraub
1997,101806,2203.644867,59,23,0,36,2,Marc Kevin Goellner
1990,101717,2203.642063,10,4,0,6,1,Diego Nargiso
2007,104926,2203.629909,12,5,0,7,7,Fabio Fognini
2006,104476,2203.584185,2,1,0,1,30,Louk Sorensen
2002,102987,2203.563076,46,20,0,26,3,Andre Sa
2010,104639,2203.552855,14,7,0,7,36,Wayne Odesnik
1998,102925,2203.514661,30,14,0,16,6,Justin Gimelstob
1993,101889,2203.513729,39,19,0,20,7,Todd Woodbridge
1999,101924,2203.510702,4,2,0,2,19,Stefano Pescosolido
2011,104661,2203.501263,2,1,0,1,14,Pierre Ludovic Duclos
1989,100595,2203.480018,5,2,0,3,5,Ronnie Bathman
1989,101767,2203.474333,9,4,0,5,14,Lars Jonsson
2000,103292,2203.473309,52,27,0,25,3,Gaston Gaudio
1990,106695,2203.471212,2,1,0,1,11,Carlos Claverie
1994,102286,2203.468548,8,4,0,4,9,Wayne Black
2003,102477,2203.443722,11,5,0,6,9,Gaston Etlis
1990,101237,2203.440573,8,4,0,4,1,Danilo Marcelino
1996,102362,2203.427672,6,3,0,3,10,Amro Ghoneim
2003,102928,2203.408322,4,2,0,2,31,Hee Seok Chung
2006,103820,2203.399294,2,1,0,1,16,Alan Mackin
1991,101977,2203.392095,2,1,0,1,14,Patricio Arnold
2001,103594,2203.386403,2,1,0,1,17,Oliver Marach
1988,101723,2203.369817,4,2,0,2,6,Magnus Larsson
1990,101232,2203.354501,33,15,0,18,5,Nicklas Kroon
1988,107480,2203.344852,4,2,0,2,2,Karel Demuynck
2005,104224,2203.344322,2,1,0,1,20,Travis Rettenmaier
1989,108814,2203.33378,4,2,0,2,22,Konstantinos Effraimoglou
1994,101745,2203.318198,13,7,0,6,11,Roberto Jabali
1998,101956,2203.317109,8,4,0,4,18,Mark Knowles
2009,104515,2203.312988,2,1,0,1,26,Mathieu Montcourt
2000,103176,2203.301782,8,4,0,4,11,David Sanchez
2007,102642,2203.301471,2,1,0,1,40,Cyril Saulnier
2007,102788,2203.300487,2,1,0,1,23,Jan Vacek
2010,105041,2203.292863,41,19,0,22,5,Lukas Lacko
1990,101459,2203.273418,4,2,0,2,6,Tomas Nydahl
2000,102053,2203.264361,2,1,0,1,45,Brian Macphie
2014,103401,2203.259513,2,1,0,1,19,Jan Hernych
1990,100997,2203.258043,4,2,0,2,29,Roger Smith
1997,101962,2203.250173,4,2,0,2,34,Younes El Aynaoui
1998,103819,2203.24632,5,2,0,3,7,Roger Federer
2015,104947,2203.211106,26,12,0,14,6,Marsel Ilhan
1992,101849,2203.208729,2,1,0,1,34,Nicola Bruno
2001,103254,2203.198714,2,1,0,1,22,Yves Allegro
2002,102184,2203.19285,4,2,0,2,12,David Prinosil
1988,100635,2203.186202,18,9,0,9,20,Mark Dickson
2012,106261,2203.184832,2,1,0,1,12,Dennis Novikov
1986,100796,2203.179863,6,3,0,3,26,Ahmed El Mehelmy
1994,102257,2203.173209,50,21,0,29,3,Greg Rusedski
1987,100639,2203.161606,21,10,0,11,5,Blaine Willenborg
2004,103470,2203.151362,8,4,0,4,10,Robert Kendrick
1990,101311,2203.150297,2,1,0,1,11,Kent Kinnear
1998,101061,2203.132963,2,1,0,1,17,Jimmy Arias
1994,102013,2203.129454,6,3,0,3,10,Blaz Trupej
1988,100631,2203.128889,35,15,0,20,3,Tim Wilkison
1994,108836,2203.128505,4,2,0,2,36,Jayendra Wijeyesekera
2003,102556,2203.128505,4,2,0,2,17,Claude Ngoran
2000,103525,2203.126151,2,1,0,1,38,Ivan Miranda
2011,104291,2203.123744,6,3,0,3,13,Malek Jaziri
1990,101365,2203.120665,4,2,0,2,11,Paul Wekesa
1994,102968,2203.086507,2,1,0,1,7,Jonathan Erlich
1988,100800,2203.074543,33,16,0,17,2,Diego Perez
1988,101252,2203.069363,2,1,0,1,24,Brian Page
2006,104268,2203.057463,16,8,0,8,3,Alejandro Falla
1991,107680,2203.049001,2,1,0,1,20,Mark Bailey
1986,100738,2203.031094,2,1,0,1,3,Schalk Van Der Merwe
1985,100567,2202.998538,32,14,0,18,9,Chip Hooper
2003,103104,2202.991435,2,1,0,1,18,Bjorn Rehnquist
2011,103428,2202.974852,53,29,0,24,4,Juan Ignacio Chela
1988,100570,2202.974703,45,20,0,25,4,Marty Davis
2006,103823,2202.973585,18,9,0,9,5,Denis Gremelmayr
2011,105311,2202.964848,4,2,0,2,21,Joao Sousa
2004,103663,2202.95917,2,1,0,1,10,Matias Boeker
2000,102558,2202.956426,8,4,0,4,8,Eric Taino
2010,105573,2202.937308,4,2,0,2,25,Henri Kontinen
2006,103722,2202.927212,49,23,0,26,2,Florent Serra
2000,102817,2202.911543,5,3,0,2,19,Edwin Kempes
1989,101561,2202.910662,2,1,0,1,20,Nicklas Utgren
2006,103675,2202.906292,4,2,0,2,15,Diego Junqueira
1986,100868,2202.892154,4,2,0,2,8,Craig A Miller
2015,105917,2202.881809,2,1,0,1,27,Gianni Mina
1993,102090,2202.866893,2,1,0,1,7,Ofer Sela
1996,102269,2202.852619,2,1,0,1,14,Jeff Salzenstein
1997,102483,2202.852315,2,1,0,1,17,David Caballero
1992,100855,2202.850782,6,3,0,3,8,Scott Davis
1985,100715,2202.839327,4,2,0,2,19,Jim Gurfein
1986,101154,2202.82821,10,5,0,5,24,Simon Youl
1985,107159,2202.821758,2,1,0,1,10,Hajime Nihonmatsu
2002,102110,2202.811541,4,2,0,2,8,Daniel Nestor
1996,102336,2202.806358,2,1,0,1,32,Kotaro Miyachi
1987,101598,2202.800623,2,1,0,1,27,Eduardo Velez
2006,104505,2202.799563,2,1,0,1,5,Konstantin Kravchuk
2014,104960,2202.775476,6,3,0,3,9,Miguel Angel Reyes Varela
2003,103580,2202.765718,4,2,0,2,5,Alexander Peya
2012,104672,2202.760001,2,1,0,1,10,Vincent Millot
1988,101809,2202.747968,10,5,0,5,3,Nicolas Pereira
2004,103754,2202.747232,2,1,0,1,21,Mark Hilton
2014,105934,2202.738929,2,1,0,1,5,Chuhan Wang
2007,104250,2202.735077,4,2,0,2,21,Prakash Amritraj
1987,100904,2202.732838,2,1,0,1,19,George Bezecny
2008,104026,2202.725248,2,1,0,1,5,Joachim Johansson
1991,101406,2202.709799,6,3,0,3,8,Wojtek Kowalski
2013,104352,2202.708371,2,1,0,1,34,Colin Obrien
1994,101858,2202.70553,2,1,0,1,11,Gilles Bastie
1985,100560,2202.69256,2,1,0,1,10,Jacques Manset
1991,101577,2202.683333,2,1,0,1,34,Jia Ping Xia
1990,101469,2202.679473,20,9,0,11,4,Brian Garrow
2004,104383,2202.674221,2,1,0,1,30,Diogo Rocha
2008,104882,2202.663501,6,3,0,3,17,Blaz Kavcic
2009,103917,2202.633148,8,4,0,4,10,Nicolas Mahut
2011,105992,2202.631478,33,14,0,19,8,Ryan Harrison
1993,101495,2202.631135,4,2,0,2,36,Miguel Tobon
1994,102419,2202.61371,6,3,0,3,10,Christophe Van Garsse
1994,108849,2202.605791,4,2,0,2,36,Rohan De Silva
2004,103066,2202.60488,6,3,0,3,8,Mark Nielsen
1988,100855,2202.598561,27,12,0,15,10,Scott Davis
1989,106576,2202.573443,2,1,0,1,28,Arafat Chekrouni
2008,103851,2202.569626,4,2,0,2,17,Conor Niland
2008,104352,2202.569626,2,1,0,1,17,Colin Obrien
2002,102968,2202.538643,4,2,0,2,12,Jonathan Erlich
2006,102610,2202.538387,4,2,0,2,27,Albert Costa
1999,102632,2202.53727,4,2,0,2,9,Michal Gawlowski
1992,101864,2202.536155,2,1,0,1,24,Fernon Wibier
1995,102154,2202.53597,39,17,0,22,6,Marcos Ondruska
2007,104897,2202.531823,2,1,0,1,30,Matthias Bachinger
1999,102623,2202.516665,2,1,0,1,9,Thomas Larsen
1989,101532,2202.493445,11,5,0,6,19,Francisco Clavet
1989,105080,2202.49247,2,1,0,1,53,Miloslav Mecir
1989,100452,2202.463347,9,4,0,5,18,Bill Scanlon
1989,101775,2202.450101,2,1,0,1,53,Frederik Fetterlein
2001,103202,2202.449388,6,3,0,3,17,Oscar Serrano
2013,104979,2202.448932,10,5,0,5,6,Andrey Golubev
2004,103813,2202.44816,39,20,0,19,3,Jarkko Nieminen
1997,101235,2202.437468,49,21,0,28,2,Paul Haarhuis
2015,105819,2202.437259,2,1,0,1,37,Guido Andreozzi
1987,101354,2202.426317,9,4,0,5,16,Andrew Sznajder
1998,101687,2202.418669,6,3,0,3,19,David Dilucia
1999,102227,2202.416785,44,21,0,23,2,Sargis Sargsian
1996,102110,2202.40265,26,11,0,15,6,Daniel Nestor
2011,103333,2202.393062,37,16,0,21,6,Ivo Karlovic
1995,101775,2202.38968,26,12,0,14,3,Frederik Fetterlein
1993,101868,2202.383518,2,1,0,1,24,Dick Norman
2007,104268,2202.379858,31,14,0,17,3,Alejandro Falla
1985,101263,2202.376643,2,1,0,1,16,Luke Jensen
1987,101120,2202.375968,42,19,0,23,4,Karel Novacek
2001,104196,2202.36563,2,1,0,1,17,Carlos Cuadrado
2006,105217,2202.352143,2,1,0,1,17,Thiemo De Bakker
1991,101711,2202.317427,2,1,0,1,15,Alex Obrien
2013,104043,2202.314426,2,1,0,1,11,Marc Lopez
2014,106291,2202.313362,4,2,0,2,18,Luke Saville
2010,104453,2202.311691,2,1,0,1,6,Michael Ryderstedt
1991,101897,2202.29148,4,2,0,2,12,Fernando Meligeni
2002,102497,2202.284501,2,1,0,1,9,Mashiska Washington
2011,103598,2202.270494,50,24,0,26,4,Xavier Malisse
2007,102967,2202.262871,46,21,0,25,3,Marc Gicquel
1997,101591,2202.249922,6,3,0,3,11,Danny Sapsford
1987,101234,2202.238909,22,10,0,12,6,Patrik Kuhnen
2014,106053,2202.226084,2,1,0,1,18,Philip Davydenko
2003,104495,2202.217379,2,1,0,1,15,Florin Mergea
2013,104216,2202.212332,2,1,0,1,13,Maximo Gonzalez
1993,100829,2202.210704,2,1,0,1,22,Jan Gunnarsson
2005,102565,2202.204073,19,9,0,10,3,Alexander Waske
2002,103066,2202.190525,8,4,0,4,14,Mark Nielsen
1988,100942,2202.180295,41,19,0,22,3,Thierry Tulasne
2003,102667,2202.168447,2,1,0,1,6,Satoshi Iwabuchi
2002,103178,2202.165675,2,1,0,1,16,Johan Settergren
1999,101821,2202.15598,2,1,0,1,22,Peter Tramacchi
1990,101064,2202.147123,2,1,0,1,27,David Lewis
2009,104471,2202.144784,4,2,0,2,17,Ivan Dodig
2008,104914,2202.143276,2,1,0,1,19,Ervin Eleskovic
1986,101155,2202.141549,2,1,0,1,25,James Turner
1988,101504,2202.136364,2,1,0,1,44,Laurent Prades
2006,104209,2202.134234,4,2,0,2,5,Rainer Eitzinger
1987,101143,2202.132191,2,1,0,1,19,Branislav Stankovic
1997,102494,2202.130441,2,1,0,1,9,Tomas Behrend
1997,103229,2202.125647,2,1,0,1,10,Kornel Bardoczky
2003,103184,2202.119399,9,4,0,5,13,Bob Bryan
2006,102886,2202.109225,2,1,0,1,7,Frantisek Cermak
1986,106576,2202.094017,4,2,0,2,38,Arafat Chekrouni
1988,110880,2202.094017,2,1,0,1,39,Wei You
1989,101236,2202.094017,2,1,0,1,34,Krassimir Lazarov
1989,101369,2202.094017,2,1,0,1,37,Bent Ove Pedersen
1989,102104,2202.094017,2,1,0,1,37,Christian Ruud
1992,108811,2202.094017,4,2,0,2,19,Christophe Boggetti
1999,102812,2202.094017,4,2,0,2,34,Jicham Zaatini
2006,104895,2202.094017,4,2,0,2,30,Abdullah Maqdas
2008,104247,2202.094017,4,2,0,2,17,Sebo Kiss
2007,103175,2202.092259,2,1,0,1,8,Toshihide Matsui
1999,103612,2202.090878,4,2,0,2,34,Alexey Kedryuk
2000,103735,2202.089388,4,2,0,2,13,Lovro Zovko
1988,100938,2202.076101,2,1,0,1,44,Jaromir Becka
2013,106290,2202.071848,2,1,0,1,16,Filip Peliwo
1985,100826,2202.057249,3,1,0,2,8,Juan Antonio Rodriguez
1999,102469,2202.05623,4,2,0,2,12,Solon Peppas
2012,104803,2202.055108,2,1,0,1,42,Younes Rachidi
1991,100529,2202.039606,38,18,0,20,3,Kevin Curren
2006,104592,2202.034548,6,3,0,3,22,Ilija Bozoljac
1993,101279,2202.028951,2,1,0,1,24,Philippe Pech
2013,105732,2202.011416,3,1,0,2,3,Pierre Hugues Herbert
2007,108594,2202.010492,2,1,0,1,9,Johnny Arcilla
1986,107960,2202.001993,2,1,0,1,32,Pedro Cordeiro
1987,107205,2202.001993,2,1,0,1,41,Hisham Nasser
1987,107511,2202.001993,2,1,0,1,41,Khaled Baligh
1998,103529,2202.001993,2,1,0,1,9,Aisam Ul Haq Qureshi
2000,103659,2202.001993,4,2,0,2,9,Wei Jen Cheng
1986,100877,2201.997575,4,2,0,2,23,Brett Dickinson
1998,103179,2201.997035,4,2,0,2,18,Jurek Stasiak
2005,103145,2201.974989,4,2,0,2,9,Amir Hadad
1999,103735,2201.963755,4,2,0,2,9,Lovro Zovko
2009,103722,2201.96101,53,24,0,29,3,Florent Serra
2014,110748,2201.954684,2,1,0,1,24,Nikola Milojevic
2007,105194,2201.950755,2,1,0,1,8,Nick Lindahl
1989,101033,2201.947158,2,1,0,1,50,John Letts
2011,104415,2201.9368,2,1,0,1,12,Colin Fleming
2008,104579,2201.933816,2,1,0,1,6,Romain Jouan
2005,103534,2201.923639,4,2,0,2,35,Nicolas Devilder
1994,102135,2201.919048,8,4,0,4,11,Emilio Benfele Alvarez
2007,102720,2201.910527,7,3,0,4,6,Tomas Zib
1989,101020,2201.873489,2,1,0,1,38,Hans Schwaier
2007,104230,2201.867941,2,1,0,1,18,Daniel Koellerer
1987,101406,2201.851509,4,2,0,2,28,Wojtek Kowalski
1986,100882,2201.849964,2,1,0,1,8,David Livingston
1996,101584,2201.841792,2,1,0,1,41,Keith Evans
2008,103104,2201.829741,4,2,0,2,5,Bjorn Rehnquist
2012,105299,2201.820806,6,3,0,3,11,Dzmitry Zhyrmont
1987,110867,2201.819127,2,1,0,1,33,Anders Haseth
1987,111008,2201.819127,2,1,0,1,33,John Erik Rustad
2006,103408,2201.81651,2,1,0,1,33,Brian Vahaly
1998,102336,2201.815801,2,1,0,1,31,Kotaro Miyachi
2000,101191,2201.779531,2,1,0,1,45,Richey Reneberg
1988,100820,2201.777909,4,2,0,2,22,Thierry Pham
1994,100815,2201.772642,2,1,0,1,34,David Pate
2015,100644,2201.770102,31,14,0,17,6,Alexander Zverev
1989,101154,2201.768735,28,13,0,15,3,Simon Youl
1991,102205,2201.758705,2,1,0,1,19,Sebastien Lareau
2013,106328,2201.758228,2,1,0,1,19,Christian Harrison
1995,102881,2201.751401,2,1,0,1,17,David Skoch
2001,102855,2201.747032,2,1,0,1,12,Jack Brasington
1987,100602,2201.732155,2,1,0,1,25,Vallis Wilder
1993,101561,2201.730853,2,1,0,1,35,Nicklas Utgren
1991,107798,2201.728396,4,2,0,2,12,Miguel Merz
2001,102950,2201.72692,49,23,0,26,3,Fernando Vicente
2001,103105,2201.726208,2,1,0,1,11,Ruben Ramirez Hidalgo
1985,100737,2201.724753,2,1,0,1,10,Gary Lemon
1998,101549,2201.719122,2,1,0,1,23,Rodolphe Gilbert
2004,103730,2201.710336,6,3,0,3,21,Jonathan Marray
2004,103865,2201.704626,4,2,0,2,31,Prima Simpatiaji
1996,102436,2201.697315,4,2,0,2,19,Borut Urh
1989,101314,2201.695079,2,1,0,1,18,Woody Hunt
1988,100995,2201.693473,27,13,0,14,2,Eduardo Masso
2009,101868,2201.693057,2,1,0,1,24,Dick Norman
1989,100947,2201.690585,10,5,0,5,21,Doug Burke
1999,102869,2201.667224,33,14,0,19,7,Galo Blanco
2002,102565,2201.662684,9,4,0,5,3,Alexander Waske
1990,100587,2201.659569,8,4,0,4,10,Steve Guy
2004,104098,2201.65392,29,12,0,17,11,Dmitry Tursunov
1988,100866,2201.636538,4,2,0,2,10,Shahar Perkiss
2006,104166,2201.633216,4,2,0,2,31,Alex Bogomolov Jr
2000,103158,2201.630487,2,1,0,1,2,Johan Ortegren
2005,104907,2201.626784,2,1,0,1,8,Jose Rubin Statham
2008,104395,2201.62676,4,2,0,2,8,Marcel Felder
2015,105182,2201.622122,4,2,0,2,19,Antso Rakotondramanga
1990,101730,2201.613854,2,1,0,1,5,Piet Norval
1996,103344,2201.601931,2,1,0,1,14,Ivan Ljubicic
1991,101812,2201.597925,2,1,0,1,7,Raviv Weidenfeld
2007,105122,2201.595912,2,1,0,1,9,Karlis Lejnieks
2008,104673,2201.595902,4,2,0,2,8,Julio Cesar Campozano
2013,103499,2201.593221,4,2,0,2,34,Aqeel Khan
2013,104907,2201.586956,2,1,0,1,11,Jose Rubin Statham
1991,101250,2201.583894,4,2,0,2,4,Jose Daher
1993,101504,2201.583462,2,1,0,1,43,Laurent Prades
2015,106234,2201.574618,2,1,0,1,6,Aslan Karatsev
1985,101485,2201.571302,2,1,0,1,43,Tanakorn Srichaphan
1987,101485,2201.571302,2,1,0,1,33,Tanakorn Srichaphan
1989,110833,2201.571302,2,1,0,1,43,Huang Jung Hsu
1991,100792,2201.571302,4,2,0,2,34,Adrian Marcu
2012,105961,2201.571302,2,1,0,1,35,David Souto
2015,105626,2201.571302,4,2,0,2,19,Takanyi Garanganga
1998,102205,2201.570428,41,20,0,21,2,Sebastien Lareau
2006,103594,2201.569916,29,13,0,16,3,Oliver Marach
1994,102644,2201.567363,2,1,0,1,3,Franco Squillari
1985,101064,2201.566584,2,1,0,1,43,David Lewis
2012,105497,2201.565707,2,1,0,1,11,Jose Hernandez
2009,104907,2201.565252,4,2,0,2,11,Jose Rubin Statham
1985,100403,2201.558382,8,4,0,4,30,Rolf Gehring
1986,101018,2201.552608,2,1,0,1,27,Edoardo Mazza
2000,102233,2201.548243,13,7,0,6,8,Leander Paes
1985,100841,2201.546483,2,1,0,1,31,Jin Sun Yoo
2003,103169,2201.532921,8,4,0,4,7,Oscar Hernandez
2008,105032,2201.528619,2,1,0,1,21,Samuel Groth
2009,104395,2201.522923,2,1,0,1,11,Marcel Felder
1993,101596,2201.521835,4,2,0,2,11,Mohamed Ridaoui
2001,102433,2201.519102,2,1,0,1,27,Mose Navarra
2002,102843,2201.51337,4,2,0,2,31,Suwandi Suwandi
2004,103761,2201.506285,2,1,0,1,36,Tomas Cakl
2004,102836,2201.495535,2,1,0,1,7,Rogier Wassen
1995,102543,2201.487976,4,2,0,2,10,Chia Yen Tsai
1987,101236,2201.475563,4,2,0,2,22,Krassimir Lazarov
1991,101591,2201.475135,6,3,0,3,13,Danny Sapsford
1993,102233,2201.473507,10,4,0,6,9,Leander Paes
1999,101416,2201.472963,4,2,0,2,9,Joao Cunha Silva
1999,102629,2201.470375,2,1,0,1,22,Oscar Burrieza
2005,104548,2201.464692,5,2,0,3,10,Brian Baker
1996,101900,2201.460654,32,15,0,17,1,Nicklas Kulti
1986,107480,2201.457043,2,1,0,1,42,Karel Demuynck
2014,105572,2201.453007,2,1,0,1,18,Austin Krajicek
1988,101499,2201.444278,2,1,0,1,28,Eduardo Furusho
2010,104945,2201.44371,4,2,0,2,22,James Mcgee
2000,103248,2201.438424,34,17,0,17,2,Harel Levy
1988,100841,2201.433585,4,2,0,2,14,Jin Sun Yoo
2000,102982,2201.404259,6,3,0,3,8,Yaoki Ishii
2012,104976,2201.387273,20,9,0,11,22,Ryan Sweeting
1998,101462,2201.380168,6,3,0,3,31,Francisco Roig
2013,104736,2201.379614,2,1,0,1,34,Farrukh Dustov
1994,101473,2201.372817,7,3,0,4,7,Jozsef Krocsko
2009,103063,2201.365244,10,5,0,5,10,Sebastien De Chaunac
1987,108469,2201.344095,2,1,0,1,46,Victor Caldarelli
1991,100943,2201.334541,2,1,0,1,37,Girts Dzelde
1995,101809,2201.32662,38,18,0,20,4,Nicolas Pereira
1995,101320,2201.321542,22,11,0,11,3,Magnus Gustafsson
1996,101904,2201.316854,2,1,0,1,23,Chris Haggard
1994,101500,2201.295656,4,2,0,2,7,Christian Saceanu
1985,101006,2201.295243,2,1,0,1,14,Bruno Dadillon
1994,102851,2201.294235,2,1,0,1,24,Giorgio Galimberti
2004,103936,2201.290669,2,1,0,1,18,Todor Enev
1996,102077,2201.285595,4,2,0,2,19,Alexander Shvec
2002,104043,2201.279749,4,2,0,2,16,Marc Lopez
1998,103280,2201.269179,2,1,0,1,15,Martin Verkerk
1993,108043,2201.266031,2,1,0,1,41,Ralph Kok
1988,100694,2201.252504,2,1,0,1,28,Eric Riley
2007,104665,2201.249484,7,3,0,4,18,Pablo Andujar
2008,103448,2201.230107,2,1,0,1,28,Gabriel Trujillo Soler
2014,106186,2201.217677,2,1,0,1,24,Jason Kubler
1985,100794,2201.215286,2,1,0,1,10,Srinivasan Vasudevan
1992,101279,2201.211775,2,1,0,1,24,Philippe Pech
2012,103868,2201.204375,2,1,0,1,31,Ivan Navarro
1996,102179,2201.203986,2,1,0,1,16,Antony Dupuis
2013,103656,2201.200685,37,18,0,19,5,Albert Montanes
2010,104098,2201.190014,15,6,0,9,4,Dmitry Tursunov
1990,101380,2201.178415,2,1,0,1,5,Amit Naor
1990,101561,2201.175562,6,3,0,3,13,Nicklas Utgren
2008,104592,2201.173653,2,1,0,1,20,Ilija Bozoljac
1988,101005,2201.172712,2,1,0,1,22,Gerald Marzenell
1989,101420,2201.162665,2,1,0,1,19,Vaclav Roubicek
1996,101822,2201.156792,2,1,0,1,38,Luis Lobo
1988,101735,2201.148917,10,5,0,5,10,Richard Fromberg
2005,103007,2201.139682,6,3,0,3,8,Mounir El Aarej
2000,103824,2201.13868,2,1,0,1,37,Orest Tereshchuk
1988,107058,2201.138433,2,1,0,1,28,Gary Drake
2015,105271,2201.123328,4,2,0,2,11,Gonzalo Escobar
2014,105413,2201.121912,2,1,0,1,16,Andrej Martin
2005,102854,2201.11517,19,9,0,10,16,Sjeng Schalken
2009,102703,2201.107626,4,2,0,2,21,Hyung Taik Lee
2003,102512,2201.107208,2,1,0,1,41,Joseph Sirianni
2011,104023,2201.105776,2,1,0,1,11,Nicolas Renavand
2009,104676,2201.10475,44,22,0,22,2,Andreas Beck
1993,102903,2201.101135,2,1,0,1,7,Eyal Erlich
2000,103045,2201.100789,2,1,0,1,36,Reginald Willems
1986,107485,2201.087498,2,1,0,1,22,Ke Qin Ma
2002,101723,2201.079375,16,8,0,8,6,Magnus Larsson
2013,105278,2201.072029,4,2,0,2,34,Alexis Klegou
2007,104979,2201.070628,2,1,0,1,3,Andrey Golubev
2007,105009,2201.069217,4,2,0,2,35,Elbert Sie
1996,101563,2201.067256,4,2,0,2,34,Joseph Lizardo
2015,104499,2201.067256,2,1,0,1,11,Jimmy Wang
1996,101409,2201.064983,6,3,0,3,43,Jaime Yzaga
2015,105826,2201.064393,2,1,0,1,18,Alejandro Gomez GB42
1985,108817,2201.057123,2,1,0,1,43,Konstantin Pugaev
1987,101337,2201.054381,2,1,0,1,19,Martin Strelba
2003,103737,2201.053906,2,1,0,1,36,Edgardo Massa
1986,101295,2201.048588,2,1,0,1,32,Toshihisa Tsuchihashi
1994,101238,2201.048588,4,2,0,2,19,Andres Vysand
2002,104051,2201.048588,2,1,0,1,8,Andrej Kracman
2005,103229,2201.048588,2,1,0,1,17,Kornel Bardoczky
2009,105912,2201.048588,4,2,0,2,21,Diego Galeano
2013,105286,2201.048588,2,1,0,1,43,Greg Jones
1986,100955,2201.047008,2,1,0,1,44,Yahiya Doumbia
1987,101051,2201.047008,2,1,0,1,28,Oleksandr Dolgopolov
1987,107928,2201.047008,2,1,0,1,54,Pat Serret
1987,110782,2201.047008,2,1,0,1,44,Djamel Boudjemline
1988,106615,2201.047008,2,1,0,1,34,Bernard Balleret
1989,101605,2201.047008,2,1,0,1,43,Jiu Hua Zhang
1989,110827,2201.047008,2,1,0,1,43,Sunny Liu
1989,110901,2201.047008,2,1,0,1,28,Samson Ahinakwa
1991,106811,2201.047008,2,1,0,1,42,Daniel Heryanto
1991,110929,2201.047008,4,2,0,2,42,Salvador Colvee
1992,100619,2201.047008,2,1,0,1,19,George Kalovelonis
1992,108615,2201.047008,4,2,0,2,35,Genaro Deleon
1992,110813,2201.047008,4,2,0,2,35,Rafael Moreno
1998,101563,2201.047008,4,2,0,2,18,Joseph Lizardo
1998,103170,2201.047008,2,1,0,1,18,Wei Ju Chen
2000,102103,2201.047008,2,1,0,1,50,Michael Sell
2003,108679,2201.047008,2,1,0,1,31,Jose Bernard
2004,103395,2201.047008,2,1,0,1,31,Julio Silva
2004,104479,2201.047008,2,1,0,1,31,Sarvar Ikramov
2007,108939,2201.047008,4,2,0,2,35,Rasid Winklaar
2010,104702,2201.047008,4,2,0,2,22,Michael Leong
2010,105367,2201.047008,2,1,0,1,22,Daniel Alejandro Lopez Cassaccia
2011,105961,2201.047008,2,1,0,1,21,David Souto
2011,108768,2201.047008,2,1,0,1,21,Gabriel Flores Ruiz
2015,120792,2201.047008,2,1,0,1,20,M Abid Ali Khan Akbar
1993,102227,2201.041688,2,1,0,1,16,Sargis Sargsian
1985,101285,2201.035809,6,3,0,3,1,Thierry Champion
1988,101110,2201.029964,2,1,0,1,38,David De Miguel
2009,102563,2201.028681,2,1,0,1,38,Thomas Johansson
2004,104154,2201.028245,2,1,0,1,31,Paul Capdeville
2015,103812,2201.025788,2,1,0,1,35,Victor Hanescu
1993,101884,2201.023011,4,2,0,2,21,Frank Ofori
1992,101143,2201.018101,5,2,0,3,18,Branislav Stankovic
1995,101626,2201.015756,2,1,0,1,33,Stephen Noteboom
2006,102851,2201.01016,2,1,0,1,30,Giorgio Galimberti
2009,103735,2201.009359,2,1,0,1,11,Lovro Zovko
1995,106882,2201.007005,2,1,0,1,20,Dimitri Muzyka
2000,102467,2201.006621,4,2,0,2,37,Fazaluddin Syed
1985,106531,2201.003737,2,1,0,1,20,Andrei Dirzu
1995,103151,2201.0025,4,2,0,2,3,Mariano Zabaleta
1987,100930,2200.997013,20,9,0,11,4,Paul Vojtischek
2007,102959,2200.986482,2,1,0,1,19,Marko Tkalec
2008,104593,2200.984756,14,7,0,7,18,Daniel Gimeno Traver
2004,103439,2200.981373,2,1,0,1,31,Dimitri Mazur
2008,102967,2200.977,45,21,0,24,2,Marc Gicquel
2006,104349,2200.97161,2,1,0,1,36,Rui Machado
1991,108548,2200.967274,2,1,0,1,20,Yakubu Suleiman
1993,100896,2200.964029,6,3,0,3,21,Miguel Nido
1989,108686,2200.96401,2,1,0,1,43,Alejandro Aramburu Acuna
2001,102227,2200.963379,37,17,0,20,3,Sargis Sargsian
2002,103165,2200.961429,2,1,0,1,18,Gorka Fraile
2001,102061,2200.960558,2,1,0,1,9,Kevin Ullyett
1993,102061,2200.953811,4,2,0,2,14,Kevin Ullyett
1992,101691,2200.94047,2,1,0,1,15,Florian Krumrey
2005,103590,2200.931344,2,1,0,1,17,Michael Quintero
2015,103401,2200.929678,4,2,0,2,21,Jan Hernych
2013,106100,2200.919595,4,2,0,2,11,Micke Kontinen
1999,101820,2200.918822,54,27,0,27,2,Marc Rosset
1991,102169,2200.910907,2,1,0,1,13,Michael Joyce
1990,101234,2200.909645,45,23,0,22,1,Patrik Kuhnen
1987,100932,2200.909154,2,1,0,1,15,Denys Maasdorp
2008,103204,2200.908834,2,1,0,1,30,Hugo Armando
2000,102863,2200.908488,2,1,0,1,8,Takao Suzuki
2011,105676,2200.907172,4,2,0,2,10,David Goffin
2014,104476,2200.891702,2,1,0,1,18,Louk Sorensen
2014,105678,2200.888077,2,1,0,1,23,Axel Michon
1985,101295,2200.85705,2,1,0,1,10,Toshihisa Tsuchihashi
2012,104619,2200.856887,4,2,0,2,40,Jesse Huta Galung
1999,101866,2200.856142,2,1,0,1,9,David Rikl
1998,101613,2200.849779,21,10,0,11,11,Malivai Washington
2004,103393,2200.847421,2,1,0,1,17,Yuri Schukin
1998,101750,2200.842873,6,3,0,3,17,Cristiano Caratti
2006,104515,2200.840299,2,1,0,1,22,Mathieu Montcourt
2006,103424,2200.82373,4,2,0,2,3,Tobias Clemens
2005,103530,2200.814273,2,1,0,1,15,Zack Fleishman
1994,101955,2200.791314,6,3,0,3,36,Luis Herrera
1990,101429,2200.78863,2,1,0,1,20,Stephane Grenier
2009,105226,2200.768255,4,2,0,2,21,Attila Balazs
1996,101954,2200.766785,2,1,0,1,34,Oscar Bustos
2006,102998,2200.766448,2,1,0,1,14,Jan Michael Gambill
1991,101917,2200.765533,11,5,0,6,13,Grant Stafford
1994,101149,2200.762204,2,1,0,1,39,Morten Christensen
1985,100944,2200.754478,8,3,0,5,16,Mikael Pernfors
1987,101730,2200.752343,2,1,0,1,10,Piet Norval
2005,103746,2200.749883,4,2,0,2,17,Miguel Gallardo Valles
1993,101058,2200.732533,2,1,0,1,35,Francisco Yunis
1996,101888,2200.723006,58,26,0,32,3,Daniel Vacek
2008,102999,2200.713199,2,1,0,1,20,Stefano Galvani
1998,101358,2200.702271,15,7,0,8,5,Olivier Delaitre
1990,100945,2200.691904,2,1,0,1,23,Craig Campbell
2006,104851,2200.672948,2,1,0,1,7,Gianluca Naso
1991,101030,2200.670098,70,39,0,31,0,Goran Prpic
1997,101931,2200.666516,2,1,0,1,18,Marcus Hilpert
2008,104639,2200.653244,30,14,0,16,6,Wayne Odesnik
2008,104292,2200.633735,2,1,0,1,17,Izak Van Der Merwe
2009,103852,2200.633655,41,17,0,24,2,Feliciano Lopez
1987,101031,2200.632433,6,3,0,3,13,Massimo Cierro
2000,103270,2200.632063,2,1,0,1,16,Kristian Capalik
2006,103393,2200.630658,2,1,0,1,18,Yuri Schukin
2013,104586,2200.615012,50,23,0,27,3,Lukas Rosol
2011,104736,2200.615,2,1,0,1,21,Farrukh Dustov
2004,103586,2200.613953,2,1,0,1,8,Mariusz Fyrstenberg
2004,103077,2200.607369,4,2,0,2,8,Konstantinos Economidis
2002,102443,2200.597875,2,1,0,1,19,Barry Cowan
1985,101377,2200.589387,2,1,0,1,6,Christian Bergstrom
1995,100284,2200.580138,4,2,0,2,17,Jimmy Connors
2006,104569,2200.570292,6,3,0,3,8,Lado Chikhladze
2007,105671,2200.566397,2,1,0,1,9,Gastao Elias
2003,103659,2200.56491,2,1,0,1,8,Wei Jen Cheng
1987,101034,2200.563546,2,1,0,1,35,Bobby Banck
2001,102131,2200.563334,4,2,0,2,33,Alistair Hunt
2003,103118,2200.554911,2,1,0,1,9,Ion Moldovan
1989,100965,2200.549839,5,2,0,3,13,Peter Ballauff
1997,102395,2200.544692,4,2,0,2,10,Ville Liukko
2006,104463,2200.543019,4,2,0,2,8,Dmitriy Makeyev
2006,104557,2200.542774,2,1,0,1,16,Andis Juska
1989,101293,2200.542455,2,1,0,1,12,Ted Scherman
2015,111805,2200.540656,2,1,0,1,19,Seong Chan Hong
1991,100736,2200.539095,2,1,0,1,42,Hugo Nunez
1988,101452,2200.533548,2,1,0,1,21,Greg Failla
1999,103286,2200.529592,2,1,0,1,18,Yohny Romero
1986,106929,2200.524294,2,1,0,1,22,Eiji Takeuchi
1991,111040,2200.524294,2,1,0,1,39,Garth Thomson
1993,108836,2200.524294,4,2,0,2,36,Jayendra Wijeyesekera
1997,102119,2200.524294,2,1,0,1,33,Chih Jung Chen
1998,103229,2200.524294,2,1,0,1,18,Kornel Bardoczky
1999,108588,2200.524294,2,1,0,1,34,Asim Shafik
1999,108595,2200.524294,2,1,0,1,31,Mohammed Reza Tavakoli
2000,103807,2200.524294,2,1,0,1,20,Raimonds Sproga
2000,104063,2200.524294,2,1,0,1,20,Mait Kunnap
2000,108585,2200.524294,2,1,0,1,38,Americo Venero Montes
2000,108601,2200.524294,2,1,0,1,20,Bob Borella
2001,102868,2200.524294,2,1,0,1,18,Jonathan Printzlau
2001,103201,2200.524294,2,1,0,1,33,Adrian Garcia
2001,103590,2200.524294,2,1,0,1,33,Michael Quintero
2001,108602,2200.524294,2,1,0,1,18,Alti Vahkal
2002,102802,2200.524294,2,1,0,1,17,Gunther Darkey
2002,103573,2200.524294,2,1,0,1,17,Rik De Voest
2002,103998,2200.524294,2,1,0,1,31,Mario Monroy
2003,102320,2200.524294,2,1,0,1,31,Lazaro Navarro Batles
2003,108594,2200.524294,2,1,0,1,31,Johnny Arcilla
2003,108640,2200.524294,2,1,0,1,17,Mik Ledvonova
2004,102655,2200.524294,2,1,0,1,18,Jimy Szymanski
2004,103699,2200.524294,2,1,0,1,40,Fred Hemmes
2004,108915,2200.524294,2,1,0,1,31,Luis Haddock
2004,108924,2200.524294,2,1,0,1,31,Jing Yi Li
2005,102233,2200.524294,2,1,0,1,26,Leander Paes
2005,103920,2200.524294,2,1,0,1,8,Sanchai Ratiwatana
2005,108941,2200.524294,2,1,0,1,17,Damar Johnson
2006,103066,2200.524294,2,1,0,1,36,Mark Nielsen
2006,104826,2200.524294,2,1,0,1,30,Federico Sansonetti
2006,108945,2200.524294,2,1,0,1,30,Juan Sebastian Langton
2007,104368,2200.524294,2,1,0,1,41,Daniel King Turner
2007,104658,2200.524294,4,2,0,2,9,Gustavo Ramirez
2007,108979,2200.524294,2,1,0,1,35,Benito Jose Suriano
2008,102558,2200.524294,2,1,0,1,31,Eric Taino
2008,104887,2200.524294,2,1,0,1,31,Piero Luisi
2009,104789,2200.524294,2,1,0,1,21,Sherif Sabry
2009,108693,2200.524294,2,1,0,1,21,Romano Tatuhey
2010,108713,2200.524294,2,1,0,1,22,Julen Uriguen
2011,106220,2200.524294,2,1,0,1,21,Dimitar Kuzmanov
2012,104763,2200.524294,2,1,0,1,35,Rafael Arevalo
2012,104775,2200.524294,2,1,0,1,35,Adam Kellner
2012,105334,2200.524294,2,1,0,1,35,Luis David Martinez
2013,105935,2200.524294,2,1,0,1,34,Duilio Beretta
2013,106232,2200.524294,2,1,0,1,11,Roberto Cid
2014,103746,2200.524294,2,1,0,1,32,Miguel Gallardo Valles
2014,104763,2200.524294,2,1,0,1,32,Rafael Arevalo
2014,105899,2200.524294,2,1,0,1,9,Martin Cuevas
2014,106136,2200.524294,2,1,0,1,32,Warit Sornbutnark
2014,122687,2200.524294,2,1,0,1,9,Rodrigo Senattore
1986,107827,2200.522715,2,1,0,1,39,Moncef Zehar
2013,103746,2200.522715,2,1,0,1,34,Miguel Gallardo Valles
1997,102154,2200.522658,29,13,0,16,2,Marcos Ondruska
1992,101484,2200.520838,4,2,0,2,7,Vladimir Gabrichidze
1986,101174,2200.518444,2,1,0,1,2,Fernando Roese
1997,102506,2200.510323,4,2,0,2,17,Quino Munoz
1986,101251,2200.508579,2,1,0,1,28,Eric Winogradsky
2000,103400,2200.504013,2,1,0,1,9,Hendri Susilo Pramono
2006,104655,2200.504011,2,1,0,1,30,Pablo Cuevas
2001,108628,2200.503923,2,1,0,1,18,Jhonnatan Medina Alvarez
2014,103529,2200.502524,2,1,0,1,9,Aisam Ul Haq Qureshi
2011,104592,2200.497209,2,1,0,1,26,Ilija Bozoljac
2008,105573,2200.491937,2,1,0,1,17,Henri Kontinen
1996,101600,2200.488903,4,2,0,2,23,Daniel Courcol
1996,102078,2200.485726,4,2,0,2,28,Jorge Gonzalez
2009,104392,2200.48566,6,3,0,3,26,Franco Ferreiro
1994,101840,2200.484398,4,2,0,2,36,Jacobo Chavez
1994,108583,2200.484398,4,2,0,2,36,Daniel Chavez Morales
2006,104368,2200.483616,4,2,0,2,30,Daniel King Turner
1985,100792,2200.483341,4,2,0,2,12,Adrian Marcu
1985,100918,2200.482945,2,1,0,1,10,Harald Rittersbacher
1999,103525,2200.477991,2,1,0,1,18,Ivan Miranda
1999,108686,2200.477991,2,1,0,1,18,Alejandro Aramburu Acuna
1999,101495,2200.472086,2,1,0,1,34,Miguel Tobon
2014,103573,2200.471431,4,2,0,2,32,Rik De Voest
2013,105656,2200.468934,4,2,0,2,11,Marcelo Arevalo
2003,102910,2200.467378,2,1,0,1,28,Salvador Navarro
1991,101278,2200.466519,2,1,0,1,37,Scott Melville
2006,103999,2200.464897,6,3,0,3,10,Thiago Alves
2012,104678,2200.464665,56,27,0,29,3,Viktor Troicki
2010,104948,2200.463321,2,1,0,1,44,Petar Jelenic
1998,103019,2200.461994,2,1,0,1,9,Evgeni Mikheev
2011,106150,2200.458582,2,1,0,1,12,Jeson Patrombon
1993,102010,2200.455077,2,1,0,1,35,Clinton Marsh
2005,104268,2200.454994,4,2,0,2,14,Alejandro Falla
1997,102201,2200.449547,43,18,0,25,2,Lionel Roux
1998,102667,2200.439142,2,1,0,1,31,Satoshi Iwabuchi
1997,101938,2200.435326,4,2,0,2,10,Bernardo Mota
1985,100144,2200.424547,2,1,0,1,45,Robert Lutz
2013,104068,2200.423647,4,2,0,2,33,Robby Ginepri
1992,101780,2200.418658,4,2,0,2,5,Alejo Mancisidor
1998,102737,2200.401201,2,1,0,1,9,Gergely Kisgyorgy
2002,104386,2200.397778,2,1,0,1,17,Janko Tipsarevic
1997,101947,2200.387499,2,1,0,1,11,Vincenzo Santopadre
1987,101439,2200.384549,37,17,0,20,2,Javier Sanchez
1996,103170,2200.379452,2,1,0,1,34,Wei Ju Chen
2000,103739,2200.375558,4,2,0,2,20,Jose De Armas
1998,103632,2200.364376,2,1,0,1,28,Luis Horna
1999,103066,2200.359585,6,3,0,3,9,Mark Nielsen
2011,104869,2200.352713,7,3,0,4,6,Sergei Bubka
1986,101334,2200.351181,2,1,0,1,10,Alexander Volkov
1987,100546,2200.347232,2,1,0,1,35,Eric Fromm
2007,102615,2200.338187,2,1,0,1,39,Dennis Van Scheppingen
2012,104467,2200.335901,2,1,0,1,34,Lamine Ouahab
1993,102881,2200.328755,2,1,0,1,18,David Skoch
2001,104082,2200.31798,2,1,0,1,7,Hiroki Kondo
2006,104890,2200.313248,2,1,0,1,15,Andreas Haider Maurer
1999,102036,2200.308016,4,2,0,2,18,Marco Osorio
2008,104251,2200.284096,4,2,0,2,31,Ti Chen
1986,100852,2200.282055,2,1,0,1,21,Howard Herr
2004,103296,2200.2813,2,1,0,1,18,Ivaylo Traykov
2004,103666,2200.2813,2,1,0,1,18,Ilia Kushev
1987,107485,2200.270438,6,3,0,3,22,Ke Qin Ma
1987,101131,2200.268523,21,10,0,11,13,Jimmy Brown
1989,101225,2200.257585,2,1,0,1,13,Jens Peter
2005,103455,2200.252746,12,6,0,6,0,Michal Mertinak
1998,102650,2200.248374,2,1,0,1,31,Roberto Carretero
2011,103976,2200.246045,2,1,0,1,40,Juan Pablo Brzezicki
2008,103238,2200.236086,2,1,0,1,7,Jean Claude Scherrer
2005,103403,2200.234263,2,1,0,1,6,Takahiro Terachi
1987,101731,2200.230533,6,3,0,3,22,Nuno Marques
1999,102558,2200.230418,3,1,0,2,12,Eric Taino
1999,103638,2200.213056,2,1,0,1,18,Jhonson Garcia
1996,101577,2200.21274,6,3,0,3,7,Jia Ping Xia
2007,104719,2200.210247,4,2,0,2,32,Marcel Granollers
1985,101066,2200.205334,2,1,0,1,16,Richard Matuszewski
1992,101716,2200.197835,2,1,0,1,34,Javier Molina
1996,101800,2200.187679,2,1,0,1,17,Daniele Balducci
1997,102756,2200.186175,2,1,0,1,3,Eduardo Rincon
2006,103638,2200.17821,4,2,0,2,8,Jhonson Garcia
2003,102469,2200.162043,2,1,0,1,8,Solon Peppas
2007,103205,2200.15716,2,1,0,1,9,Emilio Daniel Baez Britez
2010,105148,2200.155233,2,1,0,1,22,Hsin Han Lee
1986,101402,2200.141601,2,1,0,1,8,Stephen Furlong
2000,103337,2200.130076,6,3,0,3,7,Ben Qiang Zhu
1989,101510,2200.129627,2,1,0,1,26,Henrik Holm
1989,101058,2200.104041,9,4,0,5,14,Francisco Yunis
1988,100434,2200.096395,42,18,0,24,2,Tomas Smid
1995,102519,2200.095872,2,1,0,1,32,Marcio Carlsson
2005,103506,2200.088157,2,1,0,1,36,Martin Vassallo Arguello
1985,100776,2200.077604,2,1,0,1,28,Tomm Warneke
1999,102494,2200.072853,2,1,0,1,10,Tomas Behrend
2006,104001,2200.067294,2,1,0,1,35,Brian Wilson
2015,104330,2200.057863,13,7,0,6,6,Rajeev Ram
1993,108615,2200.044963,4,2,0,2,36,Genaro Deleon
2002,102131,2200.040744,2,1,0,1,31,Alistair Hunt
1987,100947,2200.040683,4,2,0,2,46,Doug Burke
1987,100910,2200.039455,3,1,0,2,21,Magnus Tideman
1991,101823,2200.037466,4,2,0,2,6,Gerald Mandl
1992,102147,2200.036982,4,2,0,2,35,Oliver Fernandez
2003,104081,2200.033507,4,2,0,2,8,Boris Pashanski
1989,101138,2200.032889,8,4,0,4,40,Pat Cash
2005,102969,2200.030932,2,1,0,1,8,Sergei Yaroshenko
1991,102344,2200.025616,2,1,0,1,16,Karol Kucera
2005,104167,2200.024289,2,1,0,1,38,Todd Widom
2001,102477,2200.022744,2,1,0,1,42,Gaston Etlis
1988,100617,2200.020372,4,2,0,2,50,Bud Schultz
2010,105311,2200.020372,2,1,0,1,11,Joao Sousa
2003,102873,2200.01958,2,1,0,1,31,Rob Cheyne
1993,102035,2200.017118,14,6,0,8,3,Jonas Bjorkman
1997,101868,2200.006282,8,4,0,4,14,Dick Norman
2015,104810,2200.000789,2,1,0,1,11,Zhe Li
1985,100179,2200,2,1,0,1,50,Karl Meiler
1985,100630,2200,2,1,0,1,44,Gustavo Guerrero
1985,100636,2200,2,1,0,1,44,Gustavo Tiberti
1985,100798,2200,2,1,0,1,50,Howard Sands
1985,101406,2200,2,1,0,1,31,Wojtek Kowalski
1985,101686,2200,2,1,0,1,44,Franco Davin
1985,106506,2200,2,1,0,1,31,Alkis Papamichael
1985,107680,2200,4,2,0,2,43,Mark Bailey
1985,108431,2200,2,1,0,1,31,Tony Jonsson
1985,108487,2200,2,1,0,1,31,Waldemar Rogowski
1985,110782,2200,2,1,0,1,31,Djamel Boudjemline
1985,110979,2200,2,1,0,1,49,Mahader Hassan
1986,100522,2200,2,1,0,1,47,Chris Dunk
1986,100616,2200,2,1,0,1,48,Andy Kohlberg
1986,100638,2200,2,1,0,1,50,David Mustard
1986,106580,2200,2,1,0,1,44,Arjun Fernando
1986,106782,2200,2,1,0,1,44,Colin Grant
1986,107181,2200,2,1,0,1,32,Haseeb Aslam
1986,107232,2200,2,1,0,1,49,Inaki Calvo
1986,107837,2200,2,1,0,1,44,NA Sulistyono
1986,108469,2200,2,1,0,1,49,Victor Caldarelli
1986,108844,2200,2,1,0,1,44,Hamed Ul Haq
1986,110990,2200,2,1,0,1,44,Rodrigo Rafael
1987,100337,2200,2,1,0,1,53,Mark Edmondson
1987,100761,2200,2,1,0,1,53,Danny Saltz
1987,106442,2200,2,1,0,1,51,Abdul Khalek Nadini
1987,107117,2200,2,1,0,1,34,Gordon Asciak
1987,107473,2200,2,1,0,1,46,Justedjo Tarik
1987,107824,2200,2,1,0,1,51,Mohamed Dlimi
1987,108373,2200,2,1,0,1,44,Thierno Ly
1988,100280,2200,2,1,0,1,46,Wojtek Fibak
1988,100769,2200,2,1,0,1,47,Mario Martinez
1988,100795,2200,2,1,0,1,47,Alvaro Jordan
1988,101003,2200,2,1,0,1,49,Ricardo Acioly
1988,101121,2200,2,1,0,1,34,Alaaddin Karagoz
1988,101216,2200,2,1,0,1,34,Olli Rahnasto
1988,101615,2200,2,1,0,1,49,Otavio Della
1988,101884,2200,2,1,0,1,47,Frank Ofori
1988,107213,2200,2,1,0,1,34,Houcine Saber
1988,108056,2200,2,1,0,1,39,Reda Galou
1988,108373,2200,2,1,0,1,34,Thierno Ly
1988,110818,2200,2,1,0,1,39,Shovon Jamaly
1988,110855,2200,2,1,0,1,39,Dawood Dawoodian
1989,100323,2200,2,1,0,1,52,Givaldo Barbosa
1989,100796,2200,2,1,0,1,43,Ahmed El Mehelmy
1989,101483,2200,2,1,0,1,52,Ricardo Camargo
1989,101580,2200,2,1,0,1,56,Roger Rasheed
1989,101601,2200,2,1,0,1,56,Brett Steven
1989,101647,2200,2,1,0,1,53,Byron Black
1989,101662,2200,2,1,0,1,53,Selvam Veerasingam
1989,107310,2200,2,1,0,1,42,Jean Nabi
1989,107481,2200,2,1,0,1,53,Karl Hale
1989,110819,2200,2,1,0,1,53,Ali Kadhim
1989,110821,2200,2,1,0,1,53,Kadhim Kadhim
1989,110834,2200,2,1,0,1,53,Oscar Blacutt
1989,110841,2200,2,1,0,1,53,Hervoje Eterovic
1989,110855,2200,2,1,0,1,53,Dawood Dawoodian
1989,110888,2200,2,1,0,1,42,Jean Jacques Kouassi
1990,100918,2200,2,1,0,1,34,Harald Rittersbacher
1990,101009,2200,2,1,0,1,34,John Sobel
1990,101252,2200,2,1,0,1,31,Brian Page
1991,100947,2200,2,1,0,1,50,Doug Burke
1991,101121,2200,4,2,0,2,25,Alaaddin Karagoz
1991,101417,2200,2,1,0,1,50,Mario Rincon
1991,101802,2200,2,1,0,1,31,Ramayah Ramachandran
1991,102033,2200,2,1,0,1,32,Abdelhak Hameurlaine
1991,102314,2200,2,1,0,1,50,Rodrigo Navarro
1991,106987,2200,2,1,0,1,34,Fadel Berthe
1991,107764,2200,2,1,0,1,32,Mehdi Benyebka
1991,108583,2200,2,1,0,1,50,Daniel Chavez Morales
1991,108733,2200,2,1,0,1,50,Jose Medrano
1991,108751,2200,2,1,0,1,31,Bader Mohammed Almuqail
1991,110866,2200,2,1,0,1,34,Christopher Gatt
1991,110890,2200,2,1,0,1,50,Lionel Kemajou
1992,100792,2200,2,1,0,1,44,Adrian Marcu
1992,101156,2200,4,2,0,2,35,Juan Pino
1992,101630,2200,2,1,0,1,29,Clement Ngoran
1992,101802,2200,4,2,0,2,35,Ramayah Ramachandran
1992,101969,2200,2,1,0,1,19,Orlin Stanoytchev
1992,101979,2200,2,1,0,1,44,Ricardo Mena
1992,107382,2200,2,1,0,1,44,John Farrington
1992,110815,2200,4,2,0,2,35,Vernon Lewis
1992,110825,2200,4,2,0,2,35,Hira Lal Rahman
1993,100553,2200,2,1,0,1,30,Nduka Odizor
1993,101365,2200,2,1,0,1,36,Paul Wekesa
1993,101620,2200,2,1,0,1,30,Phillipe Ventura
1993,102826,2200,4,2,0,2,36,Muhammad Khaliq Siddiq
1993,108867,2200,2,1,0,1,36,Serge Brueck
1994,101448,2200,2,1,0,1,30,Tasos Bavelas
1994,102243,2200,2,1,0,1,46,Marcelo Charpentier
1994,102685,2200,4,2,0,2,19,Sebastien Graeff
1994,102839,2200,2,1,0,1,43,Nicolas Lapentti
1994,106987,2200,2,1,0,1,19,Fadel Berthe
1994,108595,2200,2,1,0,1,43,Mohammed Reza Tavakoli
1994,108870,2200,2,1,0,1,36,Chee Yen Chen
1994,108871,2200,2,1,0,1,36,Kim Huat Khoo
1994,111067,2200,2,1,0,1,43,Anthony Mills
1995,102246,2200,2,1,0,1,43,Fernando Samayoa
1995,102598,2200,2,1,0,1,30,Nouhoun Sangare
1995,102742,2200,4,2,0,2,20,Armand Strombach
1995,108532,2200,4,2,0,2,35,Worapol Thongkamcho
1995,108849,2200,4,2,0,2,35,Rohan De Silva
1996,100943,2200,4,2,0,2,19,Girts Dzelde
1996,102538,2200,2,1,0,1,34,Tuomas Ketola
1997,101781,2200,2,1,0,1,44,Robert Angelo
1997,102078,2200,2,1,0,1,44,Jorge Gonzalez
1997,102335,2200,2,1,0,1,28,Taso Vasiliadis
1997,102436,2200,2,1,0,1,28,Borut Urh
1998,101926,2200,2,1,0,1,43,Andrei Merinov
1998,102279,2200,2,1,0,1,27,Gehad El Deeb
1998,103066,2200,2,1,0,1,45,Mark Nielsen
1998,103148,2200,2,1,0,1,27,Norbert Mazany
1998,108582,2200,2,1,0,1,34,Luis Perez Chete
1998,108800,2200,2,1,0,1,18,Alexander Lehnhoff
1999,102335,2200,2,1,0,1,18,Taso Vasiliadis
1999,102903,2200,2,1,0,1,34,Eyal Erlich
1999,103296,2200,2,1,0,1,18,Ivaylo Traykov
1999,103659,2200,2,1,0,1,34,Wei Jen Cheng
1999,108621,2200,2,1,0,1,31,Seyed Akbar Taheri Rahaghi
1999,108674,2200,2,1,0,1,34,Jerry Joseph
1999,108855,2200,2,1,0,1,28,Robert Collins
2000,101940,2200,2,1,0,1,33,Rene Busch
2000,102444,2200,2,1,0,1,22,Scott Barron
2000,103402,2200,2,1,0,1,33,Peter Clarke
2000,108594,2200,4,2,0,2,40,Johnny Arcilla
2000,108624,2200,2,1,0,1,47,Hazuan Hizan
2000,108651,2200,2,1,0,1,47,Sandor Martinez Breijo
2001,100754,2200,2,1,0,1,40,Rafael Avalos Brenes
2001,103638,2200,2,1,0,1,40,Jhonson Garcia
2001,103997,2200,2,1,0,1,29,Lukasz Kubot
2002,101957,2200,2,1,0,1,26,Milen Velev
2002,101989,2200,2,1,0,1,17,Patrik Langvardt
2002,102320,2200,2,1,0,1,31,Lazaro Navarro Batles
2002,103102,2200,2,1,0,1,31,John Hui
2002,103197,2200,2,1,0,1,17,John Doran
2002,108651,2200,2,1,0,1,31,Sandor Martinez Breijo
2003,101810,2200,2,1,0,1,39,Asif Ismail
2003,101976,2200,2,1,0,1,31,Federico Dondo
2003,102055,2200,2,1,0,1,31,Bertrand Madsen
2003,103188,2200,2,1,0,1,42,Michael Russell
2003,103296,2200,2,1,0,1,31,Ivaylo Traykov
2003,103986,2200,4,2,0,2,17,Radoslav Lukaev
2003,103997,2200,2,1,0,1,31,Lukasz Kubot
2003,104395,2200,2,1,0,1,39,Marcel Felder
2004,102737,2200,2,1,0,1,31,Gergely Kisgyorgy
2004,103739,2200,2,1,0,1,38,Jose De Armas
2004,103875,2200,2,1,0,1,38,Anoosha Shahgholi
2004,104454,2200,2,1,0,1,31,Murad Inoyatov
2005,103296,2200,2,1,0,1,34,Ivaylo Traykov
2005,103891,2200,2,1,0,1,17,Alexandros Jakupovic
2005,104162,2200,2,1,0,1,17,Deniss Pavlovs
2005,108644,2200,4,2,0,2,17,Patrick Chucri
2006,103427,2200,2,1,0,1,30,Yew Ming Si
2006,104040,2200,2,1,0,1,30,Adam Thompson
2006,104395,2200,2,1,0,1,30,Marcel Felder
2006,104477,2200,2,1,0,1,37,Jorge Aguilar
2006,105009,2200,2,1,0,1,8,Elbert Sie
2006,108593,2200,2,1,0,1,30,Wing Luen Wong
2006,108960,2200,2,1,0,1,30,Michael Lai
2007,104008,2200,2,1,0,1,35,Carlos Avellan
2007,104227,2200,2,1,0,1,34,Augustin Gensse
2007,104775,2200,2,1,0,1,19,Adam Kellner
2007,105081,2200,2,1,0,1,35,Jean Michel Durango
2008,104311,2200,2,1,0,1,8,Leonardo Tavares
2008,104453,2200,2,1,0,1,19,Michael Ryderstedt
2008,104800,2200,2,1,0,1,31,Mauricio Estivariz
2008,105009,2200,2,1,0,1,38,Elbert Sie
2008,105216,2200,2,1,0,1,6,Yuichi Sugita
2009,103472,2200,2,1,0,1,21,Karim Maamoun
2009,103746,2200,2,1,0,1,21,Miguel Gallardo Valles
2009,104569,2200,2,1,0,1,38,Lado Chikhladze
2009,105471,2200,2,1,0,1,21,Cesar Ramirez
2009,108717,2200,2,1,0,1,21,Francis Casey Alcantara
2009,108720,2200,2,1,0,1,38,Eddy Chala
2010,101962,2200,2,1,0,1,47,Younes El Aynaoui
2010,104763,2200,2,1,0,1,22,Rafael Arevalo
2010,108747,2200,2,1,0,1,22,Dineshkanthan Thangarajah
2011,103525,2200,2,1,0,1,21,Ivan Miranda
2011,103746,2200,2,1,0,1,12,Miguel Gallardo Valles
2011,104628,2200,2,1,0,1,45,Alexander Kudryavtsev
2011,104779,2200,2,1,0,1,38,Jamie Baker
2011,104887,2200,2,1,0,1,38,Piero Luisi
2011,105229,2200,2,1,0,1,21,Philip Bester
2011,105541,2200,2,1,0,1,38,Alex Llompart
2012,103529,2200,2,1,0,1,41,Aisam Ul Haq Qureshi
2012,103823,2200,2,1,0,1,46,Denis Gremelmayr
2012,105156,2200,2,1,0,1,42,Federico Zeballos
2012,105367,2200,2,1,0,1,42,Daniel Alejandro Lopez Cassaccia
2012,105909,2200,2,1,0,1,35,Sam Barry
2012,108770,2200,2,1,0,1,42,Nicholas Sayer
2013,104895,2200,2,1,0,1,41,Abdullah Maqdas
2013,105633,2200,2,1,0,1,44,Mohamed Safwat
2013,105909,2200,2,1,0,1,41,Sam Barry
2013,106024,2200,2,1,0,1,34,Dovydas Sakinis
2014,105456,2200,2,1,0,1,40,Sergio Galdos
2014,105707,2200,2,1,0,1,40,Nicolaas Scholtz
2014,106368,2200,2,1,0,1,44,Ramkumar Ramanathan
2014,106392,2200,4,2,0,2,32,Thien Nguyen Hoang
2014,106397,2200,2,1,0,1,32,Wishaya Trongcharoenchaikul
2014,108930,2200,2,1,0,1,32,Juan Carlos Ramirez
2014,111426,2200,2,1,0,1,40,John Morrissey
1995,102549,2199.997093,4,2,0,2,20,Rolandas Murashka
1994,100865,2199.989441,2,1,0,1,27,Marcelo Ingaramo
1987,101003,2199.987132,2,1,0,1,27,Ricardo Acioly
1995,102869,2199.98426,7,3,0,4,3,Galo Blanco
2000,103077,2199.979628,2,1,0,1,9,Konstantinos Economidis
2012,105182,2199.978838,2,1,0,1,35,Antso Rakotondramanga
2000,102549,2199.978812,4,2,0,2,20,Rolandas Murashka
2001,103337,2199.978807,2,1,0,1,9,Ben Qiang Zhu
2001,103296,2199.978274,2,1,0,1,25,Ivaylo Traykov
2013,105641,2199.971697,2,1,0,1,11,Blaz Rola
1995,108427,2199.965499,4,2,0,2,20,Tomasz Lichon
1995,102055,2199.965361,4,2,0,2,35,Bertrand Madsen
2014,106174,2199.963263,4,2,0,2,32,Gonzalo Lama
2001,101938,2199.96233,2,1,0,1,40,Bernardo Mota
2008,105311,2199.960078,4,2,0,2,8,Joao Sousa
2015,104597,2199.959565,38,18,0,20,5,Nicolas Almagro
2006,103286,2199.956271,2,1,0,1,8,Yohny Romero
2011,103893,2199.94816,5,2,0,3,17,Paolo Lorenzi
1990,101448,2199.943516,2,1,0,1,6,Tasos Bavelas
2003,103444,2199.941545,35,16,0,19,3,Jean Rene Lisnard
2001,101727,2199.941264,14,7,0,7,21,Jason Stoltenberg
2006,104736,2199.94061,2,1,0,1,30,Farrukh Dustov
1998,102585,2199.936818,2,1,0,1,36,Sebastian Prieto
1989,110813,2199.936088,4,2,0,2,43,Rafael Moreno
2011,104600,2199.934201,2,1,0,1,12,Treat Conrad Huey
1991,102233,2199.919013,11,6,0,5,10,Leander Paes
2014,106201,2199.918687,6,3,0,3,9,Maxim Dubarenco
1990,102154,2199.917927,6,3,0,3,11,Marcos Ondruska
2008,103668,2199.908733,2,1,0,1,31,Lazar Magdincev
1985,100830,2199.901069,2,1,0,1,10,Gary Donnelly
1987,106695,2199.90073,2,1,0,1,51,Carlos Claverie
1991,101861,2199.899396,6,3,0,3,6,Thomas Buchmayer
1999,103485,2199.898947,2,1,0,1,16,Ivan Beros
1995,102491,2199.886624,9,4,0,5,5,Alex Radulescu
1991,101360,2199.882887,6,3,0,3,12,Mark Keil
1991,101317,2199.875326,2,1,0,1,21,John Sullivan
1994,101214,2199.860668,39,18,0,21,7,Bryan Shelton
1988,101664,2199.847833,4,2,0,2,29,Andras Lanyi
2015,105223,2199.836769,4,2,0,2,34,Juan Martin Del Potro
2000,102780,2199.832956,2,1,0,1,18,Frederic Niemeyer
1991,101534,2199.830151,2,1,0,1,17,Libor Nemecek
2002,103018,2199.825209,54,25,0,29,2,Max Mirnyi
1989,101726,2199.822746,2,1,0,1,9,Boaz Merenstein
2007,103104,2199.81707,2,1,0,1,6,Bjorn Rehnquist
1997,101468,2199.796486,12,6,0,6,18,Gerard Solves
1999,102911,2199.794326,2,1,0,1,2,Andrei Stoliarov
1985,101332,2199.792132,2,1,0,1,10,Gilad Bloom
2006,103978,2199.791101,2,1,0,1,8,Rabie Chaki
2013,105292,2199.785145,8,4,0,4,1,Alejandro Gonzalez
1996,102405,2199.778337,6,3,0,3,33,Mahesh Bhupathi
1988,100989,2199.777204,2,1,0,1,24,Ned Caswell
2006,104224,2199.777201,2,1,0,1,35,Travis Rettenmaier
2005,103544,2199.773684,2,1,0,1,11,Andy Ram
1997,102247,2199.772385,34,14,0,20,2,Andrea Gaudenzi
2009,106026,2199.765824,2,1,0,1,11,Yuki Bhambri
1992,101639,2199.756579,2,1,0,1,8,Lan Bale
2001,101746,2199.747961,2,1,0,1,37,Renzo Furlan
2012,106158,2199.713638,2,1,0,1,35,Suk Young Jeong
2010,104721,2199.71345,9,4,0,5,2,Josselin Ouanna
1993,102610,2199.711236,4,2,0,2,5,Albert Costa
2008,103174,2199.703627,2,1,0,1,5,Noam Okun
2009,105573,2199.700817,6,3,0,3,6,Henri Kontinen
2014,126094,2199.698919,2,1,0,1,4,Andrey Rublev
2009,104775,2199.696086,2,1,0,1,38,Adam Kellner
2003,103877,2199.693749,2,1,0,1,8,Mike Scheidweiler
1988,101961,2199.688769,2,1,0,1,5,Martin Stringari
1999,108615,2199.688571,4,2,0,2,18,Genaro Deleon
2010,102887,2199.687629,6,3,0,3,24,Ramon Delgado
2008,103735,2199.684659,4,2,0,2,35,Lovro Zovko
2006,103529,2199.68101,6,3,0,3,8,Aisam Ul Haq Qureshi
2005,103714,2199.679878,2,1,0,1,18,Andreas Vinciguerra
1997,102457,2199.669606,2,1,0,1,11,Miles Maclagan
1999,108801,2199.661303,2,1,0,1,18,Jorge Catala
2000,104014,2199.654109,2,1,0,1,2,Lee Childs
1999,102574,2199.652786,4,2,0,2,30,Gabriel Trifu
2009,105052,2199.646809,2,1,0,1,38,Chris Eaton
2002,102957,2199.6381,6,3,0,3,9,Vadim Kutsenko
1993,102167,2199.637402,2,1,0,1,34,Juan Albert Viloca Puig
1985,100945,2199.61942,2,1,0,1,10,Craig Campbell
2015,105156,2199.607634,2,1,0,1,19,Federico Zeballos
2007,103893,2199.605184,2,1,0,1,32,Paolo Lorenzi
2011,104907,2199.602642,2,1,0,1,21,Jose Rubin Statham
2012,104368,2199.594577,2,1,0,1,11,Daniel King Turner
2015,124063,2199.584871,2,1,0,1,4,Santiago Maresca
2008,105149,2199.576104,2,1,0,1,17,Reda El Amrani
2006,104467,2199.572857,2,1,0,1,27,Lamine Ouahab
2001,102024,2199.572588,2,1,0,1,38,Hernan Gumy
2012,104857,2199.572321,7,3,0,4,31,Robert Farah
2006,101962,2199.569698,4,2,0,2,33,Younes El Aynaoui
2005,102630,2199.56541,4,2,0,2,17,Slimane Saoudi
2005,104467,2199.56541,4,2,0,2,17,Lamine Ouahab
1994,100984,2199.553874,2,1,0,1,19,Peter Wright
1986,100624,2199.550762,2,1,0,1,34,Derek Tarr
1988,101217,2199.550555,2,1,0,1,38,Andreas Lesch
2012,104499,2199.544331,7,3,0,4,9,Jimmy Wang
2012,104589,2199.542346,2,1,0,1,18,Chris Guccione
2002,101924,2199.53898,2,1,0,1,14,Stefano Pescosolido
2006,103747,2199.537074,2,1,0,1,34,Dominik Meffert
1996,102401,2199.536687,42,18,0,24,3,Scott Draper
1988,100273,2199.535161,2,1,0,1,38,Kim Warwick
1986,100252,2199.534724,8,3,0,5,16,Tim Gullikson
2011,104738,2199.53431,2,1,0,1,42,Caio Zampieri
1992,108161,2199.533702,4,2,0,2,35,Roland So
2000,102131,2199.53369,2,1,0,1,37,Alistair Hunt
2007,102696,2199.526123,2,1,0,1,9,Guillaume Couillard
2006,104007,2199.518516,2,1,0,1,34,Andre Ghem
2014,105633,2199.51645,4,2,0,2,32,Mohamed Safwat
1991,100890,2199.516332,2,1,0,1,20,Rashid Malik
2006,108956,2199.516332,2,1,0,1,8,Jesus Francisco Felix
2012,108776,2199.516332,2,1,0,1,42,Vimuktha De Alwis
2009,106024,2199.505425,2,1,0,1,21,Dovydas Sakinis
1990,101715,2199.502949,2,1,0,1,8,Jose Antonio Pepe Conde
2008,103722,2199.498986,44,20,0,24,2,Florent Serra
2010,104631,2199.497661,4,2,0,2,22,Harshana Godamanna
2007,108947,2199.496078,2,1,0,1,35,West Nott
1991,101871,2199.492532,2,1,0,1,22,Alexander Reichel
2008,103789,2199.480936,2,1,0,1,8,Irakli Labadze
2011,105004,2199.48078,4,2,0,2,21,Dimitar Kutrovsky
2012,105430,2199.478223,4,2,0,2,35,Radu Albot
2012,106201,2199.478223,2,1,0,1,35,Maxim Dubarenco
2002,108597,2199.477285,2,1,0,1,31,Adelo Abadia
2005,104305,2199.476495,2,1,0,1,9,Luka Gregorc
2001,101840,2199.476487,2,1,0,1,33,Jacobo Chavez
2001,108582,2199.476487,2,1,0,1,33,Luis Perez Chete
1985,110922,2199.475706,2,1,0,1,20,Albert Viviani
1986,106615,2199.475706,2,1,0,1,26,Bernard Balleret
1986,107097,2199.475706,2,1,0,1,26,Gilles Ganancia
1987,100890,2199.475706,2,1,0,1,33,Rashid Malik
1987,101601,2199.475706,2,1,0,1,54,Brett Steven
1987,107833,2199.475706,2,1,0,1,33,Mushaf Zia
1988,100460,2199.475706,2,1,0,1,38,Jose Lopez Maeso
1989,101663,2199.475706,2,1,0,1,27,Eugenio Rossi
1991,102068,2199.475706,2,1,0,1,20,Omer Rashid
1991,107182,2199.475706,6,3,0,3,18,Hassan El Arousy
1992,101580,2199.475706,2,1,0,1,45,Roger Rasheed
1992,108332,2199.475706,2,1,0,1,29,Suharyadi Suharyadi
1993,103029,2199.475706,2,1,0,1,21,Mehdi Tahiri
1993,108810,2199.475706,2,1,0,1,21,Khaled El Salawy
1995,101552,2199.475706,2,1,0,1,45,Xavier Daufresne
1996,102083,2199.475706,2,1,0,1,21,Nick Gould
1997,100943,2199.475706,2,1,0,1,19,Girts Dzelde
1998,101970,2199.475706,2,1,0,1,18,Iztok Bozic
1998,108846,2199.475706,2,1,0,1,18,Syed Nasir Sherazi
1999,102543,2199.475706,2,1,0,1,34,Chia Yen Tsai
1999,103077,2199.475706,2,1,0,1,18,Konstantinos Economidis
1999,108862,2199.475706,2,1,0,1,18,Kristian Mitrovski
2000,101840,2199.475706,2,1,0,1,37,Jacobo Chavez
2000,102647,2199.475706,2,1,0,1,37,Alberto Brause
2000,108593,2199.475706,4,2,0,2,37,Wing Luen Wong
2002,101840,2199.475706,4,2,0,2,31,Jacobo Chavez
2002,104395,2199.475706,2,1,0,1,17,Marcel Felder
2003,108672,2199.475706,2,1,0,1,31,William Lock
2004,103770,2199.475706,4,2,0,2,18,Kevin Sorensen
2004,103937,2199.475706,2,1,0,1,18,Irakli Ushangishvili
2004,104162,2199.475706,2,1,0,1,18,Deniss Pavlovs
2004,104210,2199.475706,4,2,0,2,31,Ryan Russell
2004,104698,2199.475706,2,1,0,1,18,Diego Cubas
2004,104863,2199.475706,2,1,0,1,31,Olivier Sajous
2005,102737,2199.475706,2,1,0,1,17,Gergely Kisgyorgy
2005,103050,2199.475706,2,1,0,1,17,Shahab Hassani Nafez
2005,103077,2199.475706,2,1,0,1,17,Konstantinos Economidis
2005,104976,2199.475706,2,1,0,1,17,Ryan Sweeting
2005,108945,2199.475706,2,1,0,1,17,Juan Sebastian Langton
2006,103829,2199.475706,4,2,0,2,30,Cristian Paiz
2006,104712,2199.475706,4,2,0,2,30,Israel Morales
2006,108947,2199.475706,2,1,0,1,30,West Nott
2007,108978,2199.475706,2,1,0,1,35,Nick Van Rosberg
2008,105394,2199.475706,2,1,0,1,31,Ilija Martinoski
2009,104299,2199.475706,2,1,0,1,21,Hiu Tung Yu
2009,108956,2199.475706,2,1,0,1,21,Jesus Francisco Felix
2010,103630,2199.475706,2,1,0,1,22,Martijn Van Haasteren
2010,105273,2199.475706,2,1,0,1,22,Mauricio Echazu
2010,105812,2199.475706,2,1,0,1,22,David Agung Susanto
2011,103499,2199.475706,2,1,0,1,21,Aqeel Khan
2011,104942,2199.475706,2,1,0,1,21,Roman Recarte
2011,108767,2199.475706,2,1,0,1,21,Gonzales Austin
2012,104656,2199.475706,2,1,0,1,35,Haydn Lewis
2012,105912,2199.475706,2,1,0,1,35,Diego Galeano
2013,106410,2199.475706,2,1,0,1,34,Jorge Brian Panta Herreros
2014,104283,2199.475706,2,1,0,1,32,Minh Quan Do
2014,106393,2199.475706,2,1,0,1,9,Frederico Ferreira Silva
2014,108748,2199.475706,2,1,0,1,9,Lukas Mugevicius
2014,144773,2199.475706,2,1,0,1,32,Jose Olivares
2015,105177,2199.475706,2,1,0,1,20,Aditya Hari Sasongko
2015,105434,2199.475706,2,1,0,1,19,Ruan Roelofse
2012,105985,2199.474745,2,1,0,1,35,Darian King
2011,105254,2199.473461,2,1,0,1,12,Nikola Mektic
1995,102444,2199.473208,4,2,0,2,20,Scott Barron
2015,104804,2199.470594,2,1,0,1,19,Amir Weintraub
2014,104673,2199.468804,2,1,0,1,32,Julio Cesar Campozano
1999,102455,2199.46809,13,6,0,7,7,Lorenzo Manta
1996,108605,2199.464916,2,1,0,1,28,Sacha Thoma
1998,102836,2199.464454,2,1,0,1,10,Rogier Wassen
2009,104592,2199.461858,2,1,0,1,11,Ilija Bozoljac
1988,101378,2199.461509,29,14,0,15,6,Tore Meinecke
2014,105032,2199.461448,23,10,0,13,4,Samuel Groth
1989,101406,2199.459847,2,1,0,1,37,Wojtek Kowalski
1989,101545,2199.459847,2,1,0,1,37,Tomasz Iwanski
1988,100323,2199.459308,2,1,0,1,49,Givaldo Barbosa
1988,107228,2199.458334,2,1,0,1,15,Igor Flego
1992,102061,2199.457896,4,2,0,2,15,Kevin Ullyett
2015,108766,2199.457038,2,1,0,1,11,Samir Iftikhar
1989,100835,2199.455366,2,1,0,1,54,Hans Dieter Beutel
2000,101917,2199.455366,2,1,0,1,49,Grant Stafford
2003,103690,2199.453659,2,1,0,1,14,Marcin Matkowski
1999,102024,2199.445877,30,14,0,16,7,Hernan Gumy
2002,103829,2199.445202,2,1,0,1,31,Cristian Paiz
2006,103894,2199.44516,2,1,0,1,14,Phillip King
2004,102740,2199.442961,4,2,0,2,8,Francisco Rodriguez
2014,105935,2199.442417,2,1,0,1,32,Duilio Beretta
1988,100618,2199.442258,21,9,0,12,3,Leif Shiras
1997,103077,2199.436135,4,2,0,2,19,Konstantinos Economidis
2008,104958,2199.42934,2,1,0,1,8,Carsten Ball
2003,103912,2199.426021,2,1,0,1,15,Mario Radic
2011,103580,2199.420779,2,1,0,1,12,Alexander Peya
1999,102687,2199.41984,2,1,0,1,16,Herbert Wiltschnig
2004,103229,2199.413547,4,2,0,2,8,Kornel Bardoczky
2006,108950,2199.41039,2,1,0,1,8,Juan Andres Gomez
2008,108930,2199.410018,4,2,0,2,8,Juan Carlos Ramirez
1998,102800,2199.406876,4,2,0,2,18,Nenad Zimonjic
1992,100795,2199.402646,4,2,0,2,35,Alvaro Jordan
2012,105471,2199.398617,6,3,0,3,11,Cesar Ramirez
2014,108701,2199.395482,2,1,0,1,17,Juan Sebastian Cabal
1987,100868,2199.379468,4,2,0,2,21,Craig A Miller
2003,104330,2199.378492,2,1,0,1,15,Rajeev Ram
2006,103586,2199.366554,2,1,0,1,16,Mariusz Fyrstenberg
2001,102381,2199.364725,5,2,0,3,20,Werner Eschauer
2003,102267,2199.354738,2,1,0,1,17,Gwinyai Tongoona
1985,100876,2199.350522,4,2,0,2,12,Bong Soo Kim
2006,102788,2199.347932,2,1,0,1,20,Jan Vacek
2000,102107,2199.347554,4,2,0,2,20,Jan Frode Andersen
2004,102860,2199.337929,40,21,0,19,3,Agustin Calleri
1994,102687,2199.323817,3,1,0,2,13,Herbert Wiltschnig
1987,101314,2199.320452,2,1,0,1,13,Woody Hunt
1987,101726,2199.317934,2,1,0,1,10,Boaz Merenstein
2005,103817,2199.308312,4,2,0,2,9,Yu Jr Wang
2000,101997,2199.306078,2,1,0,1,21,Marzio Martelli
1998,102944,2199.303354,2,1,0,1,16,Stefano Cobolli
1989,100956,2199.299942,13,6,0,7,13,Simone Colombo
1987,100950,2199.298354,30,12,0,18,4,Libor Pimek
1994,100770,2199.295528,2,1,0,1,39,Peter Moraing
1993,101681,2199.293645,13,6,0,7,13,Chris Wilkinson
1990,101061,2199.293395,50,24,0,26,4,Jimmy Arias
2007,104026,2199.289373,9,4,0,5,6,Joachim Johansson
1995,101672,2199.289327,4,2,0,2,18,Michael Geserer
1996,101789,2199.287506,10,5,0,5,14,Steve Bryan
1999,102776,2199.284214,57,28,0,29,2,Andrew Ilie
1993,102153,2199.280412,2,1,0,1,17,German Puentes
2005,107098,2199.279534,2,1,0,1,17,Gilles Kremer
2004,103534,2199.277439,2,1,0,1,29,Nicolas Devilder
1985,101380,2199.275977,2,1,0,1,10,Amit Naor
1987,109456,2199.274736,4,2,0,2,33,Carlos Lozano
1987,110141,2199.274736,4,2,0,2,33,Chang Rung Wu
1995,108585,2199.2732,2,1,0,1,10,Americo Venero Montes
1989,100966,2199.257669,4,2,0,2,9,Nick Fulwood
1993,101084,2199.25126,52,22,0,30,3,Jakob Hlasek
2015,105963,2199.249912,2,1,0,1,33,Arthur De Greef
1989,101380,2199.237949,2,1,0,1,9,Amit Naor
1995,102484,2199.22631,2,1,0,1,26,Massimo Calvelli
2003,107098,2199.212185,2,1,0,1,8,Gilles Kremer
1998,101976,2199.195646,6,3,0,3,9,Federico Dondo
2008,103395,2199.194124,2,1,0,1,28,Julio Silva
2001,102104,2199.183181,6,3,0,3,24,Christian Ruud
2006,102869,2199.180963,2,1,0,1,27,Galo Blanco
2015,105254,2199.18053,2,1,0,1,31,Nikola Mektic
2002,101956,2199.179758,4,2,0,2,8,Mark Knowles
1999,103250,2199.176822,2,1,0,1,30,Rodolphe Cadart
1994,101811,2199.171447,2,1,0,1,18,Bill Barber
2013,104007,2199.167541,2,1,0,1,27,Andre Ghem
2009,105028,2199.163109,15,7,0,8,12,Jesse Levine
2013,105226,2199.160582,2,1,0,1,34,Attila Balazs
1985,106576,2199.16053,2,1,0,1,31,Arafat Chekrouni
2015,106247,2199.143582,2,1,0,1,19,Nik Razborsek
1990,101124,2199.138357,31,15,0,16,7,Paolo Cane
2014,105161,2199.13673,4,2,0,2,16,Yann Marti
2012,104901,2199.125819,2,1,0,1,35,Vladimir Ivanov
1997,102050,2199.125568,2,1,0,1,32,Marco Meneschincheri
2013,105477,2199.121703,2,1,0,1,38,Marco Trungelliti
2005,104027,2199.120137,2,1,0,1,17,Pablo Gonzalez
2008,104919,2199.116545,2,1,0,1,18,Leonardo Mayer
2002,102362,2199.115355,2,1,0,1,17,Amro Ghoneim
1988,110141,2199.115269,4,2,0,2,34,Chang Rung Wu
1988,101507,2199.112023,14,7,0,7,16,Tomas Carbonell
2005,103248,2199.091519,2,1,0,1,34,Harel Levy
1999,102860,2199.063935,6,3,0,3,16,Agustin Calleri
2013,104535,2199.060879,4,2,0,2,34,Daniel Garza
1991,101516,2199.056472,2,1,0,1,12,Joao Zwetsch
1989,101745,2199.056467,4,2,0,2,41,Roberto Jabali
2012,104677,2199.051849,2,1,0,1,11,Artem Sitak
2013,105590,2199.050741,4,2,0,2,34,Uladzimir Ignatik
2013,106078,2199.050741,2,1,0,1,34,Egor Gerasimov
2013,106158,2199.04781,4,2,0,2,9,Suk Young Jeong
2002,103408,2199.04428,13,6,0,7,6,Brian Vahaly
2004,103963,2199.039199,2,1,0,1,14,Filip Urban
2009,102567,2199.038389,2,1,0,1,40,George Bastl
1997,101821,2199.03342,2,1,0,1,47,Peter Tramacchi
2005,104495,2199.021095,2,1,0,1,18,Florin Mergea
2004,102800,2199.019181,4,2,0,2,13,Nenad Zimonjic
1987,101420,2199.015175,2,1,0,1,19,Vaclav Roubicek
2015,105004,2199.012447,2,1,0,1,11,Dimitar Kutrovsky
1992,108686,2199.01213,2,1,0,1,44,Alejandro Aramburu Acuna
2002,102512,2199.010671,2,1,0,1,14,Joseph Sirianni
2010,105036,2199.002427,2,1,0,1,22,Hyun Joon Kim
1987,100630,2198.998879,2,1,0,1,3,Gustavo Guerrero
2011,104695,2198.994221,2,1,0,1,42,Fritz Wolmarans
2006,104167,2198.992885,2,1,0,1,37,Todd Widom
2004,104589,2198.992127,4,2,0,2,39,Chris Guccione
2012,108701,2198.982527,2,1,0,1,38,Juan Sebastian Cabal
1997,101412,2198.979741,7,3,0,4,31,Shuzo Matsuoka
2003,103483,2198.972456,2,1,0,1,31,James Shortall
2009,104908,2198.955225,2,1,0,1,11,Mikal Oliver Statham
2006,103607,2198.953777,4,2,0,2,8,Victor Estrella
1988,110878,2198.952992,4,2,0,2,39,Noel Rutherford
1991,110815,2198.952992,4,2,0,2,39,Vernon Lewis
1992,108836,2198.952992,4,2,0,2,35,Jayendra Wijeyesekera
1993,110794,2198.952992,4,2,0,2,21,Jerome Seguin
1994,103187,2198.952992,2,1,0,1,19,Hisham Hemeda
1994,108828,2198.952992,4,2,0,2,19,Emmanuel Udozorh
1995,108582,2198.952992,4,2,0,2,35,Luis Perez Chete
1997,108838,2198.952992,4,2,0,2,33,Vittaya Samrej
1997,108843,2198.952992,2,1,0,1,10,Toufiq Zhalan
1999,102843,2198.952992,4,2,0,2,34,Suwandi Suwandi
1999,103504,2198.952992,4,2,0,2,34,Febi Widhiyanto
2003,108651,2198.952992,2,1,0,1,31,Sandor Martinez Breijo
2004,103419,2198.952992,4,2,0,2,31,Gabriel Montilla
2007,104036,2198.952992,2,1,0,1,35,Simon Rea
2009,102696,2198.952992,2,1,0,1,21,Guillaume Couillard
2009,103882,2198.952992,2,1,0,1,21,Adrians Zguns
2011,105566,2198.952992,4,2,0,2,21,Shahin Khaledan
2011,108770,2198.952992,2,1,0,1,21,Nicholas Sayer
2012,108930,2198.952992,2,1,0,1,35,Juan Carlos Ramirez
2014,103894,2198.952992,4,2,0,2,28,Phillip King
2009,105781,2198.951447,2,1,0,1,21,Andrei Vasilevski
1988,107205,2198.951412,4,2,0,2,34,Hisham Nasser
2000,102830,2198.951412,4,2,0,2,37,Paulo Carvallo
2001,108617,2198.951412,4,2,0,2,33,Hussain Al Ashwak
2003,103612,2198.951412,4,2,0,2,31,Alexey Kedryuk
2004,102055,2198.951412,4,2,0,2,31,Bertrand Madsen
2006,104695,2198.951412,2,1,0,1,16,Fritz Wolmarans
2007,103499,2198.951412,4,2,0,2,35,Aqeel Khan
2013,105201,2198.951412,4,2,0,2,34,Marc Abdulnour
2013,105372,2198.951412,4,2,0,2,34,Issam Al Tawil
2014,106175,2198.951412,4,2,0,2,9,Ricardo Rodriguez
1990,101093,2198.949238,2,1,0,1,33,Steve Devries
2005,104468,2198.94599,12,6,0,6,6,Gilles Simon
2010,103851,2198.943912,4,2,0,2,22,Conor Niland
1993,101097,2198.9404,2,1,0,1,38,Rick Leach
2009,104812,2198.938811,2,1,0,1,35,Scoville Jenkins
1985,100620,2198.936585,2,1,0,1,39,Eduardo Osta
1991,101545,2198.932744,2,1,0,1,34,Tomasz Iwanski
2002,103504,2198.931072,2,1,0,1,31,Febi Widhiyanto
2015,104591,2198.90779,2,1,0,1,19,Patrick Tierro
2015,104604,2198.90779,2,1,0,1,19,Ruben Gonzales
2000,102087,2198.903099,7,3,0,4,13,Oleg Ogorodov
2001,102077,2198.898877,2,1,0,1,9,Alexander Shvec
2007,103891,2198.896648,2,1,0,1,35,Alexandros Jakupovic
2013,104250,2198.893028,4,2,0,2,21,Prakash Amritraj
1991,101857,2198.892191,2,1,0,1,9,Jason Cask
1991,101341,2198.89175,2,1,0,1,49,Pablo Albano
1985,100498,2198.879026,4,2,0,2,28,Klaus Eberhard
1995,102466,2198.876947,22,10,0,12,3,Jan Kroslak
1990,101145,2198.875844,10,5,0,5,3,Jonathan Canter
2001,102934,2198.873095,4,2,0,2,24,Nicolas Coutelot
1998,101353,2198.862486,2,1,0,1,8,Lionel Barthez
2002,103280,2198.847232,19,8,0,11,3,Martin Verkerk
1992,101058,2198.841271,4,2,0,2,24,Francisco Yunis
2010,103638,2198.831011,2,1,0,1,11,Jhonson Garcia
2012,103444,2198.814542,4,2,0,2,33,Jean Rene Lisnard
2001,103197,2198.811953,4,2,0,2,18,John Doran
2010,104914,2198.800199,2,1,0,1,21,Ervin Eleskovic
1992,101234,2198.795961,39,16,0,23,3,Patrik Kuhnen
1985,100795,2198.784013,4,2,0,2,20,Alvaro Jordan
2002,103402,2198.768774,4,2,0,2,14,Peter Clarke
2011,105066,2198.767276,2,1,0,1,12,Grzegorz Panfil
1991,102031,2198.759761,4,2,0,2,28,Sandor Noszaly
1993,101098,2198.754365,18,9,0,9,29,Guy Forget
2012,104667,2198.749953,2,1,0,1,19,Philipp Oswald
1995,101106,2198.740639,2,1,0,1,38,Peter Lundgren
1989,100974,2198.738892,2,1,0,1,19,Jeff Klaparda
1999,101900,2198.73348,19,10,0,9,2,Nicklas Kulti
1998,103454,2198.7315,4,2,0,2,2,Nicolas Massu
2005,102306,2198.730009,4,2,0,2,23,Michael Kohlmann
2013,105806,2198.723893,4,2,0,2,6,Mirza Basic
2006,103319,2198.721177,6,3,0,3,10,Jeff Morrison
1991,101035,2198.712858,4,2,0,2,17,Menno Oosting
2011,105152,2198.695701,2,1,0,1,38,Marcin Gawron
2004,104676,2198.683217,2,1,0,1,19,Andreas Beck
2003,104180,2198.679964,4,2,0,2,8,Gilles Muller
1985,101240,2198.669292,2,1,0,1,38,Martin Hipp
1988,101018,2198.667431,2,1,0,1,38,Edoardo Mazza
2002,103110,2198.667302,2,1,0,1,14,Daniele Bracciali
2013,105041,2198.658599,31,14,0,17,6,Lukas Lacko
1988,101721,2198.65486,3,1,0,2,6,Markus Zillner
2005,104008,2198.654558,4,2,0,2,8,Carlos Avellan
2007,104140,2198.620788,4,2,0,2,9,Dawid Olejniczak
1986,100966,2198.618021,2,1,0,1,24,Nick Fulwood
1992,106936,2198.617471,2,1,0,1,19,Emile Ngoran
1989,106887,2198.616028,2,1,0,1,49,Dominic Durand
2013,104960,2198.613053,2,1,0,1,37,Miguel Angel Reyes Varela
1989,102019,2198.609842,2,1,0,1,38,Dirk Dier
2012,105434,2198.598712,2,1,0,1,35,Ruan Roelofse
2012,105874,2198.595434,4,2,0,2,10,Albano Olivetti
2009,105098,2198.592213,4,2,0,2,20,Alexandre Sidorenko
1995,101460,2198.578359,2,1,0,1,36,Jose Francisco Altur
1996,101701,2198.577129,4,2,0,2,33,Bing Pan
1995,102318,2198.575645,5,2,0,3,3,Andrei Pavel
1986,101367,2198.571477,2,1,0,1,15,Igor Saric
2010,104963,2198.566125,2,1,0,1,42,Yannick Mertens
1988,100485,2198.563987,2,1,0,1,38,Tsuyoshi Fukui
1989,106941,2198.554929,4,2,0,2,28,Eno Polo
1990,107093,2198.547314,2,1,0,1,5,Gil Kovalski
1995,103170,2198.544059,4,2,0,2,10,Wei Ju Chen
1998,102851,2198.542728,3,1,0,2,11,Giorgio Galimberti
1992,101961,2198.541061,4,2,0,2,3,Martin Stringari
2011,104395,2198.538621,2,1,0,1,21,Marcel Felder
1998,102169,2198.532449,4,2,0,2,16,Michael Joyce
2007,104619,2198.531951,2,1,0,1,9,Jesse Huta Galung
1994,101816,2198.53083,2,1,0,1,16,Steve Campbell
1986,100607,2198.516379,28,13,0,15,4,Eduardo Bengoechea
2004,104181,2198.505368,2,1,0,1,8,Victor Ionita
1995,102061,2198.504541,2,1,0,1,34,Kevin Ullyett
1988,101398,2198.501787,2,1,0,1,28,Neil Borwick
1995,101835,2198.492961,8,4,0,4,7,Arne Thoms
2008,103254,2198.488504,2,1,0,1,8,Yves Allegro
1994,102742,2198.484118,4,2,0,2,10,Armand Strombach
1996,102068,2198.463962,4,2,0,2,34,Omer Rashid
1996,108844,2198.463962,4,2,0,2,34,Hamed Ul Haq
1998,101374,2198.45935,2,1,0,1,4,Leonardo Lavalle
2011,104681,2198.45922,2,1,0,1,7,Sebastian Rieschick
1993,102146,2198.452054,35,18,0,17,3,Jordi Burillo
1986,100427,2198.45037,2,1,0,1,18,Ferrante Rocchi
2005,104330,2198.44808,4,2,0,2,10,Rajeev Ram
2000,103821,2198.447461,4,2,0,2,37,Danai Udomchoke
1991,102192,2198.4435,4,2,0,2,42,Luis Adrian Morejon
1995,102336,2198.43367,4,2,0,2,7,Kotaro Miyachi
2000,101775,2198.433416,2,1,0,1,20,Frederik Fetterlein
2010,105221,2198.433416,2,1,0,1,22,Mauricio Doria Medina
1985,110990,2198.433236,4,2,0,2,31,Rodrigo Rafael
1997,101825,2198.428698,4,2,0,2,33,Manuel Tejada
2010,104996,2198.428698,4,2,0,2,22,Alexander Blom
2015,104895,2198.428698,2,1,0,1,19,Abdullah Maqdas
2015,200273,2198.428698,2,1,0,1,19,Hady Habib
2007,104063,2198.420868,4,2,0,2,19,Mait Kunnap
2004,103514,2198.418354,4,2,0,2,8,Young Jun Kim
1985,100837,2198.416195,25,13,0,12,3,Jeremy Bates
1995,108816,2198.411529,2,1,0,1,20,Isaac Donkor
1986,100490,2198.400804,2,1,0,1,19,Jaroslav Navratil
1985,100578,2198.400376,2,1,0,1,11,Brent Pirow
2012,105899,2198.397107,2,1,0,1,35,Martin Cuevas
1997,102491,2198.394901,50,23,0,27,2,Alex Radulescu
1987,100553,2198.390994,36,17,0,19,4,Nduka Odizor
1997,102993,2198.376526,4,2,0,2,10,Michal Chmela
2009,104166,2198.37104,6,3,0,3,15,Alex Bogomolov Jr
2001,103898,2198.368517,2,1,0,1,6,Julien Benneteau
2003,101806,2198.363122,2,1,0,1,14,Marc Kevin Goellner
2001,102843,2198.327291,6,3,0,3,9,Suwandi Suwandi
1993,101149,2198.326369,2,1,0,1,40,Morten Christensen
1990,102375,2198.318026,2,1,0,1,13,Dinu Pescariu
1992,101862,2198.308793,8,4,0,4,19,Maurice Ruah
1988,101131,2198.307565,32,13,0,19,13,Jimmy Brown
1995,101370,2198.306811,2,1,0,1,16,Paolo Pambianco
1994,102100,2198.304913,4,2,0,2,19,Bartlomiej Dabrowski
1996,102556,2198.303624,4,2,0,2,19,Claude Ngoran
2006,102985,2198.302436,4,2,0,2,26,Gustavo Marcaccio
2013,105877,2198.296963,5,2,0,3,11,Emilio Gomez
2014,105497,2198.29148,2,1,0,1,32,Jose Hernandez
1986,100967,2198.29066,18,8,0,10,5,Dan Goldie
2004,103339,2198.287575,2,1,0,1,23,Wesley Whitehouse
1993,102169,2198.283524,7,3,0,4,14,Michael Joyce
2001,101833,2198.28085,2,1,0,1,10,Michael Tebbutt
2015,106000,2198.278578,17,8,0,9,12,Damir Dzumhur
2009,105011,2198.278428,10,5,0,5,5,Illya Marchenko
2005,103451,2198.262713,24,10,0,14,5,Bjorn Phau
2008,104952,2198.260141,4,2,0,2,17,Martin Pedersen
2015,106281,2198.258946,2,1,0,1,22,Liam Broady
2009,105238,2198.255829,2,1,0,1,5,Alexandr Dolgopolov
2003,104580,2198.240424,2,1,0,1,17,Haithem Abid
2008,105052,2198.240232,2,1,0,1,20,Chris Eaton
1991,101373,2198.235831,5,2,0,3,17,Karsten Braasch
1991,108161,2198.2271,6,3,0,3,10,Roland So
1993,100653,2198.219487,12,6,0,6,28,Andres Gomez
1993,102198,2198.210399,4,2,0,2,23,Paul Kilderry
2002,104745,2198.204719,2,1,0,1,27,Rafael Nadal
2005,101885,2198.198246,37,18,0,19,6,Wayne Arthurs
1991,100917,2198.178114,2,1,0,1,12,Nelson Aerts
2002,104026,2198.172434,2,1,0,1,3,Joachim Johansson
2015,126203,2198.166267,2,1,0,1,23,Taylor Harry Fritz
2004,104378,2198.16073,2,1,0,1,18,Yordan Kanev
2005,104592,2198.16028,2,1,0,1,15,Ilija Bozoljac
2004,103970,2198.159829,60,29,0,31,2,David Ferrer
1999,102251,2198.158258,2,1,0,1,10,Mariano Hood
2014,105041,2198.146011,32,14,0,18,4,Lukas Lacko
1995,101280,2198.121856,2,1,0,1,42,Mikael Stadling
1985,100628,2198.117853,35,15,0,20,1,Michiel Schapers
1993,102457,2198.116391,2,1,0,1,23,Miles Maclagan
1985,100252,2198.103798,35,17,0,18,5,Tim Gullikson
2005,102887,2198.102851,4,2,0,2,33,Ramon Delgado
1990,102302,2198.100736,2,1,0,1,3,Marcelo Saliola
1988,101301,2198.094842,2,1,0,1,22,Jan Willem Lodder
2000,102286,2198.074498,20,9,0,11,8,Wayne Black
2009,104113,2198.068113,2,1,0,1,29,Carlos Salamanca
2015,106198,2198.050505,4,2,0,2,19,Hugo Dellien
2003,103478,2198.022956,4,2,0,2,6,Diego Veronelli
2012,105992,2198.018161,47,23,0,24,7,Ryan Harrison
1988,101354,2198.009562,4,2,0,2,20,Andrew Sznajder
2007,104209,2198.007356,2,1,0,1,18,Rainer Eitzinger
1988,101068,2197.996264,2,1,0,1,10,Byron Talbot
2003,104589,2197.994549,4,2,0,2,15,Chris Guccione
2015,111190,2197.990349,2,1,0,1,9,Zhizhen Zhang
1991,108844,2197.986878,4,2,0,2,20,Hamed Ul Haq
2015,105952,2197.981836,4,2,0,2,37,Renzo Olivo
2009,103862,2197.977197,2,1,0,1,5,Michail Elgin
2013,104589,2197.974122,2,1,0,1,20,Chris Guccione
1989,101315,2197.973539,2,1,0,1,27,Enrico Cocchi
1989,100807,2197.966885,4,2,0,2,41,Marcelo Hennemann
2015,105589,2197.955452,8,4,0,4,6,Gerald Melzer
2006,103325,2197.952425,32,13,0,19,3,Wesley Moodie
2004,103638,2197.950882,4,2,0,2,8,Jhonson Garcia
2007,102863,2197.94486,4,2,0,2,7,Takao Suzuki
2009,105575,2197.93557,4,2,0,2,21,Ricardas Berankis
1994,100431,2197.917809,4,2,0,2,30,Mansour Bahrami
1994,101720,2197.907345,2,1,0,1,25,Agustin Garizzio
1986,100890,2197.905983,4,2,0,2,32,Rashid Malik
1988,110852,2197.905983,4,2,0,2,39,Umesha Wallooppillai
1989,108754,2197.905983,4,2,0,2,43,Esam Abdulaal
1991,101662,2197.905983,4,2,0,2,25,Selvam Veerasingam
1992,101946,2197.905983,4,2,0,2,19,Milko Petkov
1993,109232,2197.905983,4,2,0,2,36,Terence Chia
2000,103472,2197.905983,4,2,0,2,20,Karim Maamoun
2005,104702,2197.905983,4,2,0,2,17,Michael Leong
2010,108961,2197.905983,2,1,0,1,22,Abd Hazli Bin Zainuddin
2015,105723,2197.903624,22,10,0,12,6,Andrey Kuznetsov
2010,106158,2197.883332,2,1,0,1,11,Suk Young Jeong
2012,104724,2197.87067,9,4,0,5,21,Eduardo Schwank
2008,104702,2197.865489,4,2,0,2,31,Michael Leong
2008,104262,2197.865289,13,6,0,7,6,Flavio Cipolla
1987,110897,2197.864618,4,2,0,2,41,Greig Rodger
2000,102251,2197.857949,4,2,0,2,11,Mariano Hood
2008,102667,2197.856332,2,1,0,1,6,Satoshi Iwabuchi
2013,104559,2197.853119,8,4,0,4,1,Teymuraz Gabashvili
2001,102100,2197.848738,4,2,0,2,18,Bartlomiej Dabrowski
1997,101515,2197.844611,2,1,0,1,31,Donald Johnson
1987,101477,2197.829452,4,2,0,2,26,Chris Bailey
2013,104433,2197.82848,7,3,0,4,13,Frank Dancevic
1996,101444,2197.806051,2,1,0,1,10,Bonit Wiryawan
2011,104195,2197.800125,4,2,0,2,18,Simone Vagnozzi
2008,104229,2197.791074,26,11,0,15,5,Yen Hsun Lu
2009,103017,2197.778049,29,13,0,16,4,Nicolas Kiefer
1989,100768,2197.773031,8,4,0,4,4,Nick Brown
2003,103171,2197.76886,45,20,0,25,3,Raemon Sluiter
2007,103693,2197.760083,7,3,0,4,3,Thierry Ascione
1993,101979,2197.74885,4,2,0,2,36,Ricardo Mena
1987,106782,2197.744019,4,2,0,2,33,Colin Grant
1987,107680,2197.744019,4,2,0,2,33,Mark Bailey
2008,104091,2197.701774,3,1,0,2,24,Miguel Angel Lopez Jaen
2010,104395,2197.696898,6,3,0,3,30,Marcel Felder
2002,103592,2197.684105,2,1,0,1,14,Jerome Haehnel
1992,101522,2197.680331,4,2,0,2,29,Chi Wan Kim
1993,101459,2197.65666,7,3,0,4,5,Tomas Nydahl
2001,103758,2197.651555,23,10,0,13,11,Taylor Dent
1985,100661,2197.632386,27,12,0,15,4,Damir Keretic
2000,102968,2197.631044,2,1,0,1,13,Jonathan Erlich
1990,101391,2197.629879,42,21,0,21,2,Carl Uwe Steeb
2005,103305,2197.61901,2,1,0,1,7,Daniel Elsner
2011,105166,2197.596619,2,1,0,1,12,Peter Polansky
1994,101417,2197.584051,2,1,0,1,11,Mario Rincon
1989,100926,2197.583999,13,6,0,7,4,Ken Flach
1999,102880,2197.581219,2,1,0,1,7,Alexander Popp
2000,103487,2197.570774,4,2,0,2,11,Federico Luzzi
1999,102910,2197.563888,2,1,0,1,22,Salvador Navarro
2012,105477,2197.559069,2,1,0,1,21,Marco Trungelliti
2004,103600,2197.55382,4,2,0,2,31,Mohammad Ghareeb
2014,105827,2197.553161,4,2,0,2,9,Laurynas Grigelis
1985,100431,2197.526562,2,1,0,1,41,Mansour Bahrami
1985,101120,2197.523306,8,4,0,4,19,Karel Novacek
2005,103510,2197.520486,2,1,0,1,13,Rob Steckley
2007,108925,2197.50741,6,3,0,3,9,Ahmad Rabeea Muhammad
2008,104112,2197.494751,6,3,0,3,8,Benjamin Balleret
1985,101242,2197.489704,5,2,0,3,14,Brad Pearce
1998,102790,2197.481203,4,2,0,2,7,Yu Zheng
2011,105930,2197.45786,2,1,0,1,18,Daniel Kosakowski
1998,102644,2197.452617,42,21,0,21,2,Franco Squillari
1986,101096,2197.445495,5,2,0,3,8,Gary Muller
1990,101184,2197.438673,2,1,0,1,22,Damir Buljevic
2004,103333,2197.432381,44,18,0,26,3,Ivo Karlovic
2015,105842,2197.422539,5,2,0,3,7,Di Wu
1992,101364,2197.406903,6,3,0,3,6,Bret Garnett
1989,100957,2197.396461,7,3,0,4,26,Greg Holmes
1995,101750,2197.394083,29,12,0,17,6,Cristiano Caratti
1992,102031,2197.392676,4,2,0,2,29,Sandor Noszaly
1995,101732,2197.390596,2,1,0,1,26,Pietro Pennisi
1985,110880,2197.386408,4,2,0,2,31,Wei You
1991,110813,2197.386408,4,2,0,2,42,Rafael Moreno
1987,101421,2197.373758,4,2,0,2,28,Veli Paloheimo
1985,101416,2197.371692,4,2,0,2,26,Joao Cunha Silva
1985,107960,2197.371692,4,2,0,2,26,Pedro Cordeiro
2007,105155,2197.359423,2,1,0,1,31,Pedro Sousa
1992,101227,2197.356065,2,1,0,1,34,Daniel Marco
1985,110141,2197.355295,4,2,0,2,43,Chang Rung Wu
2000,102834,2197.337139,43,20,0,23,2,Paul Goldstein
2015,105269,2197.33234,2,1,0,1,18,Marcelo Demoliner
2003,103230,2197.330815,2,1,0,1,6,Tasuku Iwami
1994,108755,2197.328988,4,2,0,2,19,Maciej Kost
1992,101066,2197.324812,4,2,0,2,7,Richard Matuszewski
1991,101003,2197.306087,2,1,0,1,12,Ricardo Acioly
1997,103239,2197.305068,2,1,0,1,20,Marcus Sarstrand
1995,101980,2197.299212,2,1,0,1,34,Howard Joffe
2010,104180,2197.288752,4,2,0,2,20,Gilles Muller
2005,104250,2197.283552,8,4,0,4,7,Prakash Amritraj
2009,103936,2197.281872,2,1,0,1,21,Todor Enev
2008,104535,2197.277435,2,1,0,1,8,Daniel Garza
1999,102117,2197.26572,6,3,0,3,7,Eduardo Nicolas
2014,106078,2197.263356,4,2,0,2,7,Egor Gerasimov
2013,105376,2197.262068,2,1,0,1,13,Peter Gojowczyk
2001,103835,2197.260267,5,2,0,3,8,Filippo Volandri
1987,100985,2197.243684,3,1,0,2,10,Tim Pawsat
2010,105154,2197.243056,6,3,0,3,34,Joao Souza
2012,105404,2197.238598,2,1,0,1,13,Michael Mcclune
1989,101866,2197.237035,2,1,0,1,19,David Rikl
1990,101262,2197.220881,3,1,0,2,3,Rikard Bergh
1990,101133,2197.193029,10,5,0,5,1,Patrick Baur
2010,104160,2197.180682,2,1,0,1,22,Lukas Dlouhy
1998,102318,2197.176135,46,24,0,22,2,Andrei Pavel
1985,101216,2197.17085,2,1,0,1,31,Olli Rahnasto
2004,104332,2197.16902,2,1,0,1,22,Philipp Petzschner
2010,104869,2197.164814,2,1,0,1,23,Sergei Bubka
1998,101982,2197.160087,2,1,0,1,23,Jordi Mas
1985,101180,2197.159357,2,1,0,1,34,Jose Clavet
1998,103420,2197.146936,2,1,0,1,28,Michal Tabara
2011,103781,2197.14471,45,22,0,23,6,Jurgen Melzer
2015,103285,2197.141897,17,7,0,10,6,Radek Stepanek
1985,100917,2197.139415,9,4,0,5,1,Nelson Aerts
1995,102344,2197.128595,52,24,0,28,3,Karol Kucera
2004,104068,2197.104621,47,21,0,26,3,Robby Ginepri
1998,102028,2197.097109,2,1,0,1,7,Massimo Valeri
1994,101776,2197.067965,10,4,0,6,8,Sandon Stolle
1987,100810,2197.041578,11,5,0,6,7,Paul Chamberlin
2007,103898,2197.037406,50,22,0,28,3,Julien Benneteau
1988,101254,2197.014928,2,1,0,1,25,Peter Svensson
2015,105512,2196.972258,2,1,0,1,18,Alexander Sarkissian
2014,104628,2196.959474,4,2,0,2,10,Alexander Kudryavtsev
1998,102811,2196.958177,7,3,0,4,8,Dusan Vemic
1995,100943,2196.95046,6,3,0,3,20,Girts Dzelde
2000,102738,2196.935433,2,1,0,1,11,Stefano Tarallo
2009,103444,2196.916847,4,2,0,2,26,Jean Rene Lisnard
2004,103337,2196.914759,6,3,0,3,7,Ben Qiang Zhu
2007,103573,2196.913466,7,3,0,4,11,Rik De Voest
1997,102001,2196.911618,2,1,0,1,31,German Lopez
2011,106045,2196.891945,4,2,0,2,17,Denis Kudla
1991,101167,2196.878046,4,2,0,2,10,Jaime Cortes
1991,101958,2196.877919,2,1,0,1,12,Pierre Bouteyre
1992,102184,2196.876786,18,9,0,9,6,David Prinosil
2007,103860,2196.859412,2,1,0,1,19,Timo Nieminen
1986,101368,2196.845241,15,7,0,8,2,Christian Miniussi
1995,101776,2196.844102,16,7,0,9,7,Sandon Stolle
1994,101897,2196.838606,35,15,0,20,3,Fernando Meligeni
2002,103176,2196.828379,42,19,0,23,5,David Sanchez
2000,102306,2196.825897,7,3,0,4,13,Michael Kohlmann
1986,100736,2196.820027,1,0,0,1,6,Hugo Nunez
2011,104026,2196.818631,2,1,0,1,38,Joachim Johansson
1986,101057,2196.793774,3,1,0,2,8,Peter Carter
1990,107617,2196.790803,2,1,0,1,16,Magnus Nilsson
1994,102259,2196.782494,2,1,0,1,35,Jerome Golmard
2011,104677,2196.781367,4,2,0,2,17,Artem Sitak
1989,110914,2196.78032,2,1,0,1,37,Robert Dolan
1998,102519,2196.779289,7,3,0,4,2,Marcio Carlsson
1986,101372,2196.770302,4,2,0,2,18,Joey Blake
2010,105149,2196.76786,4,2,0,2,34,Reda El Amrani
1997,103114,2196.76524,6,3,0,3,21,Martin Lee
1989,101427,2196.75665,2,1,0,1,20,Ruben Gajardo
1997,101888,2196.727374,45,19,0,26,2,Daniel Vacek
2002,103103,2196.72007,52,23,0,29,2,Dominik Hrbaty
2007,104217,2196.719521,5,2,0,3,7,Simon Stadler
1988,100922,2196.696023,13,6,0,7,5,Roberto Arguello
2011,103967,2196.690365,3,1,0,2,4,Michael Lammer
2002,103568,2196.687842,6,3,0,3,8,Valentin Sanon
1999,101862,2196.643314,4,2,0,2,9,Maurice Ruah
2000,103356,2196.63051,17,8,0,9,6,Michel Kratochvil
2004,104195,2196.600256,2,1,0,1,25,Simone Vagnozzi
1995,103181,2196.583106,2,1,0,1,17,Jiri Vanek
1999,102950,2196.570401,54,25,0,29,2,Fernando Vicente
1987,101050,2196.545439,16,7,0,9,6,Martin Laurendeau
1986,101196,2196.533097,19,8,0,11,3,Derrick Rostagno
1987,100751,2196.523144,10,4,0,6,2,Roberto Saad
2006,103470,2196.509806,9,4,0,5,10,Robert Kendrick
1990,101321,2196.478297,4,2,0,2,18,Juan Carlos Baguena
2013,105842,2196.473473,7,3,0,4,7,Di Wu
1993,101356,2196.469359,2,1,0,1,16,Buff Farrow
1996,101515,2196.466392,3,1,0,2,14,Donald Johnson
2002,102902,2196.453964,4,2,0,2,6,Thomas Blake
2005,102788,2196.453486,2,1,0,1,20,Jan Vacek
2009,104433,2196.393134,22,10,0,12,15,Frank Dancevic
1994,101412,2196.385774,28,13,0,15,6,Shuzo Matsuoka
1997,101594,2196.366442,4,2,0,2,31,Carsten Arriens
2000,103373,2196.346234,2,1,0,1,21,Sergio Roitman
1993,100991,2196.317233,4,2,0,2,30,Johnny Goudenbour
2012,103813,2196.311989,53,26,0,27,4,Jarkko Nieminen
1986,100824,2196.30735,2,1,0,1,10,Peter Bastiansen
1991,101370,2196.302365,2,1,0,1,17,Paolo Pambianco
1997,102897,2196.293288,3,1,0,2,11,Nir Welgreen
1995,101430,2196.29058,4,2,0,2,12,Sergio Cortes
2009,105558,2196.27683,2,1,0,1,26,Guillaume Rufin
1994,100876,2196.244417,3,1,0,2,7,Bong Soo Kim
1989,101370,2196.232732,8,4,0,4,15,Paolo Pambianco
1989,101374,2196.215199,29,14,0,15,13,Leonardo Lavalle
2015,105379,2196.20457,34,17,0,17,3,Aljaz Bedene
1992,100772,2196.191527,12,6,0,6,14,Kelly Evernden
1991,100607,2196.184584,6,3,0,3,35,Eduardo Bengoechea
2004,104499,2196.183544,5,2,0,3,6,Jimmy Wang
1986,100240,2196.16812,6,3,0,3,2,Joao Soares
2012,104371,2196.161037,3,1,0,2,11,Ivo Minar
2014,106148,2196.160356,6,3,0,3,27,Roberto Carballes Baena
1995,102192,2196.153785,7,3,0,4,12,Luis Adrian Morejon
2007,104978,2196.153301,2,1,0,1,30,Daniel Brands
2000,103305,2196.146832,9,4,0,5,7,Daniel Elsner
2014,105872,2196.143954,4,2,0,2,4,Christian Lindell
1995,102863,2196.131591,4,2,0,2,7,Takao Suzuki
1988,101580,2196.128077,6,3,0,3,11,Roger Rasheed
2007,103553,2196.110032,5,2,0,3,12,Alun Jones
1987,110880,2196.100352,3,1,0,2,12,Wei You
2004,103174,2196.068449,13,6,0,7,6,Noam Okun
2005,104534,2196.043597,3,1,0,2,8,Dudi Sela
2002,102539,2196.04305,52,23,0,29,3,Bohdan Ulihrach
1986,101132,2196.0005,3,1,0,2,19,Fredrik Rosenquist
2010,104214,2195.962778,36,17,0,19,5,Igor Andreev
1988,100931,2195.961023,7,3,0,4,17,Andrew Burrow
1988,100663,2195.952309,3,1,0,2,15,Marcel Freeman
2003,104182,2195.949338,2,1,0,1,15,Sasa Tuksar
1987,100395,2195.945509,18,9,0,9,15,Victor Pecci
1986,101029,2195.90932,32,15,0,17,7,Ricki Osterthun
2003,103626,2195.899412,2,1,0,1,7,Tomas Tenconi
2012,106207,2195.890909,4,2,0,2,21,Mate Pavic
1985,100910,2195.861862,5,2,0,3,11,Magnus Tideman
1990,101251,2195.856327,7,3,0,4,2,Eric Winogradsky
1997,102103,2195.848148,2,1,0,1,12,Michael Sell
1995,102397,2195.841139,3,1,0,2,12,Jose Imaz Ruiz
1988,101598,2195.837143,1,0,0,1,19,Eduardo Velez
1994,108842,2195.837006,4,2,0,2,36,Zulfiqar Ahmed
2004,108657,2195.820866,1,0,0,1,8,Alexander Skrypko
1997,102348,2195.819304,4,2,0,2,19,Hideki Kaneko
1994,102088,2195.812235,36,17,0,19,3,Joern Renzenbrink
2008,103084,2195.806508,44,22,0,22,2,Guillermo Canas
2004,103830,2195.805409,2,1,0,1,7,Shao Xuan Zeng
1993,102669,2195.801204,1,0,0,1,7,Noam Behr
1994,100870,2195.771756,15,7,0,8,6,Christo Van Rensburg
1991,101234,2195.761642,45,21,0,24,3,Patrik Kuhnen
1988,101476,2195.750163,2,1,0,1,26,Rolf Hertzog
2011,104585,2195.740426,1,0,0,1,12,Gyorgy Balazs
2001,102860,2195.729832,28,12,0,16,11,Agustin Calleri
2004,104812,2195.707582,1,0,0,1,11,Scoville Jenkins
1995,101098,2195.705069,45,19,0,26,4,Guy Forget
2010,104122,2195.66502,8,4,0,4,10,Carlos Berlocq
2010,104739,2195.662169,4,2,0,2,24,Guillermo Alcaide
2003,104597,2195.650288,2,1,0,1,7,Nicolas Almagro
1997,102875,2195.597187,5,2,0,3,12,Luke Smith
1986,100395,2195.566987,14,6,0,8,10,Victor Pecci
1986,101147,2195.566378,28,12,0,16,8,Claudio Mezzadri
1998,101601,2195.565543,39,18,0,21,6,Brett Steven
2003,102494,2195.563671,27,12,0,15,3,Tomas Behrend
2012,104557,2195.546044,4,2,0,2,11,Andis Juska
2013,103888,2195.521556,9,4,0,5,14,Mardy Fish
1986,100641,2195.494698,4,2,0,2,26,Jan Van Langendonck
1993,101367,2195.442175,1,0,0,1,13,Igor Saric
1992,108390,2195.431952,4,2,0,2,6,Thomas Prerovsky
1994,101876,2195.425371,2,1,0,1,16,Massimo Ardinghi
2009,104216,2195.417322,24,11,0,13,10,Maximo Gonzalez
2006,103077,2195.417086,4,2,0,2,6,Konstantinos Economidis
1998,101805,2195.373845,17,7,0,10,4,David Nainkin
2015,105023,2195.357186,44,20,0,24,6,Sam Querrey
2012,104548,2195.32438,24,11,0,13,4,Brian Baker
2003,104332,2195.323524,5,2,0,3,6,Philipp Petzschner
1987,100652,2195.323111,33,14,0,19,2,Cassio Motta
1989,100711,2195.320829,9,4,0,5,25,Pedro Rebolledo
1996,102285,2195.307619,1,0,0,1,25,Nasser Ghanim Al Khulaifi
1997,102235,2195.302338,7,3,0,4,12,Tommy Ho
2015,105062,2195.301683,43,19,0,24,5,Mikhail Kukushkin
1990,100935,2195.262663,3,1,0,2,5,Michael Robertson
1988,101767,2195.250896,5,2,0,3,6,Lars Jonsson
1993,102133,2195.250749,8,4,0,4,16,Laurence Tieleman
2010,105001,2195.24387,1,0,0,1,8,Mao Xin Gong
2007,103254,2195.241735,2,1,0,1,24,Yves Allegro
2014,105487,2195.221416,5,2,0,3,10,Facundo Bagnis
1992,101108,2195.21605,3,1,0,2,15,Richard Schmidt
2012,104620,2195.192303,19,8,0,11,6,Simone Bolelli
1998,102548,2195.171652,47,20,0,27,2,Juan Antonio Marin
2005,103971,2195.161228,47,20,0,27,3,Karol Beck
1996,103420,2195.13529,4,2,0,2,6,Michal Tabara
1988,101191,2195.119945,33,14,0,19,3,Richey Reneberg
1994,102562,2195.117371,1,0,0,1,16,Jiri Novak
1993,101387,2195.110932,13,6,0,7,24,Claudio Pistolesi
2012,105311,2195.097959,10,5,0,5,11,Joao Sousa
1986,100978,2195.095509,9,4,0,5,22,Andrew Castle
2005,102344,2195.056684,10,4,0,6,0,Karol Kucera
1997,101549,2195.028678,3,1,0,2,21,Rodolphe Gilbert
2014,105339,2195.023106,1,0,0,1,6,Yan Bai
1987,101122,2195.015175,1,0,0,1,10,Alberto Paris
1994,101482,2195.009269,31,15,0,16,3,Markus Zoecke
2014,105011,2195.003371,9,4,0,5,9,Illya Marchenko
1996,102202,2194.99389,46,20,0,26,3,Kenneth Carlsen
2002,102694,2194.989587,40,19,0,21,3,Lars Burgsmuller
2015,104898,2194.989523,36,15,0,21,5,Robin Haase
2013,104651,2194.976334,14,6,0,8,21,Martin Alund
1991,101674,2194.942195,3,1,0,2,3,Rudiger Haas
1992,101745,2194.938787,2,1,0,1,5,Roberto Jabali
2015,105011,2194.927986,12,5,0,7,11,Illya Marchenko
2003,101897,2194.910625,14,6,0,8,28,Fernando Meligeni
1992,101022,2194.888397,3,1,0,2,3,Kelly Jones
1996,101214,2194.887474,14,6,0,8,11,Bryan Shelton
2001,103403,2194.839747,4,2,0,2,7,Takahiro Terachi
2014,103781,2194.831773,36,16,0,20,2,Jurgen Melzer
2011,103808,2194.825061,50,24,0,26,4,Potito Starace
1988,100956,2194.821151,4,2,0,2,15,Simone Colombo
2010,106045,2194.818286,2,1,0,1,23,Denis Kudla
1994,101929,2194.80072,3,1,0,2,17,Joost Winnink
1994,102443,2194.778705,1,0,0,1,22,Barry Cowan
2000,102753,2194.778581,2,1,0,1,21,Wolfgang Schranz
1993,102067,2194.763829,1,0,0,1,15,Emanuel Rasberger
2000,103070,2194.748027,1,0,0,1,12,Christophe Pognon
2014,105132,2194.73985,3,1,0,2,19,Jurgen Zopp
2008,105166,2194.738866,6,3,0,3,16,Peter Polansky
2005,104660,2194.729638,6,3,0,3,3,Sergiy Stakhovsky
1994,103009,2194.728879,7,3,0,4,9,Razvan Sabau
2012,104661,2194.721164,1,0,0,1,24,Pierre Ludovic Duclos
1991,107607,2194.717455,1,0,0,1,16,Lukas Thomas
1998,102192,2194.686944,10,5,0,5,2,Luis Adrian Morejon
1993,101281,2194.676263,1,0,0,1,14,Shelby Cannon
1995,102624,2194.674483,1,0,0,1,22,Andrew Painter
1991,100768,2194.653359,5,2,0,3,23,Nick Brown
2007,103151,2194.610614,18,8,0,10,12,Mariano Zabaleta
2008,102811,2194.604151,3,1,0,2,14,Dusan Vemic
2002,103709,2194.582407,37,15,0,22,5,Kristian Pless
1996,102131,2194.567867,5,2,0,3,10,Alistair Hunt
2015,105583,2194.562597,38,17,0,21,3,Dusan Lajovic
1987,101339,2194.522515,2,1,0,1,27,Agustin Moreno
1998,103060,2194.516934,13,6,0,7,4,Alejandro Hernandez
1994,101682,2194.514423,18,8,0,10,6,David Adams
2004,102035,2194.514043,47,21,0,26,2,Jonas Bjorkman
1996,101334,2194.50103,35,13,0,22,6,Alexander Volkov
1997,101373,2194.497694,5,2,0,3,5,Karsten Braasch
1987,100995,2194.476004,3,1,0,2,10,Eduardo Masso
2000,102086,2194.469265,1,0,0,1,4,Igor Kornienko
1995,101735,2194.464684,38,18,0,20,6,Richard Fromberg
2003,102834,2194.460719,9,4,0,5,9,Paul Goldstein
1993,101733,2194.447587,49,24,0,25,3,Jan Siemerink
2001,102835,2194.438994,1,0,0,1,21,Luke Milligan
1990,101026,2194.428974,34,16,0,18,1,Jim Grabb
1994,101062,2194.420002,37,17,0,20,4,Mats Wilander
1991,101031,2194.418395,7,3,0,4,9,Massimo Cierro
2010,103675,2194.418016,5,2,0,3,34,Diego Junqueira
2000,102263,2194.40697,5,2,0,3,8,Yong Il Yoon
2001,103193,2194.403454,22,11,0,11,3,Peter Wessels
1996,102585,2194.358749,2,1,0,1,11,Sebastian Prieto
1988,100939,2194.341246,42,22,0,20,3,Joey Rive
1987,101543,2194.329139,3,1,0,2,21,Jeff Tarango
1993,101407,2194.310715,3,1,0,2,5,David Engel
1992,101030,2194.273815,40,18,0,22,7,Goran Prpic
1987,100565,2194.24558,5,2,0,3,16,Lloyd Bourne
2010,103484,2194.230375,32,15,0,17,5,James Blake
2012,105438,2194.216777,5,2,0,3,22,Inigo Cervantes Huegun
1986,100914,2194.178235,1,0,0,1,9,Jean Marc Piacentile
2007,103530,2194.175584,10,4,0,6,7,Zack Fleishman
1987,100800,2194.16529,38,18,0,20,2,Diego Perez
1991,100713,2194.138498,12,5,0,7,8,John Fitzgerald
2005,103594,2194.118807,7,3,0,4,5,Oliver Marach
1993,102028,2194.084018,5,2,0,3,17,Massimo Valeri
2014,104882,2194.068097,15,7,0,8,10,Blaz Kavcic
2011,107552,2194.064881,1,0,0,1,21,Laurent Bram
1994,100943,2194.058588,6,3,0,3,10,Girts Dzelde
2009,104947,2194.056668,5,2,0,3,8,Marsel Ilhan
2002,103799,2194.001754,1,0,0,1,22,Eric Prodon
1997,101133,2194.001442,5,2,0,3,12,Patrick Baur
2011,103444,2193.978626,7,3,0,4,13,Jean Rene Lisnard
1992,101776,2193.973482,39,19,0,20,6,Sandon Stolle
1999,102300,2193.947422,8,4,0,4,22,Gouichi Motomura
2014,104022,2193.94164,42,18,0,24,2,Mikhail Youzhny
1994,102118,2193.929779,5,2,0,3,3,Radomir Vasek
1989,101373,2193.922153,5,2,0,3,21,Karsten Braasch
1993,102104,2193.913909,5,2,0,3,15,Christian Ruud
1993,101348,2193.89769,11,5,0,6,20,Dave Randall
2007,103535,2193.882863,12,5,0,7,16,Olivier Patience
1993,100997,2193.880865,5,2,0,3,11,Roger Smith
1999,101589,2193.878313,3,1,0,2,23,Arnaud Boetsch
2014,104534,2193.850273,39,18,0,21,4,Dudi Sela
2010,105053,2193.847405,44,20,0,24,2,Santiago Giraldo
1997,102053,2193.838848,7,3,0,4,14,Brian Macphie
2013,104639,2193.83052,5,2,0,3,22,Wayne Odesnik
1986,100544,2193.801491,14,7,0,7,8,Tony Mmoh
2014,104122,2193.800635,38,19,0,19,3,Carlos Berlocq
2004,104198,2193.75099,12,5,0,7,6,Guillermo Garcia Lopez
1996,102581,2193.74978,3,1,0,2,10,Goran Oresic
1987,101405,2193.746923,1,0,0,1,42,Ugo Colombini
2011,104226,2193.744801,3,1,0,2,19,Bastian Knittel
2004,103318,2193.739638,3,1,0,2,17,Zeljko Krajan
1993,100837,2193.73895,29,12,0,17,7,Jeremy Bates
2006,102887,2193.735456,17,8,0,9,6,Ramon Delgado
2007,104004,2193.703179,3,1,0,2,6,Filip Prpic
1992,101071,2193.684458,10,4,0,6,3,Tom Nijssen
1992,101549,2193.682981,39,18,0,21,6,Rodolphe Gilbert
2006,103339,2193.672042,5,2,0,3,14,Wesley Whitehouse
2011,104997,2193.658886,5,2,0,3,11,Igor Sijsling
2001,103174,2193.640155,10,4,0,6,6,Noam Okun
1991,101901,2193.62083,22,10,0,12,3,Chuck Adams
2003,102999,2193.619305,3,1,0,2,19,Stefano Galvani
2008,104424,2193.617059,7,3,0,4,6,Go Soeda
1995,102300,2193.615723,3,1,0,2,7,Gouichi Motomura
2007,103747,2193.604656,4,2,0,2,8,Dominik Meffert
2004,104379,2193.603369,24,12,0,12,8,Todd Reid
1996,101608,2193.582675,5,2,0,3,11,Tom Kempers
1991,101071,2193.576514,8,3,0,5,3,Tom Nijssen
1999,102835,2193.570239,3,1,0,2,20,Luke Milligan
2005,103830,2193.56177,1,0,0,1,9,Shao Xuan Zeng
2003,103455,2193.559267,5,2,0,3,8,Michal Mertinak
2009,104424,2193.5354,5,2,0,3,8,Go Soeda
2003,103468,2193.534047,1,0,0,1,8,Harsh Mankad
1994,101565,2193.532162,1,0,0,1,11,Marius Barnard
2001,103157,2193.520236,5,2,0,3,21,Arvind Parmar
1992,101284,2193.485848,13,6,0,7,5,Lars Anders Wahlgren
2002,102286,2193.485105,7,3,0,4,8,Wayne Black
2007,102388,2193.470342,1,0,0,1,9,Simon Aspelin
1987,101812,2193.459275,1,0,0,1,10,Raviv Weidenfeld
2000,103908,2193.451748,5,2,0,3,7,Paul Henri Mathieu
2004,103240,2193.431547,5,2,0,3,10,Kevin Kim
1991,100837,2193.401466,13,6,0,7,3,Jeremy Bates
2000,102153,2193.400998,3,1,0,2,21,German Puentes
2009,104579,2193.391556,1,0,0,1,26,Romain Jouan
2013,105649,2193.388927,5,2,0,3,25,Cedrik Marcel Stebe
2009,103813,2193.375861,29,14,0,15,3,Jarkko Nieminen
1997,101687,2193.360829,2,1,0,1,20,David Dilucia
2006,103521,2193.356721,5,2,0,3,14,Andrea Stoppini
1990,101432,2193.35525,3,1,0,2,4,Dimitri Poliakov
1999,102607,2193.349719,3,1,0,2,10,Juan Balcells
2007,103063,2193.335868,1,0,0,1,3,Sebastien De Chaunac
1989,101416,2193.324157,7,3,0,4,37,Joao Cunha Silva
1990,101767,2193.30283,29,12,0,17,4,Lars Jonsson
2001,103428,2193.278926,20,10,0,10,11,Juan Ignacio Chela
2005,103646,2193.276132,1,0,0,1,20,Lars Uebel
1991,100954,2193.267276,47,22,0,25,3,Luiz Mattar
1994,102610,2193.246179,33,15,0,18,4,Albert Costa
2007,104914,2193.236675,1,0,0,1,6,Ervin Eleskovic
2014,106298,2193.21986,6,2,0,4,2,Lucas Pouille
2006,103852,2193.1932,47,19,0,28,3,Feliciano Lopez
1985,100646,2193.185015,33,17,0,16,9,Claudio Panatta
1998,101490,2193.181038,1,0,0,1,19,Daniel Orsanic
2004,104312,2193.172576,17,7,0,10,5,Andreas Seppi
2007,104305,2193.160776,5,2,0,3,7,Luka Gregorc
1996,101688,2193.158893,3,1,0,2,14,Geoff Grant
2004,102231,2193.152795,13,6,0,7,7,Alex Calatrava
2000,102300,2193.152663,9,4,0,5,8,Gouichi Motomura
2013,104327,2193.149757,12,5,0,7,12,Steve Darcis
1985,101439,2193.147618,1,0,0,1,13,Javier Sanchez
1996,101234,2193.140725,3,1,0,2,7,Patrik Kuhnen
1998,103206,2193.137458,35,16,0,19,2,Sebastien Grosjean
2002,103700,2193.126986,1,0,0,1,19,Juan Pablo Guzman
1994,102434,2193.124141,24,11,0,13,3,Vincent Spadea
1986,101243,2193.123492,3,1,0,2,4,Roberto Azar
1995,102753,2193.121632,1,0,0,1,6,Wolfgang Schranz
1993,101819,2193.119479,1,0,0,1,26,Frederic Vitoux
2004,103817,2193.11762,3,1,0,2,8,Yu Jr Wang
1998,102588,2193.11648,3,1,0,2,5,Lars Rehmann
1991,101912,2193.115268,7,3,0,4,3,Felipe Rivera
2007,104378,2193.098004,3,1,0,2,19,Yordan Kanev
1996,108511,2193.091568,1,0,0,1,17,Werner Hipfl
1994,102455,2193.082436,1,0,0,1,21,Lorenzo Manta
1987,101717,2193.073618,3,1,0,2,13,Diego Nargiso
1997,102694,2193.03987,6,3,0,3,32,Lars Burgsmuller
2000,101938,2193.039716,5,2,0,3,9,Bernardo Mota
2007,103204,2193.034519,5,2,0,3,11,Hugo Armando
2015,104122,2193.028274,18,8,0,10,19,Carlos Berlocq
2009,105683,2193.017523,1,0,0,1,15,Milos Raonic
2003,103694,2193.015233,54,24,0,30,3,Olivier Rochus
1997,102831,2193.009487,14,6,0,8,2,Jacobo Diaz
2001,102785,2193.002836,6,3,0,3,14,Glenn Weiner
1990,101581,2192.995287,1,0,0,1,8,Jose Luis Aparisi
2005,103808,2192.992266,37,17,0,20,9,Potito Starace
2005,103318,2192.979862,1,0,0,1,15,Zeljko Krajan
1992,101311,2192.960783,5,2,0,3,14,Kent Kinnear
2003,103181,2192.929401,16,7,0,9,14,Jiri Vanek
2013,103708,2192.914571,3,1,0,2,6,Jaroslav Pospisil
1987,100502,2192.911728,4,2,0,2,21,Vincent Van Patten
2003,103174,2192.909508,9,4,0,5,12,Noam Okun
1999,103157,2192.890457,3,1,0,2,20,Arvind Parmar
1993,100728,2192.865643,5,2,0,3,16,Todd Nelson
2009,103830,2192.862462,7,3,0,4,7,Shao Xuan Zeng
1996,102363,2192.855561,3,1,0,2,9,Filippo Veglio
1990,101776,2192.846242,5,2,0,3,6,Sandon Stolle
1989,101295,2192.837471,5,2,0,3,8,Toshihisa Tsuchihashi
1985,100281,2192.83235,1,0,0,1,10,Sashi Menon
1985,100553,2192.812594,22,9,0,13,4,Nduka Odizor
2012,104779,2192.811716,5,2,0,3,22,Jamie Baker
1992,102201,2192.80451,5,2,0,3,6,Lionel Roux
2003,104198,2192.795429,1,0,0,1,27,Guillermo Garcia Lopez
1998,101888,2192.786188,55,25,0,30,2,Daniel Vacek
2000,102135,2192.783915,13,6,0,7,11,Emilio Benfele Alvarez
1985,100677,2192.775973,1,0,0,1,19,Bob Blazekovic
1989,107201,2192.773914,1,0,0,1,8,Hidehiko Tanizawa
1992,101704,2192.768782,1,0,0,1,12,Ellis Ferreira
1987,101126,2192.762389,3,1,0,2,19,Chris Pridham
1989,101900,2192.761011,16,7,0,9,5,Nicklas Kulti
1995,100926,2192.760194,1,0,0,1,22,Ken Flach
1997,102304,2192.758181,5,2,0,3,43,Grant Doyle
1987,100926,2192.712353,23,10,0,13,11,Ken Flach
2004,102259,2192.709698,9,4,0,5,10,Jerome Golmard
2005,104327,2192.709554,1,0,0,1,8,Steve Darcis
2010,104882,2192.701215,16,7,0,9,11,Blaz Kavcic
2002,102521,2192.699837,1,0,0,1,21,Hendrik Dreekmann
1986,100913,2192.675833,7,3,0,4,5,Peter Carlsson
1991,101362,2192.646785,5,2,0,3,12,Stephane Simian
2007,103830,2192.64358,1,0,0,1,11,Shao Xuan Zeng
1998,101860,2192.632112,3,1,0,2,20,Mark Draper
2008,103573,2192.627865,15,7,0,8,6,Rik De Voest
2012,105936,2192.622885,3,1,0,2,26,Filip Krajinovic
1992,101711,2192.614527,8,3,0,5,12,Alex Obrien
2001,102644,2192.585457,56,27,0,29,2,Franco Squillari
1987,101321,2192.580866,1,0,0,1,13,Juan Carlos Baguena
1987,100865,2192.576312,3,1,0,2,3,Marcelo Ingaramo
1995,102110,2192.570195,10,4,0,6,10,Daniel Nestor
1988,101932,2192.562719,3,1,0,2,17,Jared Palmer
1994,101959,2192.561834,1,0,0,1,12,Robert Eriksson
1989,101276,2192.557872,32,15,0,17,10,Horacio De La Pena
2011,105155,2192.557841,1,0,0,1,31,Pedro Sousa
1987,100797,2192.546684,38,18,0,20,4,Ben Testerman
2002,102106,2192.545006,46,24,0,22,2,Davide Sanguinetti
2014,104620,2192.536925,15,6,0,9,3,Simone Bolelli
2012,105379,2192.534179,12,6,0,6,0,Aljaz Bedene
2015,103656,2192.514613,15,7,0,8,5,Albert Montanes
2001,102836,2192.510859,3,1,0,2,19,Rogier Wassen
1997,101179,2192.501291,9,4,0,5,23,Jean Philippe Fleurian
1997,102585,2192.496234,3,1,0,2,2,Sebastian Prieto
1991,101412,2192.487895,44,23,0,21,3,Shuzo Matsuoka
1996,102567,2192.484454,1,0,0,1,6,George Bastl
2001,103204,2192.481979,10,4,0,6,8,Hugo Armando
1991,100790,2192.480262,3,1,0,2,43,Bruce Derlin
2011,104579,2192.479703,1,0,0,1,13,Romain Jouan
1990,100866,2192.469115,3,1,0,2,5,Shahar Perkiss
1994,101704,2192.463713,7,3,0,4,12,Ellis Ferreira
2012,103990,2192.46197,12,5,0,7,5,Tommy Robredo
1985,100564,2192.461807,3,1,0,2,10,Cary Stansbury
1988,100836,2192.458178,21,9,0,12,10,Glenn Michibata
2006,104770,2192.456127,1,0,0,1,5,Martin Fischer
1986,107468,2192.451558,5,2,0,3,22,Julian Stamatov
1991,101686,2192.434436,28,12,0,16,12,Franco Davin
1989,100864,2192.433792,14,6,0,8,12,Martin Wostenholme
1986,101216,2192.433607,6,3,0,3,8,Olli Rahnasto
2004,104268,2192.42698,12,5,0,7,7,Alejandro Falla
2004,102950,2192.357037,9,4,0,5,17,Fernando Vicente
1986,101085,2192.35469,7,3,0,4,12,Corrado Aprili
1998,102202,2192.352833,48,23,0,25,2,Kenneth Carlsen
1987,100556,2192.352101,1,0,0,1,10,Brian Levine
2006,103472,2192.34981,3,1,0,2,16,Karim Maamoun
2000,103457,2192.336969,3,1,0,2,14,Petr Kralert
1992,101448,2192.30199,7,3,0,4,8,Tasos Bavelas
1996,101849,2192.297306,1,0,0,1,8,Nicola Bruno
1990,101703,2192.279265,15,6,0,9,2,Guillaume Raoux
1992,101710,2192.278432,3,1,0,2,13,Martin Blackman
1994,102133,2192.250792,1,0,0,1,22,Laurence Tieleman
1998,101373,2192.232196,7,3,0,4,7,Karsten Braasch
2009,105137,2192.224594,5,2,0,3,10,Pere Riba
1995,102263,2192.223948,5,2,0,3,31,Yong Il Yoon
2010,104770,2192.221231,5,2,0,3,5,Martin Fischer
1995,101814,2192.217355,1,0,0,1,23,Colin Beecher
2008,104171,2192.212357,1,0,0,1,23,Richard Bloomfield
1999,102694,2192.209707,15,7,0,8,6,Lars Burgsmuller
1993,102161,2192.208956,1,0,0,1,6,Robert Kroll
1997,102076,2192.204521,7,3,0,4,14,Mark Merklein
1998,102897,2192.204483,1,0,0,1,10,Nir Welgreen
2012,104714,2192.203616,3,1,0,2,20,Julian Reister
2003,103082,2192.189455,3,1,0,2,25,Markus Hantschk
2003,104098,2192.18923,5,2,0,3,10,Dmitry Tursunov
2015,144719,2192.183262,3,1,0,2,17,Jaume Munar
2008,104308,2192.171773,5,2,0,3,17,Michal Przysiezny
1992,102344,2192.162941,1,0,0,1,15,Karol Kucera
1995,101436,2192.160656,1,0,0,1,12,George Cosac
2008,104261,2192.1526,5,2,0,3,7,Peng Sun
1991,101715,2192.148626,3,1,0,2,9,Jose Antonio Pepe Conde
1997,102966,2192.127056,1,0,0,1,2,Fredrik Jonsson
2006,102800,2192.125544,1,0,0,1,3,Nenad Zimonjic
1999,103344,2192.124128,25,11,0,14,6,Ivan Ljubicic
1995,101704,2192.120783,3,1,0,2,15,Ellis Ferreira
2007,103171,2192.107754,9,4,0,5,9,Raemon Sluiter
1996,102227,2192.107653,10,4,0,6,5,Sargis Sargsian
1986,100887,2192.088728,3,1,0,2,19,Eric Korita
2012,104523,2192.087893,24,11,0,13,21,Frederico Gil
2010,104628,2192.085391,1,0,0,1,26,Alexander Kudryavtsev
1992,101566,2192.080214,1,0,0,1,6,Fabien Cousin
1994,100581,2192.07539,1,0,0,1,40,John Mcenroe
2005,103110,2192.061611,18,7,0,11,5,Daniele Bracciali
2004,102863,2192.057558,10,4,0,6,6,Takao Suzuki
1996,102212,2192.046994,1,0,0,1,26,Corrado Borroni
1987,101368,2192.040514,23,11,0,12,3,Christian Miniussi
2005,102143,2192.023051,3,1,0,2,7,Nicolas Thomann
2010,105683,2192.017701,10,4,0,6,8,Milos Raonic
1999,101731,2192.01503,5,2,0,3,9,Nuno Marques
2006,105231,2192.001888,1,0,0,1,15,Luka Belic
2002,104250,2191.988061,1,0,0,1,10,Prakash Amritraj
2000,103909,2191.974375,7,3,0,4,16,Guillermo Coria
1990,101851,2191.953763,7,3,0,4,5,Alexis Hombrecher
2006,103080,2191.948727,1,0,0,1,8,Paul Hanley
1996,101672,2191.941294,1,0,0,1,11,Michael Geserer
1985,100321,2191.939463,34,14,0,20,10,Vijay Amritraj
1996,101976,2191.930852,8,4,0,4,10,Federico Dondo
2010,105373,2191.916827,7,3,0,4,11,Martin Klizan
1994,101968,2191.882428,3,1,0,2,16,Ola Kristiansson
1990,100967,2191.881349,50,24,0,26,5,Dan Goldie
2007,103184,2191.865898,3,1,0,2,0,Bob Bryan
1998,102753,2191.86508,7,3,0,4,6,Wolfgang Schranz
2000,102167,2191.862781,5,2,0,3,7,Juan Albert Viloca Puig
1995,103060,2191.861405,3,1,0,2,17,Alejandro Hernandez
2000,103297,2191.854339,1,0,0,1,14,Alex Kim
1998,102809,2191.83956,1,0,0,1,7,Axel Pretzsch
1986,100696,2191.836932,5,2,0,3,19,Mark Buckley
2000,103181,2191.821727,25,12,0,13,12,Jiri Vanek
1996,102623,2191.819618,1,0,0,1,10,Thomas Larsen
1988,100779,2191.800625,1,0,0,1,3,Kevin Moir
2005,104914,2191.795699,1,0,0,1,5,Ervin Eleskovic
1986,101110,2191.782808,19,7,0,12,13,David De Miguel
2006,102110,2191.770248,1,0,0,1,13,Daniel Nestor
1997,103387,2191.762433,1,0,0,1,6,Paradorn Srichaphan
1993,101991,2191.758945,13,6,0,7,17,Mauricio Hadad
1986,101284,2191.755144,1,0,0,1,21,Lars Anders Wahlgren
1998,103457,2191.753863,1,0,0,1,28,Petr Kralert
2012,103580,2191.751833,1,0,0,1,35,Alexander Peya
2005,104542,2191.748114,1,0,0,1,22,Jo Wilfried Tsonga
2008,105590,2191.732629,5,2,0,3,8,Uladzimir Ignatik
1991,100728,2191.716127,5,2,0,3,8,Todd Nelson
2000,103350,2191.711118,1,0,0,1,6,Denis Golovanov
1996,102351,2191.704185,3,1,0,2,31,Oscar Martinez
2003,103917,2191.703268,9,3,0,6,2,Nicolas Mahut
1985,101057,2191.701493,3,1,0,2,9,Peter Carter
2005,104026,2191.686431,33,19,0,14,18,Joachim Johansson
2005,103730,2191.645945,3,1,0,2,19,Jonathan Marray
1994,102001,2191.642036,1,0,0,1,31,German Lopez
1988,101416,2191.629484,5,2,0,3,20,Joao Cunha Silva
2012,105072,2191.629119,3,1,0,2,9,Sanam Singh
1989,100857,2191.626426,22,9,0,13,14,Sergio Casal
2001,102169,2191.61896,3,1,0,2,14,Michael Joyce
1996,102372,2191.611237,3,1,0,2,17,Sule Ladipo
2006,103580,2191.601527,7,3,0,4,7,Alexander Peya
2004,102880,2191.600679,26,11,0,15,11,Alexander Popp
1986,101134,2191.598043,1,0,0,1,5,Fredrik Waern
1986,101191,2191.592111,5,2,0,3,3,Richey Reneberg
2004,103722,2191.58861,5,2,0,3,5,Florent Serra
1988,108321,2191.587658,1,0,0,1,14,Steven Alger
2012,104136,2191.575833,1,0,0,1,38,Santiago Gonzalez
2013,104693,2191.562209,1,0,0,1,10,Dominic Inglot
2002,102533,2191.561787,3,1,0,2,16,Jens Knippschild
2009,105783,2191.561249,1,0,0,1,12,Chase Buchanan
1990,100768,2191.551687,9,4,0,5,17,Nick Brown
2011,104136,2191.545261,3,1,0,2,5,Santiago Gonzalez
2006,105501,2191.513779,1,0,0,1,7,Akash Wagh
2006,104732,2191.487416,1,0,0,1,10,Phillip Simmonds
2008,104898,2191.47951,27,14,0,13,20,Robin Haase
1997,101783,2191.472856,5,2,0,3,11,Mark Petchey
1995,101636,2191.469845,8,3,0,5,19,Wade Mcguire
2014,105173,2191.468926,39,16,0,23,2,Adrian Mannarino
1989,101147,2191.468409,31,15,0,16,11,Claudio Mezzadri
1993,101715,2191.464613,1,0,0,1,31,Jose Antonio Pepe Conde
1991,101143,2191.451862,1,0,0,1,3,Branislav Stankovic
1991,100727,2191.44358,1,0,0,1,33,Raul Antonio Viver
1996,102153,2191.441763,1,0,0,1,16,German Puentes
1988,101238,2191.431062,8,3,0,5,9,Andres Vysand
2009,103544,2191.410145,1,0,0,1,11,Andy Ram
1985,100782,2191.406391,29,13,0,16,14,Pablo Arraya
1993,101481,2191.404068,26,13,0,13,24,Omar Camporese
2013,105341,2191.402191,1,0,0,1,13,Thomas Fabbiano
1985,101325,2191.396002,1,0,0,1,24,Jason Goodall
2001,103999,2191.385184,1,0,0,1,11,Thiago Alves
1994,102753,2191.381444,5,2,0,3,6,Wolfgang Schranz
2001,103248,2191.379564,45,20,0,25,7,Harel Levy
1988,101578,2191.371965,19,8,0,11,5,Markus Rackl
2003,103325,2191.368215,22,11,0,11,3,Wesley Moodie
1994,101688,2191.364316,1,0,0,1,13,Geoff Grant
2012,104810,2191.361081,1,0,0,1,7,Zhe Li
2003,103735,2191.355591,1,0,0,1,15,Lovro Zovko
1991,102446,2191.343274,12,5,0,7,3,Andrei Medvedev
2007,102035,2191.330559,39,18,0,21,3,Jonas Bjorkman
1995,102162,2191.330507,3,1,0,2,13,Chris Woodruff
1988,101264,2191.329116,5,2,0,3,14,Michael Tauson
1989,100490,2191.319521,1,0,0,1,9,Jaroslav Navratil
1987,100820,2191.300486,3,1,0,2,30,Thierry Pham
2002,102100,2191.275584,1,0,0,1,15,Bartlomiej Dabrowski
2010,105614,2191.27171,1,0,0,1,13,Bradley Klahn
1996,101016,2191.2417,13,6,0,7,6,Marcos Aurelio Gorriz
2003,102886,2191.240596,12,5,0,7,3,Frantisek Cermak
2004,104467,2191.240323,3,1,0,2,13,Lamine Ouahab
1992,101358,2191.239313,45,19,0,26,3,Olivier Delaitre
2005,102882,2191.237541,20,9,0,11,3,Mark Philippoussis
1986,101263,2191.234991,3,1,0,2,16,Luke Jensen
1988,107678,2191.230157,1,0,0,1,3,Marius Masencamp
2007,104783,2191.22161,3,1,0,2,3,Mikhail Ledovskikh
2003,103133,2191.205839,34,16,0,18,6,Olivier Mutis
2002,103319,2191.202001,21,9,0,12,6,Jeff Morrison
1990,102446,2191.193479,1,0,0,1,1,Andrei Medvedev
1994,102053,2191.192049,7,3,0,4,21,Brian Macphie
2000,103566,2191.175305,12,5,0,7,3,Michael Llodra
2010,105906,2191.172708,1,0,0,1,32,Kevin Krawietz
1996,102795,2191.172645,1,0,0,1,12,Scott Humphries
1998,103193,2191.170909,3,1,0,2,21,Peter Wessels
2005,103582,2191.166989,3,1,0,2,3,Michael Berrer
1994,100713,2191.156789,1,0,0,1,22,John Fitzgerald
1999,101515,2191.150561,3,1,0,2,19,Donald Johnson
2005,103252,2191.14967,54,25,0,29,3,Alberto Martin
1995,101577,2191.146928,7,3,0,4,6,Jia Ping Xia
2008,103553,2191.141618,5,2,0,3,38,Alun Jones
2007,103781,2191.134528,49,23,0,26,2,Jurgen Melzer
1995,102131,2191.114209,1,0,0,1,10,Alistair Hunt
2013,103863,2191.105895,1,0,0,1,10,Mikhail Elgin
2011,105208,2191.103884,40,18,0,22,4,Ernests Gulbis
2010,105147,2191.095657,5,2,0,3,8,Tatsuma Ito
2005,103523,2191.091183,1,0,0,1,8,Rohan Bopanna
1990,101812,2191.087027,1,0,0,1,5,Raviv Weidenfeld
2001,102999,2191.07483,1,0,0,1,24,Stefano Galvani
1994,100852,2191.067694,1,0,0,1,31,Howard Herr
1986,101550,2191.062196,1,0,0,1,16,Al Parker
1989,101469,2191.053427,3,1,0,2,13,Brian Garrow
2007,104332,2191.040339,3,1,0,2,9,Philipp Petzschner
2013,105671,2191.015596,7,3,0,4,11,Gastao Elias
1990,101147,2191.009784,5,2,0,3,8,Claudio Mezzadri
1995,101534,2191.006762,3,1,0,2,8,Libor Nemecek
2006,104338,2191.00526,41,18,0,23,5,Juan Monaco
2015,105325,2191.004461,1,0,0,1,26,Germain Gigounon
2006,103908,2191.001194,51,23,0,28,2,Paul Henri Mathieu
1996,103104,2190.981456,1,0,0,1,20,Bjorn Rehnquist
1990,101995,2190.978937,1,0,0,1,3,Krister Wedenby
1985,100618,2190.97613,36,17,0,19,1,Leif Shiras
2013,105065,2190.973242,19,8,0,11,13,Tim Smyczek
1998,101594,2190.955518,1,0,0,1,2,Carsten Arriens
2007,104890,2190.945791,1,0,0,1,6,Andreas Haider Maurer
1988,101686,2190.945024,23,9,0,14,5,Franco Davin
2013,111513,2190.936309,1,0,0,1,9,Laslo Djere
1986,107884,2190.936146,1,0,0,1,19,Oliver Ploner
2010,105539,2190.934129,3,1,0,2,5,Evgeny Donskoy
1995,101492,2190.932178,7,3,0,4,3,Sander Groen
1993,101071,2190.930633,11,4,0,7,7,Tom Nijssen
1985,101350,2190.916467,1,0,0,1,21,Christian Feenstra
2003,103239,2190.915771,1,0,0,1,18,Marcus Sarstrand
2006,104330,2190.901917,1,0,0,1,13,Rajeev Ram
1997,102791,2190.898867,1,0,0,1,16,Bobby Kokavec
1990,100956,2190.895209,7,3,0,4,13,Simone Colombo
2002,102300,2190.894151,7,3,0,4,6,Gouichi Motomura
1994,101594,2190.893477,8,3,0,5,6,Carsten Arriens
1997,103457,2190.875985,1,0,0,1,5,Petr Kralert
1998,102024,2190.839666,20,8,0,12,9,Hernan Gumy
2014,106043,2190.834263,6,2,0,4,10,Diego Sebastian Schwartzman
2013,106006,2190.833325,1,0,0,1,38,Agustin Velotti
2003,101820,2190.832238,15,6,0,9,3,Marc Rosset
2001,103497,2190.826205,1,0,0,1,21,Artem Derepasko
1994,110867,2190.825061,1,0,0,1,36,Anders Haseth
1985,100672,2190.824904,1,0,0,1,18,Derek Segal
1985,100674,2190.80529,3,1,0,2,27,Jeff Turpin
2003,102864,2190.802784,1,0,0,1,21,Frank Moser
1989,101353,2190.796692,1,0,0,1,10,Lionel Barthez
2015,106210,2190.796322,54,24,0,30,3,Jiri Vesely
1995,101230,2190.793403,45,20,0,25,1,Andrei Chesnokov
2013,105472,2190.784543,3,1,0,2,6,Nils Langer
2001,102382,2190.783623,3,1,0,2,6,Julian Knowle
2014,106210,2190.783264,33,16,0,17,4,Jiri Vesely
2010,105341,2190.770324,1,0,0,1,10,Thomas Fabbiano
1993,100773,2190.761919,1,0,0,1,23,Brian Joelson
2000,102836,2190.746487,1,0,0,1,25,Rogier Wassen
1989,101093,2190.744328,1,0,0,1,25,Steve Devries
2011,104547,2190.741946,11,5,0,6,13,Horacio Zeballos
1997,101659,2190.737308,3,1,0,2,6,Jan Apell
1996,101902,2190.732707,1,0,0,1,21,Stephane Huet
1993,101788,2190.72329,14,6,0,8,6,Doug Flach
1996,102234,2190.721454,10,4,0,6,3,Oliver Gross
2008,105122,2190.699603,3,1,0,2,3,Karlis Lejnieks
2012,103781,2190.696298,45,20,0,25,3,Jurgen Melzer
2006,102318,2190.661125,37,16,0,21,3,Andrei Pavel
1990,100586,2190.656291,3,1,0,2,11,Eliot Teltscher
2002,103914,2190.645772,1,0,0,1,35,Omar Awadhy
2001,103319,2190.638274,1,0,0,1,15,Jeff Morrison
1993,101815,2190.637008,1,0,0,1,22,Sergio Gomez Barrio
1994,101764,2190.63578,5,2,0,3,30,Yu Hui Lien
2007,104361,2190.605204,1,0,0,1,24,Michel Koning
2010,105030,2190.602786,3,1,0,2,11,Michael Venus
1992,108354,2190.592198,1,0,0,1,8,Talito Corrales
2005,103254,2190.588375,1,0,0,1,18,Yves Allegro
1993,101332,2190.58115,10,4,0,6,7,Gilad Bloom
1991,100901,2190.569801,5,2,0,3,15,Paul Annacone
2009,103395,2190.563999,1,0,0,1,10,Julio Silva
2011,105128,2190.547151,3,1,0,2,19,Guillermo Olaso
1991,101660,2190.537492,5,2,0,3,12,Francisco Montana
2008,103294,2190.537037,12,5,0,7,3,Christophe Rochus
2000,101793,2190.52057,9,4,0,5,39,Jim Courier
1992,101248,2190.507091,1,0,0,1,16,Pat Crow
2014,106426,2190.48456,5,2,0,3,32,Christian Garin
1995,102304,2190.452324,3,1,0,2,41,Grant Doyle
2007,104707,2190.451975,3,1,0,2,3,Denis Matsukevitch
1994,102533,2190.438921,1,0,0,1,31,Jens Knippschild
2007,103718,2190.427929,1,0,0,1,8,David Martin
1989,101438,2190.424863,1,0,0,1,9,Michael Bauer
1999,102834,2190.420568,27,12,0,15,6,Paul Goldstein
2012,103096,2190.413026,5,2,0,3,26,Arnaud Clement
1995,101821,2190.404022,1,0,0,1,22,Peter Tramacchi
2012,105819,2190.396923,1,0,0,1,12,Guido Andreozzi
2009,105643,2190.392612,1,0,0,1,18,Federico Delbonis
1985,100835,2190.387977,1,0,0,1,28,Hans Dieter Beutel
1990,101058,2190.384633,3,1,0,2,13,Francisco Yunis
1998,102768,2190.384251,1,0,0,1,10,Federico Browne
1985,101081,2190.383871,3,1,0,2,15,Massimo Zampieri
1993,102088,2190.381688,19,8,0,11,10,Joern Renzenbrink
1999,101945,2190.344746,1,0,0,1,8,Thierry Guardiola
1985,100503,2190.343417,1,0,0,1,13,Lorenzo Fargas
1992,102139,2190.337903,3,1,0,2,7,Eyal Ran
2004,104010,2190.326827,1,0,0,1,28,Dieter Kindlmann
1992,101863,2190.308892,1,0,0,1,11,Roberto Alvarez
1987,101329,2190.305736,5,2,0,3,15,Christer Allgardh
1989,101441,2190.297507,3,1,0,2,21,Martin Sinner
2001,103487,2190.290047,19,9,0,10,2,Federico Luzzi
1989,100997,2190.286796,20,10,0,10,18,Roger Smith
1986,100939,2190.280246,1,0,0,1,18,Joey Rive
1998,102734,2190.279076,1,0,0,1,12,Lior Mor
2008,103830,2190.275899,1,0,0,1,12,Shao Xuan Zeng
1985,100126,2190.273743,1,0,0,1,45,Stan Smith
1996,102354,2190.260378,1,0,0,1,39,Jerome Hanquez
1991,101594,2190.247903,3,1,0,2,5,Carsten Arriens
1989,101113,2190.239251,12,5,0,7,35,Michael Westphal
1998,102772,2190.238835,5,2,0,3,7,Yu Zhang
1987,101500,2190.218455,19,8,0,11,7,Christian Saceanu
2013,105128,2190.212986,3,1,0,2,31,Guillermo Olaso
1989,101110,2190.211271,1,0,0,1,14,David De Miguel
2014,105550,2190.204867,7,3,0,4,17,Guido Pella
2006,103174,2190.202277,7,3,0,4,10,Noam Okun
1987,101112,2190.200601,1,0,0,1,30,Michele Fioroni
1995,101432,2190.195693,12,5,0,7,10,Dimitri Poliakov
2002,102201,2190.190499,3,1,0,2,12,Lionel Roux
1996,102167,2190.190149,12,5,0,7,6,Juan Albert Viloca Puig
2012,103926,2190.184009,7,3,0,4,20,Daniel Munoz De La Nava
1989,101264,2190.181953,11,5,0,6,10,Michael Tauson
1987,100579,2190.176892,1,0,0,1,11,Heinz Gunthardt
1999,102376,2190.163686,1,0,0,1,29,Radovan Svetlik
2006,103821,2190.158016,21,9,0,12,6,Danai Udomchoke
2006,103857,2190.151761,25,10,0,15,3,Igor Kunitsyn
1989,101650,2190.150844,5,2,0,3,10,Shane Barr
2001,102286,2190.142234,17,7,0,10,9,Wayne Black
1985,100332,2190.125754,30,13,0,17,6,Balazs Taroczy
2008,105559,2190.123928,1,0,0,1,24,Jonathan Eysseric
1991,102035,2190.123209,1,0,0,1,22,Jonas Bjorkman
1991,101682,2190.116714,1,0,0,1,14,David Adams
2008,104561,2190.11435,1,0,0,1,38,Jae Sung An
1990,101342,2190.113771,1,0,0,1,18,Patrick Galbraith
1990,102358,2190.106577,1,0,0,1,16,Thomas Enqvist
2008,102800,2190.104738,1,0,0,1,38,Nenad Zimonjic
1995,102843,2190.102322,5,2,0,3,35,Suwandi Suwandi
1996,100284,2190.09137,1,0,0,1,30,Jimmy Connors
1997,102571,2190.086147,1,0,0,1,16,Gregory Carraz
1985,100682,2190.08388,5,2,0,3,18,Ernie Fernandez
2011,102963,2190.073521,1,0,0,1,21,Robert Lindstedt
2001,103178,2190.070098,3,1,0,2,20,Johan Settergren
1994,102083,2190.070085,1,0,0,1,22,Nick Gould
2015,104269,2190.068211,50,24,0,26,3,Fernando Verdasco
2001,104068,2190.067575,8,3,0,5,12,Robby Ginepri
2013,105166,2190.066179,1,0,0,1,16,Peter Polansky
1994,102843,2190.065674,7,3,0,4,10,Suwandi Suwandi
2011,104914,2190.064334,1,0,0,1,21,Ervin Eleskovic
1998,101945,2190.062314,1,0,0,1,19,Thierry Guardiola
1996,106816,2190.055071,1,0,0,1,19,Daniel Omaboe
2015,104112,2190.051815,5,2,0,3,19,Benjamin Balleret
2007,103325,2190.036775,16,7,0,9,7,Wesley Moodie
2009,104192,2190.030183,1,0,0,1,28,Marco Crugnola
1996,102413,2190.027369,3,1,0,2,11,Andy Zingman
1985,100770,2190.023495,1,0,0,1,19,Peter Moraing
2013,105385,2190.012034,5,2,0,3,13,Donald Young
1990,101490,2190.007245,1,0,0,1,8,Daniel Orsanic
2007,103868,2190.002613,20,9,0,11,7,Ivan Navarro
2005,102851,2189.988815,3,1,0,2,10,Giorgio Galimberti
2008,105539,2189.985251,1,0,0,1,5,Evgeny Donskoy
1994,102456,2189.982086,1,0,0,1,16,Felix Mantilla
1993,101031,2189.98002,1,0,0,1,28,Massimo Cierro
1992,101536,2189.977292,1,0,0,1,14,Murphy Jensen
1994,102139,2189.971913,1,0,0,1,7,Eyal Ran
2005,103516,2189.970977,5,2,0,3,9,Nathan Healey
1995,100757,2189.969432,30,13,0,17,3,Anders Jarryd
1998,104117,2189.968921,3,1,0,2,9,Giovanni Lapentti
2004,107098,2189.964139,3,1,0,2,31,Gilles Kremer
2003,101775,2189.962684,1,0,0,1,8,Frederik Fetterlein
1995,101349,2189.958452,3,1,0,2,8,Adam Malik
1990,100536,2189.94961,18,8,0,10,6,Fernando Luna
2015,110602,2189.948995,3,1,0,2,6,Dennis Novak
1985,108806,2189.948397,1,0,0,1,20,Martin Aguirre
1986,101412,2189.947478,4,1,0,3,6,Shuzo Matsuoka
2006,103770,2189.944923,3,1,0,2,16,Kevin Sorensen
1987,101063,2189.941352,22,9,0,13,13,Jordi Arrese
2003,103066,2189.940932,3,1,0,2,31,Mark Nielsen
2002,102464,2189.93782,3,1,0,2,14,Todd Larkham
2000,102223,2189.93481,53,24,0,29,4,Karim Alami
1999,102103,2189.928618,5,2,0,3,22,Michael Sell
1991,101502,2189.925471,1,0,0,1,8,Torben Theine
1993,101680,2189.92492,1,0,0,1,11,Zeeshan Ali
1990,101328,2189.918345,1,0,0,1,13,Mihnea Ion Nastase
2013,104154,2189.913354,5,2,0,3,11,Paul Capdeville
2013,105001,2189.911005,1,0,0,1,7,Mao Xin Gong
1985,100713,2189.904648,39,17,0,22,3,John Fitzgerald
2006,102231,2189.89478,5,2,0,3,15,Alex Calatrava
2011,105099,2189.886659,10,4,0,6,17,Antonio Veic
1989,101299,2189.886073,1,0,0,1,18,Sven Salumaa
1993,101731,2189.886062,3,1,0,2,30,Nuno Marques
1990,101710,2189.878536,1,0,0,1,9,Martin Blackman
1987,100807,2189.876576,3,1,0,2,27,Marcelo Hennemann
1985,100116,2189.875038,1,0,0,1,6,Sherwood Stewart
2011,105095,2189.874632,1,0,0,1,22,Evgeny Korolev
1990,101389,2189.866215,1,0,0,1,5,Oren Motevassel
2006,104217,2189.865184,1,0,0,1,19,Simon Stadler
2000,102369,2189.863299,26,10,0,16,3,Julien Boutter
1990,100955,2189.852201,1,0,0,1,4,Yahiya Doumbia
2004,102830,2189.84698,1,0,0,1,8,Paulo Carvallo
1985,101040,2189.845436,1,0,0,1,14,Peter Lindgren
1993,101260,2189.845336,1,0,0,1,23,Sean Cole
1985,101097,2189.843528,3,1,0,2,21,Rick Leach
2010,105413,2189.840011,1,0,0,1,5,Andrej Martin
2013,104999,2189.839668,9,4,0,5,9,Mischa Zverev
2007,104999,2189.833168,14,6,0,8,5,Mischa Zverev
1987,101650,2189.827808,5,2,0,3,10,Shane Barr
2010,104717,2189.825725,3,1,0,2,24,Brendan Evans
2014,105385,2189.812348,40,18,0,22,2,Donald Young
2002,103240,2189.80608,5,2,0,3,11,Kevin Kim
1985,100864,2189.805379,16,7,0,9,11,Martin Wostenholme
1995,101900,2189.804372,14,6,0,8,13,Nicklas Kulti
1996,102132,2189.802104,1,0,0,1,26,Ivan Baron
1998,103216,2189.801909,1,0,0,1,24,Clemens Trimmel
2001,102768,2189.800114,3,1,0,2,11,Federico Browne
2011,104640,2189.797704,1,0,0,1,40,Pablo Galdon
1993,100619,2189.778148,1,0,0,1,9,George Kalovelonis
1988,101180,2189.760618,3,1,0,2,5,Jose Clavet
1986,100440,2189.760419,32,15,0,17,3,Eddie Edwards
2001,103444,2189.758169,5,2,0,3,24,Jean Rene Lisnard
2004,103328,2189.75516,1,0,0,1,10,Andres Pedroso
2014,105651,2189.753295,1,0,0,1,19,Daniel Smethurst
2011,104311,2189.750285,1,0,0,1,21,Leonardo Tavares
1991,101463,2189.748121,1,0,0,1,8,Bernd Karbacher
2009,104453,2189.746226,1,0,0,1,41,Michael Ryderstedt
2002,103663,2189.744842,1,0,0,1,10,Matias Boeker
2004,104099,2189.743608,1,0,0,1,30,Israel Matos Gil
1987,101150,2189.739292,3,1,0,2,16,Gianluca Pozzi
1987,101565,2189.737466,1,0,0,1,3,Marius Barnard
2000,102978,2189.732625,1,0,0,1,8,Zbynek Mlynarik
1996,102053,2189.72813,7,3,0,4,7,Brian Macphie
1998,102433,2189.725248,1,0,0,1,23,Mose Navarra
1997,103133,2189.720524,1,0,0,1,5,Olivier Mutis
2010,105633,2189.706421,1,0,0,1,40,Mohamed Safwat
1991,102085,2189.698966,1,0,0,1,22,Sasa Hirszon
1986,106978,2189.695726,1,0,0,1,12,Fabio Di Mauro
2012,104292,2189.687301,9,4,0,5,11,Izak Van Der Merwe
1988,100893,2189.686026,28,13,0,15,9,Joakim Nystrom
1997,102575,2189.685528,1,0,0,1,11,Julien Chauvin
2014,111578,2189.684934,1,0,0,1,3,Stefan Kozlov
1990,101591,2189.684527,5,2,0,3,17,Danny Sapsford
2013,106169,2189.682542,1,0,0,1,11,Vladyslav Manafov
1996,108816,2189.676375,3,1,0,2,19,Isaac Donkor
2010,104736,2189.665774,3,1,0,2,19,Farrukh Dustov
2002,104330,2189.665479,1,0,0,1,12,Rajeev Ram
2008,103521,2189.665354,3,1,0,2,14,Andrea Stoppini
2004,104219,2189.663334,1,0,0,1,37,Stephane Bohli
1999,103096,2189.66196,47,22,0,25,2,Arnaud Clement
1993,101805,2189.661587,9,4,0,5,14,David Nainkin
1999,101733,2189.657432,45,18,0,27,2,Jan Siemerink
1997,101775,2189.635545,18,9,0,9,6,Frederik Fetterlein
2009,104160,2189.627333,5,2,0,3,0,Lukas Dlouhy
2001,101947,2189.625901,3,1,0,2,27,Vincenzo Santopadre
1991,100747,2189.603617,14,6,0,8,13,Glenn Layendecker
1989,100524,2189.600573,1,0,0,1,40,Shozo Shiraishi
2006,104003,2189.599029,3,1,0,2,8,Victor Crivoi
2012,105120,2189.586586,1,0,0,1,39,Andres Molteni
2015,105339,2189.583934,3,1,0,2,7,Yan Bai
1985,100523,2189.579293,1,0,0,1,17,Erick Iskersky
2010,105583,2189.573912,1,0,0,1,31,Dusan Lajovic
2008,104471,2189.56553,1,0,0,1,37,Ivan Dodig
1993,101565,2189.562449,1,0,0,1,13,Marius Barnard
2009,105273,2189.560747,3,1,0,2,11,Mauricio Echazu
1990,101217,2189.552006,1,0,0,1,17,Andreas Lesch
1999,102800,2189.551465,5,2,0,3,13,Nenad Zimonjic
2014,108766,2189.550098,3,1,0,2,9,Samir Iftikhar
1992,101681,2189.547927,7,3,0,4,10,Chris Wilkinson
2006,102770,2189.54191,1,0,0,1,33,John Van Lottum
1988,100321,2189.538168,9,4,0,5,3,Vijay Amritraj
1997,101701,2189.537899,5,2,0,3,33,Bing Pan
2014,104216,2189.536186,7,3,0,4,7,Maximo Gonzalez
2010,104476,2189.533566,3,1,0,2,45,Louk Sorensen
1991,102158,2189.531418,1,0,0,1,9,Patrick Rafter
2002,102715,2189.526087,1,0,0,1,28,Ignacio Hirigoyen
1994,101660,2189.515616,3,1,0,2,11,Francisco Montana
2000,103201,2189.503345,5,2,0,3,21,Adrian Garcia
2005,103465,2189.502841,1,0,0,1,20,Paul Logtens
1988,101694,2189.50141,1,0,0,1,16,David Franco
2013,111200,2189.499079,1,0,0,1,21,Elias Ymer
1999,102168,2189.498885,1,0,0,1,23,Hector Moretti
2006,104115,2189.494912,1,0,0,1,38,Marc Kimmich
1997,101681,2189.493105,10,4,0,6,6,Chris Wilkinson
1995,101071,2189.491809,1,0,0,1,7,Tom Nijssen
1999,103174,2189.488778,3,1,0,2,9,Noam Okun
1992,101593,2189.487409,5,2,0,3,28,Chris Garner
1993,101703,2189.481251,55,27,0,28,3,Guillaume Raoux
1997,102961,2189.475738,1,0,0,1,20,Nicklas Timfjord
1993,102667,2189.475208,1,0,0,1,7,Satoshi Iwabuchi
2010,104779,2189.47244,5,2,0,3,22,Jamie Baker
1994,102768,2189.464057,1,0,0,1,3,Federico Browne
1985,100272,2189.459671,5,2,0,3,15,Sandy Mayer
2005,104975,2189.452531,1,0,0,1,5,Evgeny Kirillov
1999,102780,2189.451584,3,1,0,2,15,Frederic Niemeyer
2008,103598,2189.447913,21,9,0,12,8,Xavier Malisse
2004,103369,2189.446718,3,1,0,2,7,Melle Van Gemerden
1996,101668,2189.445912,1,0,0,1,33,Peter Nyborg
2014,104592,2189.436921,1,0,0,1,40,Ilija Bozoljac
2003,103193,2189.425274,1,0,0,1,36,Peter Wessels
1988,100620,2189.418755,10,4,0,6,15,Eduardo Osta
1999,102107,2189.407793,5,2,0,3,18,Jan Frode Andersen
2001,102375,2189.403634,1,0,0,1,11,Dinu Pescariu
2004,103238,2189.401777,1,0,0,1,22,Jean Claude Scherrer
1993,101510,2189.401495,55,25,0,30,3,Henrik Holm
1988,107149,2189.397476,1,0,0,1,2,Gunther Vanderveeren
2006,104378,2189.393781,1,0,0,1,30,Yordan Kanev
2000,102944,2189.390631,1,0,0,1,19,Stefano Cobolli
2015,105229,2189.380835,1,0,0,1,15,Philip Bester
1993,100970,2189.380585,1,0,0,1,31,Stefan Eriksson
2008,104586,2189.377754,3,1,0,2,19,Lukas Rosol
2011,104952,2189.371902,5,2,0,3,12,Martin Pedersen
2010,105376,2189.36866,1,0,0,1,32,Peter Gojowczyk
1993,102760,2189.360337,1,0,0,1,24,Rene Nicklisch
2014,104332,2189.350674,3,1,0,2,7,Philipp Petzschner
2012,105614,2189.342765,3,1,0,2,12,Bradley Klahn
1994,101462,2189.342546,16,7,0,9,7,Francisco Roig
1993,102765,2189.341116,1,0,0,1,26,Nicolas Escude
2010,105138,2189.336978,1,0,0,1,4,Roberto Bautista Agut
1993,101308,2189.334458,1,0,0,1,35,Neil Broad
1998,102369,2189.333504,3,1,0,2,8,Julien Boutter
1994,102087,2189.3272,1,0,0,1,16,Oleg Ogorodov
2006,104424,2189.326393,5,2,0,3,6,Go Soeda
2000,102567,2189.324187,40,16,0,24,2,George Bastl
1985,100496,2189.321758,1,0,0,1,10,Charles Buzz Strode
1995,102524,2189.319614,5,2,0,3,13,Neville Godwin
1987,107884,2189.316513,1,0,0,1,20,Oliver Ploner
2014,103722,2189.313669,1,0,0,1,8,Florent Serra
1995,102053,2189.307658,5,2,0,3,24,Brian Macphie
1989,101676,2189.304002,1,0,0,1,54,Adam Anderson
2006,104486,2189.30118,1,0,0,1,36,Horia Tecau
2000,102600,2189.297019,1,0,0,1,21,David Miketa
1995,101929,2189.286302,13,5,0,8,5,Joost Winnink
2003,103385,2189.279411,3,1,0,2,3,Paul Baccanello
2001,103834,2189.277983,1,0,0,1,12,Levar Harper Griffith
2015,103888,2189.277645,6,2,0,4,12,Mardy Fish
2001,102029,2189.260122,1,0,0,1,40,Filip Dewulf
2004,103460,2189.257863,1,0,0,1,5,Konstantin Don Gruber
2001,103063,2189.252993,1,0,0,1,12,Sebastien De Chaunac
2011,106058,2189.251642,3,1,0,2,13,Jack Sock
2004,103868,2189.249123,1,0,0,1,21,Ivan Navarro
1999,104022,2189.246823,1,0,0,1,2,Mikhail Youzhny
1999,102145,2189.244084,3,1,0,2,16,Francisco Cabello
2014,103656,2189.242793,29,13,0,16,10,Albert Montanes
1996,102584,2189.237773,3,1,0,2,20,Alexandre Strambini
2007,102963,2189.229435,1,0,0,1,35,Robert Lindstedt
2015,105585,2189.212602,8,3,0,5,7,Ze Zhang
2009,105138,2189.210189,1,0,0,1,3,Roberto Bautista Agut
2011,105132,2189.206752,5,2,0,3,7,Jurgen Zopp
2015,106148,2189.204957,3,1,0,2,30,Roberto Carballes Baena
1988,101835,2189.202487,1,0,0,1,15,Arne Thoms
2006,102512,2189.198426,1,0,0,1,20,Joseph Sirianni
1994,101234,2189.191065,14,6,0,8,7,Patrik Kuhnen
2009,104721,2189.188384,8,3,0,5,4,Josselin Ouanna
2012,105216,2189.18156,5,2,0,3,8,Yuichi Sugita
1990,101849,2189.179041,1,0,0,1,10,Nicola Bruno
2003,102694,2189.167333,42,17,0,25,3,Lars Burgsmuller
1995,102588,2189.165615,19,9,0,10,6,Lars Rehmann
1997,108595,2189.153713,3,1,0,2,10,Mohammed Reza Tavakoli
1985,107582,2189.144599,1,0,0,1,27,Luca Gasparini
1989,101207,2189.141789,1,0,0,1,9,Michael Daniel
2008,105668,2189.140957,3,1,0,2,17,Jerzy Janowicz
2012,103602,2189.140907,7,3,0,4,36,Fernando Gonzalez
1989,102205,2189.131191,1,0,0,1,18,Sebastien Lareau
1987,100972,2189.121538,25,10,0,15,11,Todd Witsken
1995,108995,2189.116388,1,0,0,1,7,Otakar Jurecka
2011,105154,2189.112857,15,7,0,8,10,Joao Souza
2008,103675,2189.112619,3,1,0,2,9,Diego Junqueira
2004,103862,2189.105741,1,0,0,1,3,Michail Elgin
2012,104594,2189.105614,36,17,0,19,4,Marinko Matosevic
1992,101544,2189.0976,1,0,0,1,30,Marcos Perez Hubert
2003,104295,2189.09028,1,0,0,1,42,Raphael Durek
2010,102148,2189.09028,1,0,0,1,45,Fabrice Santoro
1988,101380,2189.082259,1,0,0,1,10,Amit Naor
1991,102394,2189.078726,1,0,0,1,7,Johan Van Herck
1985,100938,2189.074254,5,2,0,3,15,Jaromir Becka
2006,103730,2189.066918,1,0,0,1,5,Jonathan Marray
1994,101687,2189.0611,1,0,0,1,41,David Dilucia
1996,101989,2189.060613,1,0,0,1,37,Patrik Langvardt
2008,103676,2189.06014,1,0,0,1,15,Michael Yani
1991,101776,2189.054986,12,5,0,7,8,Sandon Stolle
1988,100518,2189.053427,13,5,0,8,3,Ricardo Acuna
1994,101096,2189.051856,3,1,0,2,35,Gary Muller
1990,101920,2189.051013,1,0,0,1,35,Jamie Morgan
1985,100921,2189.049831,1,0,0,1,28,Patrice Kuchna
2000,102835,2189.049668,1,0,0,1,2,Luke Milligan
2013,105528,2189.037186,1,0,0,1,21,Alexander Ward
2004,103563,2189.028495,1,0,0,1,8,Gabriel Pitta
1998,102395,2189.02152,3,1,0,2,34,Ville Liukko
2004,102911,2189.021331,1,0,0,1,5,Andrei Stoliarov
1989,101332,2189.020599,15,6,0,9,7,Gilad Bloom
1986,107200,2189.009758,1,0,0,1,9,Herve Bardot
1992,102219,2189.007454,1,0,0,1,11,Juan Garat
2013,106065,2189.006071,1,0,0,1,27,Marco Cecchinato
1986,100503,2189.005404,1,0,0,1,13,Lorenzo Fargas
1992,100529,2189.004358,29,12,0,17,12,Kevin Curren
1998,103003,2189.004258,3,1,0,2,23,Jean Francois Bachelot
1990,101901,2188.999791,5,2,0,3,10,Chuck Adams
2002,102785,2188.99213,1,0,0,1,12,Glenn Weiner
1989,102187,2188.992068,1,0,0,1,3,John Laffnie De Jager
1999,102444,2188.990822,1,0,0,1,18,Scott Barron
2013,105894,2188.989162,1,0,0,1,29,Javier Marti
1994,102831,2188.986811,1,0,0,1,8,Jacobo Diaz
2006,104797,2188.979582,5,2,0,3,5,Denis Istomin
1987,101710,2188.970053,3,1,0,2,35,Martin Blackman
1989,101017,2188.967409,1,0,0,1,41,Gap Taik Ro
2003,103754,2188.962451,1,0,0,1,19,Mark Hilton
2013,104275,2188.962241,1,0,0,1,19,Josko Topic
2003,103252,2188.952894,45,19,0,26,3,Alberto Martin
1994,101902,2188.950901,1,0,0,1,13,Stephane Huet
1987,107183,2188.94657,1,0,0,1,19,Hatem Mcdadi
1990,101499,2188.94577,1,0,0,1,5,Eduardo Furusho
2003,106764,2188.94434,1,0,0,1,22,Christopher Koderisch
1992,108469,2188.943116,1,0,0,1,10,Victor Caldarelli
2011,104820,2188.942955,1,0,0,1,16,Erik Chvojka
1991,101309,2188.941023,5,2,0,3,47,Jay Berger
2014,104112,2188.940813,5,2,0,3,30,Benjamin Balleret
1997,102047,2188.940491,1,0,0,1,16,Pier Gauthier
1993,101833,2188.93858,8,3,0,5,6,Michael Tebbutt
1988,101207,2188.930125,1,0,0,1,10,Michael Daniel
2008,103171,2188.929022,1,0,0,1,36,Raemon Sluiter
2015,106393,2188.92579,3,1,0,2,19,Frederico Ferreira Silva
1989,101422,2188.922057,3,1,0,2,3,Mark Kaplan
1999,103594,2188.910123,1,0,0,1,6,Oliver Marach
1994,100962,2188.907844,5,2,0,3,13,Thomas Hogstedt
1999,102050,2188.906375,3,1,0,2,26,Marco Meneschincheri
1996,102286,2188.906226,11,5,0,6,10,Wayne Black
1999,108991,2188.899391,1,0,0,1,43,Sergei Petrouchevsky
1989,100460,2188.896279,1,0,0,1,15,Jose Lopez Maeso
1989,101765,2188.895154,1,0,0,1,19,Tomas Anzari
1985,100866,2188.894696,34,16,0,18,4,Shahar Perkiss
1988,101843,2188.892817,1,0,0,1,16,Sergi Bruguera
1994,101365,2188.882201,5,2,0,3,19,Paul Wekesa
2007,105404,2188.872954,1,0,0,1,12,Michael Mcclune
2006,104760,2188.866556,3,1,0,2,14,Scott Oudsema
1995,102783,2188.862892,1,0,0,1,7,Rainer Schuettler
1990,100951,2188.861715,1,0,0,1,7,Alessandro De Minicis
2001,103862,2188.844711,1,0,0,1,3,Michail Elgin
1996,101721,2188.838923,1,0,0,1,27,Markus Zillner
2011,104494,2188.837273,8,3,0,5,11,Adrian Ungur
2015,105542,2188.836144,3,1,0,2,18,Bastian Trinker
1997,101862,2188.835048,1,0,0,1,3,Maurice Ruah
2011,104692,2188.835035,1,0,0,1,25,Alexander Slabinsky
2009,104639,2188.831122,23,10,0,13,4,Wayne Odesnik
1995,102765,2188.830307,3,1,0,2,6,Nicolas Escude
1985,100292,2188.827572,3,1,0,2,30,Alvaro Fillol
2013,105471,2188.827265,1,0,0,1,37,Cesar Ramirez
1991,101877,2188.824667,1,0,0,1,16,Milan Trneny
1985,100504,2188.812529,3,1,0,2,34,Jerome Vanier
2003,104383,2188.806735,1,0,0,1,30,Diogo Rocha
2009,104624,2188.801151,3,1,0,2,24,Joshua Goodall
1992,101682,2188.799258,1,0,0,1,6,David Adams
1997,102497,2188.788545,1,0,0,1,43,Mashiska Washington
2001,103297,2188.7851,3,1,0,2,14,Alex Kim
2005,103369,2188.783278,5,2,0,3,16,Melle Van Gemerden
2002,103133,2188.78257,1,0,0,1,3,Olivier Mutis
2008,104624,2188.782439,1,0,0,1,23,Joshua Goodall
1991,100949,2188.777878,3,1,0,2,12,Mauro Menezes
1995,102081,2188.777818,1,0,0,1,13,Brett Hansen Dent
1985,100993,2188.767831,5,2,0,3,10,Loic Courteau
2002,104548,2188.755656,1,0,0,1,12,Brian Baker
2012,103863,2188.750391,1,0,0,1,10,Mikhail Elgin
2007,104173,2188.746682,3,1,0,2,22,Sam Warburg
1985,100990,2188.746612,1,0,0,1,13,Milan Srejber
2000,102502,2188.741561,1,0,0,1,16,Paul Harsanyi
1997,102284,2188.738057,3,1,0,2,7,Filippo Messori
2015,105454,2188.736126,1,0,0,1,22,Brydan Klein
2001,103287,2188.734122,3,1,0,2,17,Krystian Pfeiffer
1986,101350,2188.730927,1,0,0,1,20,Christian Feenstra
2008,105777,2188.730694,1,0,0,1,22,Grigor Dimitrov
1988,101186,2188.728814,1,0,0,1,11,Desmond Tyson
1985,101402,2188.726402,1,0,0,1,4,Stephen Furlong
2008,103843,2188.726369,1,0,0,1,3,Marco Chiudinelli
2015,126152,2188.720948,1,0,0,1,12,Ryan Shane
1990,101083,2188.705402,1,0,0,1,23,Tom Mercer
1985,100520,2188.692118,1,0,0,1,39,Juan Farrow
2000,101167,2188.68422,1,0,0,1,42,Jaime Cortes
2006,104261,2188.680777,5,2,0,3,8,Peng Sun
1986,100428,2188.680212,1,0,0,1,15,Gene Mayer
1995,101751,2188.679411,1,0,0,1,22,Ross Matheson
2008,104735,2188.677227,1,0,0,1,20,Tobias Kamke
1990,101549,2188.672725,1,0,0,1,6,Rodolphe Gilbert
2015,126205,2188.665823,1,0,0,1,12,Tommy Paul
1993,102103,2188.662752,1,0,0,1,20,Michael Sell
1993,102368,2188.659824,3,1,0,2,28,Brian Dunn
1999,101191,2188.651525,17,7,0,10,5,Richey Reneberg
2005,102110,2188.65063,1,0,0,1,8,Daniel Nestor
1991,106941,2188.634338,7,3,0,4,11,Eno Polo
1987,101765,2188.632191,1,0,0,1,19,Tomas Anzari
1994,102529,2188.629968,1,0,0,1,35,Thomas Shimada
1999,103065,2188.622431,1,0,0,1,42,Kepler Orellana
1986,100904,2188.62121,1,0,0,1,21,George Bezecny
2012,104503,2188.617955,1,0,0,1,11,Guillermo Hormazabal
2001,104166,2188.615162,1,0,0,1,12,Alex Bogomolov Jr
2004,103864,2188.614463,3,1,0,2,18,Mohamed Mamoun
1988,100962,2188.611602,7,3,0,4,19,Thomas Hogstedt
1993,101704,2188.610517,1,0,0,1,31,Ellis Ferreira
1986,101061,2188.599406,39,19,0,20,3,Jimmy Arias
2009,104910,2188.594017,3,1,0,2,21,Tihomir Grozdanov
2012,105902,2188.590878,5,2,0,3,44,James Duckworth
2014,104591,2188.590878,3,1,0,2,32,Patrick Tierro
1991,101691,2188.588236,1,0,0,1,3,Florian Krumrey
1996,103007,2188.588112,1,0,0,1,10,Mounir El Aarej
2000,101806,2188.585525,13,5,0,8,2,Marc Kevin Goellner
2006,102269,2188.585023,3,1,0,2,32,Jeff Salzenstein
2002,103862,2188.58476,1,0,0,1,3,Michail Elgin
1995,101865,2188.581563,10,4,0,6,6,Albert Chang
2014,100644,2188.578511,10,4,0,6,3,Alexander Zverev
2011,104816,2188.576524,1,0,0,1,38,Karan Rastogi
1992,100728,2188.573907,1,0,0,1,12,Todd Nelson
2004,103385,2188.55558,3,1,0,2,7,Paul Baccanello
1988,100889,2188.555312,1,0,0,1,38,Joe De Foor
2000,103256,2188.548599,1,0,0,1,21,Ivan Vajda
2007,104731,2188.543228,1,0,0,1,13,Kevin Anderson
1991,101122,2188.541763,1,0,0,1,20,Alberto Paris
2000,104000,2188.537394,3,1,0,2,37,Andrey Dernovskiy
2001,104034,2188.534457,1,0,0,1,20,Dmitry Vlasov
2005,104445,2188.528624,1,0,0,1,7,Jose Antonio Sanchez De Luna
2013,123768,2188.521573,1,0,0,1,13,Collin Altamirano
1996,102929,2188.52108,1,0,0,1,42,Ryan Wolters
1992,102035,2188.518038,1,0,0,1,5,Jonas Bjorkman
1989,101615,2188.515052,1,0,0,1,2,Otavio Della
1985,100691,2188.514689,1,0,0,1,15,Ivo Werner
2000,101731,2188.514528,1,0,0,1,36,Nuno Marques
1985,107480,2188.514344,3,1,0,2,31,Karel Demuynck
1997,101823,2188.508308,3,1,0,2,10,Gerald Mandl
2008,104768,2188.50565,1,0,0,1,31,Juho Paukku
2010,103920,2188.505079,1,0,0,1,11,Sanchai Ratiwatana
2003,103849,2188.503542,1,0,0,1,7,Francesco Aldi
2002,102693,2188.496111,1,0,0,1,36,Leonardo Olguin
1997,102998,2188.490379,8,3,0,5,12,Jan Michael Gambill
2006,103184,2188.48907,1,0,0,1,23,Bob Bryan
1993,100939,2188.485142,5,2,0,3,21,Joey Rive
1991,100744,2188.48313,1,0,0,1,51,Peter Doohan
1987,101252,2188.482332,1,0,0,1,24,Brian Page
2006,103544,2188.481912,1,0,0,1,16,Andy Ram
1995,102231,2188.479543,1,0,0,1,8,Alex Calatrava
1991,100866,2188.478034,1,0,0,1,7,Shahar Perkiss
1993,101274,2188.473592,1,0,0,1,39,Udo Riglewski
1993,101534,2188.46821,5,2,0,3,10,Libor Nemecek
1995,102067,2188.464776,1,0,0,1,14,Emanuel Rasberger
1988,101310,2188.464739,1,0,0,1,38,Conny Falk
1999,102650,2188.461368,3,1,0,2,10,Roberto Carretero
1994,102490,2188.459499,1,0,0,1,8,Pantelis Moschoutis
1997,103167,2188.459436,1,0,0,1,16,Jocelyn Robichaud
1988,107689,2188.445526,1,0,0,1,14,Mark Gurr
1997,101534,2188.444885,1,0,0,1,16,Libor Nemecek
2013,103566,2188.444293,28,13,0,15,3,Michael Llodra
1986,107725,2188.443508,1,0,0,1,7,Masayoshi Takeyari
2000,103118,2188.443142,1,0,0,1,13,Ion Moldovan
2011,105077,2188.435692,29,13,0,16,6,Albert Ramos
1996,102966,2188.431518,1,0,0,1,20,Fredrik Jonsson
2013,103714,2188.428458,1,0,0,1,21,Andreas Vinciguerra
1985,100769,2188.4233,1,0,0,1,46,Mario Martinez
2005,104424,2188.418272,3,1,0,2,6,Go Soeda
1987,107778,2188.417361,1,0,0,1,28,Michael Nugent
1994,101779,2188.406479,1,0,0,1,13,Pavel Vizner
1992,101256,2188.406031,1,0,0,1,33,Mark Kratzmann
1992,101299,2188.403596,1,0,0,1,6,Sven Salumaa
1997,102215,2188.395268,4,1,0,3,14,Joshua Eagle
2003,103830,2188.39408,3,1,0,2,7,Shao Xuan Zeng
2011,103747,2188.381889,1,0,0,1,26,Dominik Meffert
1999,108998,2188.379304,1,0,0,1,13,Patrick Osnua
2000,102572,2188.378065,1,0,0,1,24,Igor Gaudi
2002,102967,2188.378065,3,1,0,2,14,Marc Gicquel
1996,102574,2188.372964,1,0,0,1,11,Gabriel Trifu
2010,104195,2188.367833,5,2,0,3,10,Simone Vagnozzi
1989,100321,2188.362385,16,7,0,9,10,Vijay Amritraj
1990,101819,2188.359831,1,0,0,1,20,Frederic Vitoux
2007,104735,2188.357071,1,0,0,1,6,Tobias Kamke
1988,101319,2188.354808,1,0,0,1,32,Antonio Padovani
1985,101132,2188.35433,1,0,0,1,19,Fredrik Rosenquist
1986,101632,2188.351542,1,0,0,1,21,Per Henricsson
1993,100943,2188.349901,1,0,0,1,20,Girts Dzelde
1990,101502,2188.34893,1,0,0,1,22,Torben Theine
2009,104250,2188.344381,3,1,0,2,22,Prakash Amritraj
1998,101841,2188.334193,1,0,0,1,42,Aleksandar Kitinov
1985,100686,2188.32812,3,1,0,2,6,Karl Richter
1996,102743,2188.322504,3,1,0,2,12,Ben Ellwood
2001,102735,2188.32085,1,0,0,1,24,Cedric Kauffmann
2013,111202,2188.313988,1,0,0,1,9,Hyeon Chung
1996,102113,2188.298703,3,1,0,2,11,Daniele Musa
2015,105270,2188.297703,1,0,0,1,17,Maxime Teixeira
2006,102287,2188.297422,20,8,0,12,15,Albert Portas
2004,103849,2188.294632,1,0,0,1,7,Francesco Aldi
2010,102999,2188.280697,1,0,0,1,27,Stefano Galvani
2013,106058,2188.271751,23,10,0,13,6,Jack Sock
1989,101016,2188.268723,3,1,0,2,14,Marcos Aurelio Gorriz
1996,103167,2188.268483,1,0,0,1,13,Jocelyn Robichaud
1992,101912,2188.268443,5,2,0,3,12,Felipe Rivera
2008,103600,2188.268391,3,1,0,2,31,Mohammad Ghareeb
1985,101205,2188.262926,1,0,0,1,18,Grant Connell
1992,101732,2188.253281,1,0,0,1,26,Pietro Pennisi
1990,108247,2188.245411,1,0,0,1,5,Shai Friedman
2002,104082,2188.242515,1,0,0,1,6,Hiroki Kondo
1993,101244,2188.239775,1,0,0,1,41,Johan Donar
1998,102061,2188.235167,1,0,0,1,19,Kevin Ullyett
1994,101374,2188.229899,3,1,0,2,13,Leonardo Lavalle
1996,102522,2188.226759,5,2,0,3,27,Fabio Maggi
2011,103843,2188.225191,7,3,0,4,4,Marco Chiudinelli
2008,104965,2188.223053,1,0,0,1,35,Pavol Cervenak
2015,105572,2188.220162,18,7,0,11,8,Austin Krajicek
1991,101262,2188.211047,1,0,0,1,5,Rikard Bergh
1988,101282,2188.21081,1,0,0,1,24,Martin Barba
1994,102010,2188.206284,1,0,0,1,14,Clinton Marsh
2000,103239,2188.19319,1,0,0,1,2,Marcus Sarstrand
1995,102220,2188.19287,1,0,0,1,21,Patrik Fredriksson
1995,101625,2188.1925,1,0,0,1,18,Steve Herdoiza
2007,104323,2188.192471,3,1,0,2,19,Photos Kallias
1992,101324,2188.191302,1,0,0,1,5,Ulf Stenlund
1990,102085,2188.191041,3,1,0,2,12,Sasa Hirszon
2000,102948,2188.190489,1,0,0,1,2,Oliver Freelove
2004,102463,2188.186264,1,0,0,1,31,Lucas Arnold Ker
2006,105104,2188.176478,1,0,0,1,18,Robin Roshardt
1986,100974,2188.173698,1,0,0,1,5,Jeff Klaparda
1989,101322,2188.171735,1,0,0,1,40,Shigeru Ota
1993,102271,2188.168366,1,0,0,1,11,Hicham Arazi
1985,106615,2188.168225,5,2,0,3,20,Bernard Balleret
1999,102735,2188.16605,1,0,0,1,19,Cedric Kauffmann
1993,108429,2188.162655,1,0,0,1,18,Tony Bujan
1987,101462,2188.154632,1,0,0,1,14,Francisco Roig
2002,103566,2188.153787,29,12,0,17,3,Michael Llodra
2003,102789,2188.151075,1,0,0,1,34,Jay Gooding
1993,101531,2188.149414,5,2,0,3,17,Mario Visconti
1988,101725,2188.148394,1,0,0,1,15,Gabriel Markus
1999,102795,2188.146856,1,0,0,1,19,Scott Humphries
1985,100544,2188.123287,3,1,0,2,10,Tony Mmoh
2007,102630,2188.119451,5,2,0,3,19,Slimane Saoudi
1986,101088,2188.119414,1,0,0,1,9,Larry Scott
2001,103029,2188.111729,1,0,0,1,32,Mehdi Tahiri
2006,103824,2188.110612,1,0,0,1,30,Orest Tereshchuk
2001,102215,2188.100255,1,0,0,1,37,Joshua Eagle
1987,101075,2188.098544,1,0,0,1,18,Dexter Macbride
1990,101067,2188.09828,1,0,0,1,11,Philip Johnson
2001,101997,2188.097772,3,1,0,2,19,Marzio Martelli
1985,101093,2188.09772,3,1,0,2,17,Steve Devries
1990,102247,2188.096973,1,0,0,1,7,Andrea Gaudenzi
1998,102996,2188.092621,1,0,0,1,22,Franz Stauder
2003,102521,2188.088248,1,0,0,1,22,Hendrik Dreekmann
1993,102348,2188.085131,3,1,0,2,7,Hideki Kaneko
1990,101917,2188.078598,1,0,0,1,15,Grant Stafford
2015,104500,2188.07705,5,2,0,3,11,Somdev Devvarman
2012,106074,2188.070535,1,0,0,1,35,Jung Woong Na
1986,107484,2188.067279,1,0,0,1,8,Kazuya Morita
1998,102785,2188.067004,3,1,0,2,40,Glenn Weiner
2014,122109,2188.066699,1,0,0,1,9,Sanjar Fayziev
2009,103104,2188.066584,1,0,0,1,44,Bjorn Rehnquist
2009,104251,2188.066584,3,1,0,2,38,Ti Chen
2010,105656,2188.066584,3,1,0,2,22,Marcelo Arevalo
2012,105286,2188.066584,1,0,0,1,44,Greg Jones
1998,101481,2188.063558,1,0,0,1,14,Omar Camporese
2011,105216,2188.059345,5,2,0,3,9,Yuichi Sugita
2007,104342,2188.05105,3,1,0,2,9,Matias Silva
2007,104635,2188.05105,3,1,0,2,44,Robert Smeets
1997,108874,2188.050656,1,0,0,1,28,Dickson Ogu
1995,100606,2188.049185,1,0,0,1,14,Mike Bauer
1996,102777,2188.045516,1,0,0,1,10,Larbi Rharnit
2010,103103,2188.044049,1,0,0,1,44,Dominik Hrbaty
1991,102118,2188.043866,1,0,0,1,16,Radomir Vasek
1989,101363,2188.037396,1,0,0,1,20,Vojtech Flegl
2006,103114,2188.036419,3,1,0,2,19,Martin Lee
1990,101632,2188.033269,3,1,0,2,16,Per Henricsson
1988,101041,2188.032472,1,0,0,1,22,Geoff Roper
2012,105487,2188.030681,3,1,0,2,38,Facundo Bagnis
1990,101031,2188.030433,5,2,0,3,10,Massimo Cierro
1996,100676,2188.027652,1,0,0,1,42,Yannick Noah
2002,102603,2188.026374,1,0,0,1,14,Melvyn Op Der Heijde
1987,101274,2188.024933,3,1,0,2,24,Udo Riglewski
2012,105062,2188.019097,27,12,0,15,11,Mikhail Kukushkin
2012,105336,2188.013477,1,0,0,1,18,Nicolas Meister
2014,103891,2188.011935,3,1,0,2,32,Alexandros Jakupovic
2007,105229,2188.008268,1,0,0,1,15,Philip Bester
1996,101353,2188.00682,1,0,0,1,14,Lionel Barthez
2015,121896,2188.006501,3,1,0,2,11,Gabor Borsos
2010,103758,2187.998141,31,12,0,19,5,Taylor Dent
2008,105104,2187.997657,1,0,0,1,19,Robin Roshardt
2002,102979,2187.996121,1,0,0,1,20,Jeff Coetzee
1996,102116,2187.993989,1,0,0,1,31,Sang Hoon Lee
1985,106751,2187.992686,1,0,0,1,14,Christoph Meyer
1997,102795,2187.984043,1,0,0,1,29,Scott Humphries
1988,100701,2187.982532,8,3,0,5,10,Marko Ostoja
1993,101232,2187.982343,1,0,0,1,40,Nicklas Kroon
1991,101083,2187.981113,1,0,0,1,22,Tom Mercer
1988,101364,2187.977664,3,1,0,2,24,Bret Garnett
2013,104460,2187.974356,5,2,0,3,19,Dustin Brown
2006,102148,2187.971248,42,19,0,23,2,Fabrice Santoro
1993,101280,2187.96733,1,0,0,1,45,Mikael Stadling
1992,101316,2187.966152,1,0,0,1,17,Juan Rios
2004,102965,2187.964163,3,1,0,2,21,Jamie Delgado
1991,102110,2187.96203,3,1,0,2,4,Daniel Nestor
1986,101358,2187.961702,3,1,0,2,28,Olivier Delaitre
2011,104639,2187.955015,1,0,0,1,17,Wayne Odesnik
1995,103182,2187.952153,1,0,0,1,6,Markus Hipfl
1992,100876,2187.949827,1,0,0,1,7,Bong Soo Kim
1990,101352,2187.949657,1,0,0,1,26,Jae Sik Kim
1994,101953,2187.944869,1,0,0,1,34,Kentaro Masuda
2006,105671,2187.940621,1,0,0,1,26,Gastao Elias
1989,107979,2187.940424,1,0,0,1,22,Peter Flintsoe
1992,101004,2187.93329,1,0,0,1,21,Jim Pugh
1998,102675,2187.931528,1,0,0,1,10,Timur Ganiev
1988,101920,2187.931352,1,0,0,1,11,Jamie Morgan
2006,102785,2187.929201,1,0,0,1,32,Glenn Weiner
2008,104783,2187.928807,5,2,0,3,18,Mikhail Ledovskikh
2008,103530,2187.928754,1,0,0,1,14,Zack Fleishman
1993,102162,2187.920228,3,1,0,2,14,Chris Woodruff
2009,103758,2187.918273,27,12,0,15,9,Taylor Dent
2004,102957,2187.916821,3,1,0,2,31,Vadim Kutsenko
2000,102667,2187.913517,1,0,0,1,8,Satoshi Iwabuchi
2008,104470,2187.907519,1,0,0,1,12,Komlavi Loglo
1995,102010,2187.906129,1,0,0,1,44,Clinton Marsh
1988,101390,2187.903231,1,0,0,1,32,Ugo Biagianti
1995,101536,2187.902662,1,0,0,1,41,Murphy Jensen
2000,102904,2187.901354,3,1,0,2,2,Leos Friedl
1994,102206,2187.89388,1,0,0,1,17,Stephane Matheu
2013,104226,2187.892341,1,0,0,1,22,Bastian Knittel
1993,101106,2187.89096,1,0,0,1,19,Peter Lundgren
2010,104465,2187.886985,1,0,0,1,25,Martin Emmrich
2014,104393,2187.87971,1,0,0,1,7,Gregoire Burquier
1985,101434,2187.878335,1,0,0,1,9,Petr Korda
2013,104976,2187.876363,1,0,0,1,39,Ryan Sweeting
2010,104807,2187.876141,1,0,0,1,36,Mehdi Ziadi
1987,100966,2187.875808,3,1,0,2,26,Nick Fulwood
2006,104181,2187.875805,1,0,0,1,9,Victor Ionita
2011,106246,2187.865638,1,0,0,1,20,Robin Kern
1989,101582,2187.863282,1,0,0,1,20,Gilbert Schaller
1996,101869,2187.862446,3,1,0,2,36,Juan Luis Tati Rascon
2003,103586,2187.861621,3,1,0,2,14,Mariusz Fyrstenberg
1994,101061,2187.85486,7,3,0,4,13,Jimmy Arias
2014,106234,2187.850679,1,0,0,1,4,Aslan Karatsev
1997,102903,2187.85047,3,1,0,2,11,Eyal Erlich
2014,104944,2187.843305,1,0,0,1,10,Niels Desein
1988,101703,2187.836934,1,0,0,1,31,Guillaume Raoux
2008,104976,2187.830807,3,1,0,2,10,Ryan Sweeting
2013,106148,2187.830638,1,0,0,1,31,Roberto Carballes Baena
1989,101934,2187.82923,1,0,0,1,21,Paul Dogger
2008,103455,2187.825982,1,0,0,1,23,Michal Mertinak
1991,101216,2187.823859,3,1,0,2,17,Olli Rahnasto
1999,101659,2187.81702,1,0,0,1,43,Jan Apell
2004,103525,2187.815919,5,2,0,3,8,Ivan Miranda
2012,105436,2187.815312,1,0,0,1,11,Markus Eriksson
2000,102168,2187.809109,1,0,0,1,19,Hector Moretti
2004,103254,2187.808528,1,0,0,1,34,Yves Allegro
1988,101779,2187.805868,1,0,0,1,20,Pavel Vizner
1989,100485,2187.804905,1,0,0,1,40,Tsuyoshi Fukui
2011,104986,2187.80273,1,0,0,1,12,Vishnu Vardhan
1989,100794,2187.801236,3,1,0,2,20,Srinivasan Vasudevan
2003,104233,2187.800535,3,1,0,2,8,Frederik Nielsen
1990,101774,2187.799851,7,3,0,4,1,Todd Martin
1987,100619,2187.796127,5,2,0,3,27,George Kalovelonis
1985,100904,2187.795529,3,1,0,2,19,George Bezecny
2005,104138,2187.794472,3,1,0,2,17,Henry Adjei Darko
1995,102465,2187.791415,7,3,0,4,4,Gabriel Silberstein
1985,110847,2187.7896,3,1,0,2,20,Luis Arturo Gonzalez
2009,104523,2187.786681,36,18,0,18,4,Frederico Gil
2005,102497,2187.785212,1,0,0,1,16,Mashiska Washington
2003,103520,2187.779697,1,0,0,1,6,Pavel Snobel
2010,105894,2187.778809,1,0,0,1,4,Javier Marti
1985,100880,2187.778585,3,1,0,2,11,Russell Barlow
2004,102110,2187.778373,1,0,0,1,16,Daniel Nestor
2008,104921,2187.776768,1,0,0,1,31,Kirati Siributwong
2012,104783,2187.775854,1,0,0,1,24,Mikhail Ledovskikh
1986,100714,2187.769394,37,16,0,21,3,Broderick Dyke
1996,102903,2187.766163,3,1,0,2,34,Eyal Erlich
1994,102869,2187.765394,1,0,0,1,8,Galo Blanco
1985,100820,2187.764986,1,0,0,1,37,Thierry Pham
2005,102434,2187.764513,47,22,0,25,2,Vincent Spadea
2000,102501,2187.75477,1,0,0,1,25,Johan Landsberg
1992,101149,2187.753409,1,0,0,1,10,Morten Christensen
2013,104516,2187.739608,3,1,0,2,40,Arnau Brugues Davi
2000,102655,2187.738598,5,2,0,3,20,Jimy Szymanski
2010,105609,2187.730693,1,0,0,1,6,Ilya Belyaev
1993,110867,2187.729568,3,1,0,2,30,Anders Haseth
1994,101263,2187.722427,1,0,0,1,14,Luke Jensen
2004,104660,2187.721525,1,0,0,1,5,Sergiy Stakhovsky
2002,102093,2187.721243,3,1,0,2,36,Martin Damm
2001,108657,2187.717738,1,0,0,1,9,Alexander Skrypko
1985,100241,2187.715286,1,0,0,1,10,Joel Bailey
1989,102093,2187.707738,1,0,0,1,19,Martin Damm
1989,101750,2187.707292,3,1,0,2,17,Cristiano Caratti
2008,104225,2187.70629,1,0,0,1,25,Jan Hajek
1999,103176,2187.702695,1,0,0,1,7,David Sanchez
1995,102572,2187.696173,1,0,0,1,16,Igor Gaudi
2007,104136,2187.692846,3,1,0,2,19,Santiago Gonzalez
1996,102548,2187.691028,1,0,0,1,35,Juan Antonio Marin
2011,104377,2187.690188,3,1,0,2,21,Theodoros Angelinos
2008,102405,2187.688339,1,0,0,1,31,Mahesh Bhupathi
1987,101452,2187.684265,1,0,0,1,11,Greg Failla
1992,100689,2187.683461,1,0,0,1,40,Tim Mayotte
2006,104976,2187.682142,5,2,0,3,10,Ryan Sweeting
1998,101869,2187.68121,1,0,0,1,31,Juan Luis Tati Rascon
2006,108970,2187.678891,1,0,0,1,30,John El Khoury
1985,100149,2187.676799,1,0,0,1,10,Toshiro Sakai
2002,102162,2187.674229,1,0,0,1,34,Chris Woodruff
2003,103914,2187.671984,1,0,0,1,35,Omar Awadhy
1998,102872,2187.666765,1,0,0,1,11,James Sekulov
1998,103475,2187.666504,1,0,0,1,38,Thomas Messmer
2013,100644,2187.666355,1,0,0,1,20,Alexander Zverev
1986,101093,2187.664073,1,0,0,1,13,Steve Devries
1998,102025,2187.660578,42,20,0,22,2,Mikael Tillstrom
1992,101591,2187.659392,1,0,0,1,24,Danny Sapsford
1989,101067,2187.659183,12,5,0,7,3,Philip Johnson
1992,106874,2187.653942,1,0,0,1,12,Dick Bosse
1989,101433,2187.651505,1,0,0,1,27,Austen Brice
1997,102223,2187.648478,52,23,0,29,2,Karim Alami
2002,102984,2187.647059,1,0,0,1,20,Martin Garcia
1991,101062,2187.644192,19,9,0,10,27,Mats Wilander
1996,102030,2187.643592,1,0,0,1,21,Andrew Foster
1996,103252,2187.642466,5,2,0,3,15,Alberto Martin
1986,101336,2187.629258,1,0,0,1,21,Dan Nahirny
1988,101632,2187.625526,3,1,0,2,21,Per Henricsson
1987,100776,2187.62518,3,1,0,2,21,Tomm Warneke
2007,105373,2187.62377,3,1,0,2,9,Martin Klizan
1985,100930,2187.62326,1,0,0,1,38,Paul Vojtischek
2011,104489,2187.621871,3,1,0,2,21,Barry King
2002,102472,2187.621276,1,0,0,1,7,Marcello Craca
2009,104136,2187.619562,3,1,0,2,23,Santiago Gonzalez
2001,102473,2187.618851,1,0,0,1,17,Thomas Schiessling
1996,102069,2187.613212,4,1,0,3,10,Andrei Rybalko
1993,101797,2187.611204,48,22,0,26,3,Jacco Eltingh
1989,100592,2187.607271,13,6,0,7,3,Robert Vant Hof
2011,104095,2187.606867,1,0,0,1,27,David Guez
2004,103565,2187.60685,3,1,0,2,24,Stephane Robert
1988,101812,2187.60634,1,0,0,1,10,Raviv Weidenfeld
1985,101336,2187.598225,1,0,0,1,18,Dan Nahirny
2001,102455,2187.595062,1,0,0,1,20,Lorenzo Manta
2015,105586,2187.593644,3,1,0,2,11,Alexander Lazov
1985,100638,2187.59355,10,4,0,6,5,David Mustard
2009,104476,2187.591535,1,0,0,1,21,Louk Sorensen
2004,103149,2187.590718,1,0,0,1,20,Mathias Hellstrom
1989,111101,2187.587437,1,0,0,1,28,Neil Rajapakse
2007,103238,2187.586336,1,0,0,1,7,Jean Claude Scherrer
2012,103917,2187.586091,34,16,0,18,10,Nicolas Mahut
1989,100548,2187.584756,3,1,0,2,41,Ivan Kley
2015,105841,2187.581819,1,0,0,1,31,Lorenzo Giustino
1996,101836,2187.580354,1,0,0,1,10,Udo Plamberger
1991,101366,2187.57356,1,0,0,1,40,David Macpherson
1994,102465,2187.573433,3,1,0,2,5,Gabriel Silberstein
2004,103716,2187.570914,1,0,0,1,29,Uros Vico
2002,102169,2187.570221,1,0,0,1,34,Michael Joyce
1990,101934,2187.568271,1,0,0,1,22,Paul Dogger
1992,101857,2187.567256,1,0,0,1,45,Jason Cask
2000,103053,2187.567256,1,0,0,1,9,Nikos Rovas
1991,106782,2187.565809,3,1,0,2,10,Colin Grant
1991,101074,2187.561769,1,0,0,1,50,Carlos Di Laura
2008,104070,2187.557892,1,0,0,1,36,Jesse Witten
1995,102443,2187.554885,1,0,0,1,22,Barry Cowan
1995,101279,2187.552617,1,0,0,1,24,Philippe Pech
1996,102111,2187.549333,1,0,0,1,3,Diego Del Rio
1997,101884,2187.548588,3,1,0,2,19,Frank Ofori
2005,108618,2187.548588,3,1,0,2,17,Karim Alayli
2008,103077,2187.548588,3,1,0,2,31,Konstantinos Economidis
2010,103872,2187.548588,3,1,0,2,22,Dimitar Grabuloski
2010,104368,2187.548588,3,1,0,2,40,Daniel King Turner
1985,100890,2187.547008,1,0,0,1,43,Rashid Malik
1985,108844,2187.547008,1,0,0,1,43,Hamed Ul Haq
1989,101748,2187.547008,1,0,0,1,34,Ivan Keskinov
1989,110820,2187.547008,3,1,0,2,43,Mahtabur Rahman
1991,102277,2187.547008,1,0,0,1,42,Bing Chao Lin
1991,110846,2187.547008,3,1,0,2,39,John Maginley
1992,110915,2187.547008,1,0,0,1,19,Loucas Christophides
1995,101339,2187.547008,1,0,0,1,39,Agustin Moreno
1997,102097,2187.547008,1,0,0,1,33,Naratorn Srichaphan
1997,102654,2187.547008,1,0,0,1,48,Steven Downs
1998,102119,2187.547008,3,1,0,2,18,Chih Jung Chen
1998,102647,2187.547008,1,0,0,1,18,Alberto Brause
1998,102875,2187.547008,1,0,0,1,44,Luke Smith
1999,102190,2187.547008,1,0,0,1,34,Philippe Moggio
2000,108589,2187.547008,1,0,0,1,37,Vasuthevan Ortchuan
2000,108591,2187.547008,1,0,0,1,37,Adam Jaya
2001,101989,2187.547008,1,0,0,1,18,Patrik Langvardt
2001,103499,2187.547008,3,1,0,2,33,Aqeel Khan
2001,108607,2187.547008,3,1,0,2,18,Andrei Luzgin
2002,103483,2187.547008,1,0,0,1,31,James Shortall
2003,104454,2187.547008,1,0,0,1,31,Murad Inoyatov
2004,103397,2187.547008,1,0,0,1,31,Alexandre Simoni
2004,103882,2187.547008,1,0,0,1,18,Adrians Zguns
2004,108911,2187.547008,1,0,0,1,31,William Ward
2005,103638,2187.547008,3,1,0,2,17,Jhonson Garcia
2005,103899,2187.547008,3,1,0,2,17,Stian Boretti
2005,105145,2187.547008,1,0,0,1,17,Jaak Poldma
2005,108920,2187.547008,1,0,0,1,17,Federico Rodriguez
2005,108947,2187.547008,1,0,0,1,17,West Nott
2006,103296,2187.547008,1,0,0,1,16,Ivaylo Traykov
2006,103914,2187.547008,1,0,0,1,33,Omar Awadhy
2006,104469,2187.547008,1,0,0,1,16,Erling Tveit
2006,104789,2187.547008,3,1,0,2,16,Sherif Sabry
2007,102945,2187.547008,1,0,0,1,45,Luke Bourgeois
2008,103761,2187.547008,1,0,0,1,41,Tomas Cakl
2008,104789,2187.547008,3,1,0,2,17,Sherif Sabry
2008,105002,2187.547008,3,1,0,2,31,Timothy Neilly
2008,105221,2187.547008,3,1,0,2,31,Mauricio Doria Medina
2010,104191,2187.547008,3,1,0,2,22,Ismar Gorcic
2010,105051,2187.547008,3,1,0,2,45,Matthew Ebden
2010,105488,2187.547008,1,0,0,1,22,Jose Benitez
2011,104192,2187.547008,1,0,0,1,43,Marco Crugnola
2011,104702,2187.547008,3,1,0,2,21,Michael Leong
2012,104477,2187.547008,1,0,0,1,35,Jorge Aguilar
2012,104628,2187.547008,1,0,0,1,44,Alexander Kudryavtsev
2012,105656,2187.547008,3,1,0,2,35,Marcelo Arevalo
2012,108618,2187.547008,3,1,0,2,35,Karim Alayli
2014,108594,2187.547008,1,0,0,1,32,Johnny Arcilla
2015,105566,2187.547008,3,1,0,2,19,Shahin Khaledan
2015,106150,2187.547008,1,0,0,1,19,Jeson Patrombon
1991,102250,2187.544932,1,0,0,1,40,Emanuel Couto
1999,101687,2187.540643,1,0,0,1,32,David Dilucia
1987,107640,2187.538582,1,0,0,1,19,Marcello Bassanelli
2000,104282,2187.537513,1,0,0,1,21,Dennis Peschek
1992,102655,2187.534268,1,0,0,1,19,Jimy Szymanski
2011,103720,2187.532784,20,9,0,11,12,Lleyton Hewitt
2002,103820,2187.530912,1,0,0,1,19,Alan Mackin
1992,102169,2187.52846,1,0,0,1,16,Michael Joyce
2009,108713,2187.528156,3,1,0,2,21,Julen Uriguen
2005,104043,2187.527588,5,2,0,3,29,Marc Lopez
1996,102276,2187.527466,1,0,0,1,33,Sandeep Kirtane
2010,104372,2187.526993,1,0,0,1,26,Alex Bogdanovic
1997,103720,2187.526818,1,0,0,1,47,Lleyton Hewitt
1997,102790,2187.526814,1,0,0,1,33,Yu Zheng
2007,108985,2187.526757,1,0,0,1,9,Ali Ghareeb
2011,105402,2187.526757,1,0,0,1,12,Peerakiat Siriluethaiwattana
2012,105009,2187.526757,1,0,0,1,11,Elbert Sie
2015,144799,2187.526757,1,0,0,1,11,Miguel Angel Este
1986,100951,2187.52597,1,0,0,1,43,Alessandro De Minicis
1995,102903,2187.524412,5,2,0,3,7,Eyal Erlich
1992,100950,2187.519047,1,0,0,1,17,Libor Pimek
2004,102184,2187.518048,1,0,0,1,23,David Prinosil
1993,100984,2187.517293,1,0,0,1,21,Peter Wright
1992,102118,2187.516787,1,0,0,1,30,Radomir Vasek
1995,108867,2187.512708,1,0,0,1,20,Serge Brueck
2001,102251,2187.509134,1,0,0,1,20,Mariano Hood
2011,106184,2187.506561,1,0,0,1,12,Hong Chung
1999,102497,2187.504835,3,1,0,2,11,Mashiska Washington
2013,119506,2187.502899,1,0,0,1,34,Jean Segodo
1993,100757,2187.502413,33,15,0,18,3,Anders Jarryd
2010,104339,2187.500699,5,2,0,3,32,Mario Ancic
2005,104635,2187.500188,1,0,0,1,14,Robert Smeets
1995,102090,2187.499505,1,0,0,1,32,Ofer Sela
2014,105932,2187.498533,1,0,0,1,29,Nikoloz Basilashvili
1992,101360,2187.495367,1,0,0,1,39,Mark Keil
1989,101797,2187.495181,1,0,0,1,21,Jacco Eltingh
1989,101452,2187.489235,1,0,0,1,18,Greg Failla
2000,102239,2187.486841,3,1,0,2,19,Francisco Costa
1991,101147,2187.482834,12,5,0,7,9,Claudio Mezzadri
2005,103228,2187.482744,2,0,0,2,7,Marcos Daniel
1990,101235,2187.481849,45,20,0,25,1,Paul Haarhuis
1997,102145,2187.480804,3,1,0,2,2,Francisco Cabello
2007,103185,2187.479025,1,0,0,1,27,Mike Bryan
2005,103666,2187.477066,1,0,0,1,17,Ilia Kushev
2006,104619,2187.473686,1,0,0,1,36,Jesse Huta Galung
2000,108583,2187.47358,1,0,0,1,37,Daniel Chavez Morales
2004,103039,2187.471543,1,0,0,1,34,Tripp Phillips
2006,103799,2187.471188,1,0,0,1,35,Eric Prodon
1998,103009,2187.470987,1,0,0,1,10,Razvan Sabau
2003,103202,2187.466823,1,0,0,1,38,Oscar Serrano
2010,103739,2187.466096,1,0,0,1,11,Jose De Armas
1993,106539,2187.466035,1,0,0,1,46,Andrew Mclean
1999,102512,2187.466035,1,0,0,1,46,Joseph Sirianni
2007,103761,2187.465589,3,1,0,2,42,Tomas Cakl
1990,101370,2187.457717,3,1,0,2,10,Paolo Pambianco
2005,104486,2187.456776,1,0,0,1,35,Horia Tecau
1999,102993,2187.456729,3,1,0,2,9,Michal Chmela
1989,101776,2187.454801,1,0,0,1,18,Sandon Stolle
1999,102809,2187.451855,14,5,0,9,10,Axel Pretzsch
1996,101947,2187.451738,1,0,0,1,26,Vincenzo Santopadre
1999,102354,2187.449441,1,0,0,1,5,Jerome Hanquez
2000,103202,2187.448418,1,0,0,1,27,Oscar Serrano
1999,101776,2187.448055,7,3,0,4,20,Sandon Stolle
2002,102269,2187.447518,1,0,0,1,36,Jeff Salzenstein
1992,102277,2187.447021,7,3,0,4,6,Bing Chao Lin
1995,101669,2187.445142,1,0,0,1,22,Gary Henderson
1988,101881,2187.440829,1,0,0,1,21,Oliver Fuchs
1990,102019,2187.439441,1,0,0,1,17,Dirk Dier
2001,103270,2187.430124,5,2,0,3,14,Kristian Capalik
1996,102087,2187.430073,31,14,0,17,6,Oleg Ogorodov
2003,104043,2187.429848,6,2,0,4,16,Marc Lopez
1999,101775,2187.427882,3,1,0,2,9,Frederik Fetterlein
1998,102821,2187.426687,1,0,0,1,15,Cecil Mamiit
1991,101364,2187.421114,3,1,0,2,21,Bret Garnett
2008,104934,2187.411617,1,0,0,1,17,Thomas Kromann
1991,108008,2187.410907,1,0,0,1,13,Phillip Williamson
2000,102458,2187.410163,1,0,0,1,23,Jim Thomas
1998,101953,2187.409468,1,0,0,1,31,Kentaro Masuda
1997,102983,2187.40747,1,0,0,1,20,Henrik Andersson
1999,102153,2187.400987,13,6,0,7,10,German Puentes
1996,102664,2187.400065,1,0,0,1,14,Petr Pala
2003,103033,2187.394912,3,1,0,2,17,Helder Lopes
2010,104942,2187.391667,3,1,0,2,11,Roman Recarte
1985,100587,2187.388383,3,1,0,2,10,Steve Guy
1995,101745,2187.387278,1,0,0,1,29,Roberto Jabali
2005,104439,2187.386154,1,0,0,1,3,Vadim Davletshin
2000,102537,2187.384603,5,2,0,3,10,Melvin Tong
2005,103626,2187.384475,1,0,0,1,22,Tomas Tenconi
1998,102083,2187.383737,1,0,0,1,10,Nick Gould
1996,101597,2187.380485,1,0,0,1,14,Louis Gloria
2005,104122,2187.380219,1,0,0,1,16,Carlos Berlocq
1991,101504,2187.37793,3,1,0,2,9,Laurent Prades
2012,104856,2187.376645,3,1,0,2,35,Min Hyoek Cho
2013,105936,2187.374785,1,0,0,1,38,Filip Krajinovic
2012,106246,2187.374727,1,0,0,1,21,Robin Kern
2011,103868,2187.371198,3,1,0,2,39,Ivan Navarro
1992,101048,2187.369038,1,0,0,1,17,Francisco Maciel
2012,104947,2187.368434,7,3,0,4,20,Marsel Ilhan
2006,104997,2187.368284,1,0,0,1,17,Igor Sijsling
1985,100871,2187.366448,3,1,0,2,5,Laurie Warder
1988,101360,2187.359869,1,0,0,1,38,Mark Keil
1986,100986,2187.358693,1,0,0,1,33,Dacio Campos
1985,106929,2187.35705,1,0,0,1,10,Eiji Takeuchi
2003,102558,2187.356139,11,5,0,6,6,Eric Taino
1996,102668,2187.355815,1,0,0,1,10,Tapio Nurminen
2000,102585,2187.35428,3,1,0,2,11,Sebastian Prieto
1994,102457,2187.351859,1,0,0,1,22,Miles Maclagan
1985,108577,2187.349765,3,1,0,2,31,Zhao Xie
1992,101348,2187.349176,8,3,0,5,6,Dave Randall
1993,100901,2187.338781,1,0,0,1,6,Paul Annacone
2007,103174,2187.337713,5,2,0,3,10,Noam Okun
1997,102925,2187.335646,40,17,0,23,2,Justin Gimelstob
2002,102615,2187.334524,3,1,0,2,27,Dennis Van Scheppingen
1998,102920,2187.32829,1,0,0,1,31,Diego Hipperdinger
1999,102458,2187.326935,1,0,0,1,12,Jim Thomas
1998,103133,2187.326457,1,0,0,1,23,Olivier Mutis
1997,102271,2187.319593,57,29,0,28,3,Hicham Arazi
2010,108749,2187.316338,1,0,0,1,22,Sergis Kyratzis
1994,101226,2187.313509,1,0,0,1,14,Johan Carlsson
2010,103580,2187.311422,1,0,0,1,23,Alexander Peya
1985,100872,2187.309841,1,0,0,1,21,Rill Baxter
1999,101826,2187.303301,5,2,0,3,10,Alex Lopez Moron
1991,101696,2187.301108,1,0,0,1,29,Federico Mordegan
1992,102250,2187.299499,1,0,0,1,34,Emanuel Couto
2010,105116,2187.29893,1,0,0,1,13,Dusan Lojda
1996,108999,2187.290528,1,0,0,1,18,Dan Cantwell
1987,100984,2187.290187,1,0,0,1,37,Peter Wright
2011,104732,2187.281619,1,0,0,1,19,Phillip Simmonds
1999,103158,2187.277273,1,0,0,1,19,Johan Ortegren
1994,101522,2187.272478,1,0,0,1,32,Chi Wan Kim
2005,104842,2187.271713,3,1,0,2,17,Salifu Mohammed
1996,103454,2187.266785,1,0,0,1,34,Nicolas Massu
2000,103319,2187.26543,1,0,0,1,23,Jeff Morrison
1995,101630,2187.260011,1,0,0,1,8,Clement Ngoran
2000,102934,2187.259623,3,1,0,2,32,Nicolas Coutelot
2005,103690,2187.257554,1,0,0,1,14,Marcin Matkowski
2002,102434,2187.255384,30,13,0,17,3,Vincent Spadea
1995,107653,2187.251208,1,0,0,1,40,Marco Cacopardo
1995,101312,2187.249914,1,0,0,1,27,Robbie Weiss
1997,102623,2187.24891,1,0,0,1,36,Thomas Larsen
2006,104195,2187.248337,1,0,0,1,9,Simone Vagnozzi
1988,102019,2187.248218,1,0,0,1,9,Dirk Dier
1994,101900,2187.244755,46,20,0,26,5,Nicklas Kulti
2006,103063,2187.240554,1,0,0,1,35,Sebastien De Chaunac
1986,109055,2187.235831,1,0,0,1,26,Atlihan Binoz
1990,101059,2187.234738,1,0,0,1,15,Richard Vogel
1987,101493,2187.233769,1,0,0,1,5,Christian Weis
2015,104783,2187.232759,1,0,0,1,30,Mikhail Ledovskikh
2007,104043,2187.230799,1,0,0,1,32,Marc Lopez
2011,105001,2187.227264,3,1,0,2,8,Mao Xin Gong
2007,105028,2187.225055,5,2,0,3,12,Jesse Levine
1989,101719,2187.223524,1,0,0,1,31,Frederic Fontang
2007,102780,2187.222075,3,1,0,2,15,Frederic Niemeyer
1986,101234,2187.219959,4,1,0,3,7,Patrik Kuhnen
2008,102881,2187.217456,1,0,0,1,23,David Skoch
2005,104070,2187.217038,1,0,0,1,16,Jesse Witten
2011,104975,2187.216986,1,0,0,1,25,Evgeny Kirillov
1987,101018,2187.216816,1,0,0,1,31,Edoardo Mazza
1990,100782,2187.216647,5,2,0,3,1,Pablo Arraya
1999,103114,2187.207879,3,1,0,2,20,Martin Lee
1997,102221,2187.192699,1,0,0,1,11,Diego Lozano
2006,103984,2187.189797,1,0,0,1,3,Julien Mathieu
1998,101362,2187.177691,1,0,0,1,19,Stephane Simian
2002,103923,2187.170166,1,0,0,1,15,Radoslaw Nijaki
1995,102083,2187.170072,1,0,0,1,23,Nick Gould
2004,104485,2187.168638,1,0,0,1,19,Nick Van Der Meer
1996,101885,2187.160029,3,1,0,2,23,Wayne Arthurs
2009,108962,2187.159329,3,1,0,2,21,Razlan Rawi
1999,101890,2187.159016,7,3,0,4,19,Jonathan Stark
2004,103914,2187.156251,1,0,0,1,34,Omar Awadhy
1998,101668,2187.155456,1,0,0,1,32,Peter Nyborg
1992,102454,2187.154738,1,0,0,1,31,Hyeong Keun Song
2001,102809,2187.152134,6,2,0,4,4,Axel Pretzsch
1997,102028,2187.151185,1,0,0,1,7,Massimo Valeri
2010,104026,2187.146612,1,0,0,1,40,Joachim Johansson
1998,102657,2187.144404,3,1,0,2,18,Yue Wei Wang
2005,103032,2187.141937,3,1,0,2,23,Francisco Fogues
2013,105169,2187.138266,1,0,0,1,34,Jean Andersen
1992,100836,2187.137632,1,0,0,1,34,Glenn Michibata
1992,102204,2187.136737,1,0,0,1,44,Nebojsa Djordjevic
1998,103164,2187.136597,1,0,0,1,42,Artemi Tchernenko
2001,103914,2187.134012,1,0,0,1,37,Omar Awadhy
2002,103305,2187.131734,1,0,0,1,9,Daniel Elsner
2009,103577,2187.128435,1,0,0,1,38,Christopher Kas
1995,101687,2187.127027,1,0,0,1,40,David Dilucia
1987,101963,2187.125442,1,0,0,1,15,Emmanuel Marmillod
2003,104349,2187.125295,1,0,0,1,17,Rui Machado
1988,100959,2187.124759,1,0,0,1,50,Chris Kennedy
1991,101295,2187.124647,1,0,0,1,38,Toshihisa Tsuchihashi
1999,103813,2187.122278,1,0,0,1,9,Jarkko Nieminen
2001,103365,2187.121661,1,0,0,1,8,Javier Garcia Sintes
2015,111575,2187.118549,1,0,0,1,19,Karen Khachanov
2002,103912,2187.116515,3,1,0,2,16,Mario Radic
1990,102047,2187.116317,1,0,0,1,4,Pier Gauthier
1992,101868,2187.114397,1,0,0,1,6,Dick Norman
1986,110847,2187.113877,1,0,0,1,44,Luis Arturo Gonzalez
1993,102824,2187.11177,1,0,0,1,20,John Roddick
1996,102300,2187.10837,1,0,0,1,32,Gouichi Motomura
2010,105128,2187.107692,1,0,0,1,34,Guillermo Olaso
1985,101056,2187.105578,1,0,0,1,46,Chuck Willenborg
2013,125574,2187.104241,1,0,0,1,41,Soteris Hadjistyllis
2014,123915,2187.103488,1,0,0,1,40,Arturs Lazdins
2015,105943,2187.102469,1,0,0,1,28,Federico Gaio
1990,101608,2187.102431,1,0,0,1,19,Tom Kempers
2012,104797,2187.094443,63,31,0,32,3,Denis Istomin
2005,104783,2187.088924,1,0,0,1,5,Mikhail Ledovskikh
2009,104158,2187.087454,1,0,0,1,43,Andrew Anderson
2015,126646,2187.086484,1,0,0,1,11,Tim Van Rijthoven
1992,101971,2187.085754,1,0,0,1,8,Johan Anderson
1987,100903,2187.080091,1,0,0,1,23,Mike Lee
2001,102239,2187.079825,1,0,0,1,11,Francisco Costa
2008,105572,2187.079784,1,0,0,1,10,Austin Krajicek
2004,108344,2187.079,3,1,0,2,31,Tai Wei Liu
1993,102219,2187.076702,1,0,0,1,5,Juan Garat
2011,104476,2187.073835,1,0,0,1,13,Louk Sorensen
2015,127570,2187.072115,1,0,0,1,4,Rodrigo Arus
2007,103899,2187.07043,3,1,0,2,19,Stian Boretti
2005,103682,2187.065669,1,0,0,1,8,Kyu Tae Im
2005,104454,2187.064972,1,0,0,1,26,Murad Inoyatov
1998,102307,2187.06491,1,0,0,1,18,Ling Lu
2011,105614,2187.064612,1,0,0,1,41,Bradley Klahn
1998,103021,2187.064352,1,0,0,1,3,Ricardo Schlachter
2007,104768,2187.064107,3,1,0,2,19,Juho Paukku
1988,101339,2187.063964,9,3,0,6,9,Agustin Moreno
1991,101588,2187.062865,1,0,0,1,14,Jason Netter
1990,101510,2187.061728,5,2,0,3,3,Henrik Holm
1986,100426,2187.061133,1,0,0,1,43,Hans Peter Kandler
1999,103197,2187.060357,1,0,0,1,18,John Doran
2013,117365,2187.057355,3,1,0,2,34,Petros Chrysochos
2000,101947,2187.056074,1,0,0,1,47,Vincenzo Santopadre
2005,103182,2187.054952,1,0,0,1,15,Markus Hipfl
1996,102905,2187.051841,3,1,0,2,14,Stefan Koubek
1993,101957,2187.050911,7,3,0,4,6,Milen Velev
1997,103454,2187.05024,1,0,0,1,2,Nicolas Massu
2001,108634,2187.047715,1,0,0,1,33,Rodrigo Vallejo
1992,101531,2187.047078,1,0,0,1,13,Mario Visconti
1998,102304,2187.047001,1,0,0,1,40,Grant Doyle
2000,102118,2187.045478,1,0,0,1,19,Radomir Vasek
1996,102235,2187.045372,3,1,0,2,42,Tommy Ho
2010,105730,2187.045362,1,0,0,1,43,Devin Britton
2000,102918,2187.04481,3,1,0,2,20,Efe Ustundag
1994,108831,2187.044634,1,0,0,1,36,Michael Walker
2006,103872,2187.044634,1,0,0,1,16,Dimitar Grabuloski
2009,104385,2187.044634,1,0,0,1,41,Lars Poerschke
1988,101676,2187.044573,1,0,0,1,50,Adam Anderson
1994,101750,2187.043784,19,8,0,11,9,Cristiano Caratti
1994,100619,2187.043392,1,0,0,1,8,George Kalovelonis
2008,108691,2187.042962,3,1,0,2,31,Khalid Al Nabhani
1999,102437,2187.042499,38,15,0,23,8,Adrian Voinea
1992,102491,2187.041237,1,0,0,1,7,Alex Radulescu
1990,101295,2187.040662,1,0,0,1,27,Toshihisa Tsuchihashi
2008,105065,2187.040386,1,0,0,1,36,Tim Smyczek
2007,104760,2187.039806,1,0,0,1,40,Scott Oudsema
2005,103914,2187.036112,1,0,0,1,35,Omar Awadhy
2012,105572,2187.035353,1,0,0,1,38,Austin Krajicek
1999,102571,2187.035225,1,0,0,1,33,Gregory Carraz
1994,102491,2187.033732,3,1,0,2,7,Alex Radulescu
1985,101448,2187.033437,3,1,0,2,26,Tasos Bavelas
2011,105717,2187.027788,1,0,0,1,21,Tzvetan Mihov
2001,102851,2187.027545,1,0,0,1,19,Giorgio Galimberti
1990,101570,2187.027402,1,0,0,1,27,Vicente Solves
2009,105029,2187.026649,1,0,0,1,29,Sergey Betov
1989,101787,2187.025806,1,0,0,1,10,Darren Patten
1988,100315,2187.024294,1,0,0,1,50,Hank Pfister
1989,101129,2187.024294,1,0,0,1,55,Andrew Lobb
1993,102192,2187.024294,1,0,0,1,36,Luis Adrian Morejon
1994,101035,2187.024294,1,0,0,1,46,Menno Oosting
1994,101672,2187.024294,1,0,0,1,46,Michael Geserer
1995,102006,2187.024294,1,0,0,1,44,Brent Larkham
1995,102277,2187.024294,1,0,0,1,45,Bing Chao Lin
1996,103413,2187.024294,1,0,0,1,10,Genius Chidzikwe
1997,102068,2187.024294,3,1,0,2,33,Omer Rashid
1997,102800,2187.024294,3,1,0,2,19,Nenad Zimonjic
1997,107310,2187.024294,1,0,0,1,19,Jean Nabi
1998,108621,2187.024294,1,0,0,1,18,Seyed Akbar Taheri Rahaghi
1999,100754,2187.024294,3,1,0,2,18,Rafael Avalos Brenes
1999,104348,2187.024294,1,0,0,1,34,Dias Doskarayev
1999,108592,2187.024294,3,1,0,2,34,Pavel Baranov
1999,108596,2187.024294,1,0,0,1,31,Ramin Raziyani
1999,108758,2187.024294,3,1,0,2,18,Kossi Loglo
2001,102830,2187.024294,3,1,0,2,33,Paulo Carvallo
2001,103568,2187.024294,3,1,0,2,18,Valentin Sanon
2001,104258,2187.024294,1,0,0,1,33,Juan Enrique Crosa
2001,108596,2187.024294,3,1,0,2,33,Ramin Raziyani
2001,198630,2187.024294,1,0,0,1,33,Serge Dakessian
2002,101996,2187.024294,1,0,0,1,17,David Mullins
2002,102997,2187.024294,1,0,0,1,31,Hermes Gamonal
2002,103905,2187.024294,3,1,0,2,31,Ricardo Chile Fonte
2002,108631,2187.024294,1,0,0,1,31,Wen Lung Chang
2002,108665,2187.024294,1,0,0,1,17,Alexandru Andronachi
2003,103529,2187.024294,3,1,0,2,8,Aisam Ul Haq Qureshi
2003,103921,2187.024294,1,0,0,1,7,Sonchat Ratiwatana
2003,104179,2187.024294,1,0,0,1,31,Bruno Echagaray
2003,108646,2187.024294,3,1,0,2,31,Joseph Victorino
2003,108647,2187.024294,3,1,0,2,31,Anton Tsymbalov
2003,108675,2187.024294,3,1,0,2,31,Iphton Louis
2003,108891,2187.024294,1,0,0,1,31,Jose Antonio Velazquez
2003,108899,2187.024294,1,0,0,1,8,Davin Russell
2003,108905,2187.024294,1,0,0,1,31,Mansur Yakhyaev
2004,104395,2187.024294,1,0,0,1,31,Marcel Felder
2004,104895,2187.024294,1,0,0,1,31,Abdullah Maqdas
2005,104040,2187.024294,1,0,0,1,17,Adam Thompson
2005,104112,2187.024294,3,1,0,2,17,Benjamin Balleret
2005,104873,2187.024294,1,0,0,1,17,Aleksandr Nedovyesov
2005,108912,2187.024294,1,0,0,1,17,Janis Skroderis
2006,102740,2187.024294,1,0,0,1,30,Francisco Rodriguez
2006,104292,2187.024294,3,1,0,2,16,Izak Van Der Merwe
2006,104875,2187.024294,1,0,0,1,16,Denes Lukacs
2006,105006,2187.024294,1,0,0,1,30,Chu Huan Yi
2006,108932,2187.024294,1,0,0,1,16,Pfungwa Mahefu
2006,108966,2187.024294,1,0,0,1,30,Igor Chaldounov
2007,104412,2187.024294,1,0,0,1,35,Matt Simpson
2007,105149,2187.024294,1,0,0,1,9,Reda El Amrani
2007,105159,2187.024294,1,0,0,1,35,Vaja Uzakov
2007,105419,2187.024294,1,0,0,1,35,Patricio Alvarado
2007,108980,2187.024294,1,0,0,1,35,Luis Delgado
2008,105286,2187.024294,1,0,0,1,41,Greg Jones
2008,108972,2187.024294,1,0,0,1,31,Ibrahim Abou Chahine
2008,108980,2187.024294,1,0,0,1,31,Luis Delgado
2009,104591,2187.024294,1,0,0,1,21,Patrick Tierro
2009,104807,2187.024294,1,0,0,1,35,Mehdi Ziadi
2009,105305,2187.024294,1,0,0,1,21,Valentin Dimov
2009,108715,2187.024294,1,0,0,1,21,Nicolas Salama
2009,108722,2187.024294,1,0,0,1,21,Demetrios Leontis
2009,108725,2187.024294,1,0,0,1,21,Sid Ali Akkal
2010,103448,2187.024294,1,0,0,1,34,Gabriel Trujillo Soler
2011,103529,2187.024294,3,1,0,2,21,Aisam Ul Haq Qureshi
2011,104763,2187.024294,3,1,0,2,21,Rafael Arevalo
2011,105201,2187.024294,3,1,0,2,21,Marc Abdulnour
2011,105656,2187.024294,3,1,0,2,21,Marcelo Arevalo
2011,105671,2187.024294,1,0,0,1,31,Gastao Elias
2012,103499,2187.024294,3,1,0,2,35,Aqeel Khan
2012,104909,2187.024294,1,0,0,1,11,Sunu Wahyu Trijati
2012,106198,2187.024294,3,1,0,2,35,Hugo Dellien
2013,104945,2187.024294,3,1,0,2,34,James Mcgee
2014,103877,2187.024294,1,0,0,1,32,Mike Scheidweiler
2014,105434,2187.024294,1,0,0,1,32,Ruan Roelofse
2014,105448,2187.024294,1,0,0,1,40,Hsien Yin Peng
2015,105047,2187.024294,1,0,0,1,41,Tim Puetz
2015,126204,2187.024294,1,0,0,1,19,Gerardo Lopez Villasenor
2010,104949,2187.024233,3,1,0,2,11,Weerapat Doakmaiklee
2002,108594,2187.022715,3,1,0,2,31,Johnny Arcilla
2004,103184,2187.021636,1,0,0,1,36,Bob Bryan
1988,100986,2187.02116,1,0,0,1,49,Dacio Campos
2012,104629,2187.012668,1,0,0,1,22,Adrian Menendez Maceiras
1987,101387,2187.011843,25,12,0,13,13,Claudio Pistolesi
2011,105379,2187.011833,3,1,0,2,6,Aljaz Bedene
2015,103967,2187.008677,1,0,0,1,36,Michael Lammer
1989,108805,2187.00792,1,0,0,1,53,Thomas Sorensen
1985,100939,2187.003951,1,0,0,1,46,Joey Rive
1994,101596,2187.003951,1,0,0,1,37,Mohamed Ridaoui
2001,104243,2187.003951,1,0,0,1,18,Oscar Posada
2007,105261,2187.003951,1,0,0,1,19,Roberto Maytin
2009,104700,2187.003951,3,1,0,2,11,Daniel Vallverdu
1999,102140,2187.003945,1,0,0,1,34,Bruno Fragoso
2010,103427,2187.003922,3,1,0,2,9,Yew Ming Si
2013,108594,2187.003922,3,1,0,2,11,Johnny Arcilla
2005,103875,2187.003162,3,1,0,2,17,Anoosha Shahgholi
2005,103803,2187.003131,3,1,0,2,17,Ashkan Shokoofi
1996,101594,2187.00313,3,1,0,2,33,Carsten Arriens
2006,103860,2187.000654,3,1,0,2,8,Timo Nieminen
1995,102581,2186.998955,1,0,0,1,14,Goran Oresic
1998,103339,2186.997528,1,0,0,1,32,Wesley Whitehouse
2006,103684,2186.995911,1,0,0,1,19,Benedikt Dorsch
1986,101121,2186.994161,3,1,0,2,26,Alaaddin Karagoz
2015,105935,2186.992593,3,1,0,2,19,Duilio Beretta
1985,101599,2186.992204,1,0,0,1,14,Thierry Grin
1990,101945,2186.991951,1,0,0,1,6,Thierry Guardiola
2004,104247,2186.991829,1,0,0,1,18,Sebo Kiss
1988,101642,2186.988849,3,1,0,2,2,Bart Wuyts
2006,103775,2186.987507,1,0,0,1,37,Felipe Parada
2001,101831,2186.98709,3,1,0,2,18,Mustafa Azkara
2000,103280,2186.986929,1,0,0,1,21,Martin Verkerk
2000,103677,2186.986598,1,0,0,1,19,Andreas Fasching
2005,104287,2186.985678,1,0,0,1,16,Steven Korteling
1990,101895,2186.983668,1,0,0,1,35,Michael Brown B395
2012,105711,2186.983607,1,0,0,1,43,Dino Marcan
1993,100431,2186.983579,3,1,0,2,36,Mansour Bahrami
1993,101237,2186.983064,1,0,0,1,4,Danilo Marcelino
2000,102543,2186.979593,5,2,0,3,9,Chia Yen Tsai
2009,102033,2186.978639,1,0,0,1,21,Abdelhak Hameurlaine
1994,102378,2186.97863,3,1,0,2,4,Juan Gisbert Jr
1997,101815,2186.976205,1,0,0,1,11,Sergio Gomez Barrio
1987,108352,2186.974417,1,0,0,1,38,Takeshi Omono
2007,104247,2186.969863,3,1,0,2,19,Sebo Kiss
1986,100630,2186.966884,1,0,0,1,4,Gustavo Guerrero
1986,100497,2186.965762,1,0,0,1,10,Markus Gunthardt
1992,101274,2186.96401,3,1,0,2,34,Udo Riglewski
1995,101341,2186.959949,1,0,0,1,16,Pablo Albano
1994,101675,2186.959536,1,0,0,1,5,Martin Rodriguez
2009,104235,2186.95755,1,0,0,1,38,Matwe Middelkoop
2009,102950,2186.953047,1,0,0,1,25,Fernando Vicente
1989,101009,2186.952396,3,1,0,2,25,John Sobel
1997,102400,2186.949156,1,0,0,1,15,Elia Grossi
1988,100449,2186.947526,1,0,0,1,46,Stanislav Birner
1995,101858,2186.943433,1,0,0,1,12,Gilles Bastie
1985,101058,2186.943058,1,0,0,1,27,Francisco Yunis
1996,101377,2186.941712,1,0,0,1,20,Christian Bergstrom
1995,101382,2186.940796,39,16,0,23,3,Marcelo Filippini
2004,103422,2186.940337,1,0,0,1,22,Sebastian Fitz
2013,105216,2186.940141,5,2,0,3,8,Yuichi Sugita
1998,102282,2186.939142,1,0,0,1,31,Tetsuya Chaen
2005,103708,2186.936875,1,0,0,1,18,Jaroslav Pospisil
2000,103381,2186.936682,1,0,0,1,32,Andy Fahlke
2000,102734,2186.933845,3,1,0,2,16,Lior Mor
1988,101356,2186.931313,1,0,0,1,26,Buff Farrow
1999,102667,2186.931143,3,1,0,2,32,Satoshi Iwabuchi
2010,105318,2186.928489,1,0,0,1,6,Thomas Schoorel
1999,103444,2186.926532,3,1,0,2,8,Jean Rene Lisnard
1997,102669,2186.925455,1,0,0,1,33,Noam Behr
1988,101045,2186.925162,1,0,0,1,26,Craig Boynton
1994,101893,2186.923917,1,0,0,1,10,Patrick Mohr
1999,102963,2186.921724,1,0,0,1,2,Robert Lindstedt
2006,104161,2186.921519,1,0,0,1,27,Tomislav Peric
2006,104173,2186.91852,3,1,0,2,32,Sam Warburg
1992,108552,2186.91297,1,0,0,1,19,Yannos Hadjigeorgiou
2011,102388,2186.908372,1,0,0,1,38,Simon Aspelin
2002,102239,2186.907405,1,0,0,1,30,Francisco Costa
1996,100955,2186.906569,1,0,0,1,11,Yahiya Doumbia
1989,100982,2186.901995,1,0,0,1,12,Charlton Eagle
1998,103645,2186.901201,1,0,0,1,9,Balazs Veress
1996,101814,2186.900672,3,1,0,2,11,Colin Beecher
2007,103166,2186.898443,3,1,0,2,9,Vladimir Voltchkov
1998,102250,2186.897265,1,0,0,1,22,Emanuel Couto
2001,102629,2186.894508,1,0,0,1,20,Oscar Burrieza
1987,100276,2186.891331,3,1,0,2,49,Terry Moor
1993,101639,2186.891187,3,1,0,2,14,Lan Bale
2001,102886,2186.890525,1,0,0,1,28,Frantisek Cermak
1994,101629,2186.889457,1,0,0,1,24,Matt Lucena
1999,102536,2186.884759,1,0,0,1,9,James Greenhalgh
2006,104831,2186.881224,1,0,0,1,27,Bartolome Salva Vidal
2013,111578,2186.876138,1,0,0,1,21,Stefan Kozlov
1997,102354,2186.875509,1,0,0,1,29,Jerome Hanquez
2007,103656,2186.870407,44,21,0,23,2,Albert Montanes
1995,101861,2186.870148,1,0,0,1,17,Thomas Buchmayer
2010,104424,2186.868017,7,3,0,4,8,Go Soeda
1990,101417,2186.865603,1,0,0,1,9,Mario Rincon
1997,101970,2186.860958,3,1,0,2,19,Iztok Bozic
1988,100727,2186.859173,10,4,0,6,2,Raul Antonio Viver
1995,102891,2186.856074,1,0,0,1,35,Rodolfo Varela
2011,105085,2186.853859,1,0,0,1,12,Artem Smirnov
1997,103018,2186.846978,5,2,0,3,18,Max Mirnyi
1994,101642,2186.846427,1,0,0,1,36,Bart Wuyts
1994,101765,2186.846234,1,0,0,1,34,Tomas Anzari
2010,103672,2186.841733,23,11,0,12,9,Ricardo Mello
1991,107201,2186.841614,1,0,0,1,7,Hidehiko Tanizawa
2012,106058,2186.839339,12,5,0,7,12,Jack Sock
2001,103912,2186.838179,1,0,0,1,20,Mario Radic
2007,103250,2186.836701,1,0,0,1,3,Rodolphe Cadart
2004,104167,2186.834958,1,0,0,1,10,Todd Widom
1992,102205,2186.834316,3,1,0,2,14,Sebastien Lareau
2004,104717,2186.833643,1,0,0,1,34,Brendan Evans
2010,104661,2186.833529,1,0,0,1,16,Pierre Ludovic Duclos
1987,106962,2186.832744,1,0,0,1,15,Ernesto Vazquez
1995,102215,2186.830856,1,0,0,1,6,Joshua Eagle
2012,105554,2186.827301,5,2,0,3,35,Daniel Evans
2007,105064,2186.827269,1,0,0,1,9,Thomaz Bellucci
2003,103109,2186.827196,1,0,0,1,30,Talal Ouahabi
1985,107721,2186.82585,1,0,0,1,13,Martin Valenti
2006,104262,2186.823037,1,0,0,1,15,Flavio Cipolla
2002,103401,2186.820054,1,0,0,1,16,Jan Hernych
1994,102090,2186.814803,1,0,0,1,7,Ofer Sela
2013,110536,2186.813054,1,0,0,1,19,Kevin King
1985,100569,2186.810291,1,0,0,1,10,Toru Yonezawa
1996,102076,2186.810205,1,0,0,1,27,Mark Merklein
2015,106138,2186.809014,1,0,0,1,10,Yaraslau Shyla
1995,100713,2186.802617,1,0,0,1,42,John Fitzgerald
2003,103465,2186.797728,1,0,0,1,21,Paul Logtens
2007,103730,2186.797316,1,0,0,1,22,Jonathan Marray
2012,103821,2186.794134,5,2,0,3,9,Danai Udomchoke
1990,101932,2186.792582,3,1,0,2,15,Jared Palmer
2011,103534,2186.791255,1,0,0,1,35,Nicolas Devilder
1997,103498,2186.790113,1,0,0,1,2,Marat Safin
2003,103609,2186.789731,1,0,0,1,15,Matthew Behrmann
1989,100759,2186.788603,23,10,0,13,3,Danie Visser
2009,103437,2186.786016,1,0,0,1,27,Francesco Piccari
1988,101155,2186.785784,3,1,0,2,28,James Turner
1996,101149,2186.784659,1,0,0,1,37,Morten Christensen
1992,102223,2186.779503,5,2,0,3,17,Karim Alami
1998,102791,2186.774824,3,1,0,2,15,Bobby Kokavec
1993,101506,2186.772207,3,1,0,2,21,Eoin Collins
1999,102381,2186.771706,1,0,0,1,16,Werner Eschauer
2002,103792,2186.767802,1,0,0,1,6,Joji Miyao
1992,102359,2186.761929,1,0,0,1,22,Andrew Richardson
2015,105281,2186.760313,1,0,0,1,38,Eric Quigley
1992,101407,2186.758634,10,4,0,6,7,David Engel
2003,108898,2186.757913,1,0,0,1,8,Christopher Eldon
2003,103837,2186.750021,1,0,0,1,28,Didac Perez
2007,104014,2186.74502,1,0,0,1,22,Lee Childs
2006,104171,2186.737522,3,1,0,2,19,Richard Bloomfield
1987,100326,2186.733917,7,3,0,4,37,Russell Simpson
1985,101196,2186.733518,3,1,0,2,16,Derrick Rostagno
1993,101369,2186.731577,5,2,0,3,14,Bent Ove Pedersen
2006,104121,2186.729356,1,0,0,1,26,Tobias Summerer
1997,101608,2186.727173,1,0,0,1,16,Tom Kempers
1996,101725,2186.721071,1,0,0,1,3,Gabriel Markus
1994,102047,2186.720726,1,0,0,1,8,Pier Gauthier
1994,103059,2186.720716,1,0,0,1,7,Radovan Chrz
1992,101329,2186.720569,1,0,0,1,3,Christer Allgardh
2014,106066,2186.716155,1,0,0,1,4,Victor Baluda
1996,101703,2186.715715,44,22,0,22,3,Guillaume Raoux
2007,105402,2186.713953,1,0,0,1,8,Peerakiat Siriluethaiwattana
2004,103847,2186.713893,1,0,0,1,10,Adrian Bohane
1991,101876,2186.71176,1,0,0,1,17,Massimo Ardinghi
2010,104229,2186.709499,35,15,0,20,3,Yen Hsun Lu
2008,104618,2186.708286,5,2,0,3,12,Devin Mullings
1987,100477,2186.707794,1,0,0,1,37,Gianni Ocleppo
1991,100876,2186.70081,1,0,0,1,7,Bong Soo Kim
2000,101991,2186.699627,1,0,0,1,42,Mauricio Hadad
2002,104166,2186.698848,3,1,0,2,10,Alex Bogomolov Jr
2015,111453,2186.697666,2,0,0,2,11,Mikael Torpegaard
1985,101238,2186.697281,1,0,0,1,14,Andres Vysand
2007,105166,2186.687551,3,1,0,2,15,Peter Polansky
1989,101267,2186.682174,1,0,0,1,9,Michael Oberleitner
1994,102905,2186.678525,1,0,0,1,23,Stefan Koubek
1994,102067,2186.677881,1,0,0,1,13,Emanuel Rasberger
2007,104495,2186.677569,1,0,0,1,41,Florin Mergea
2012,103484,2186.677352,21,8,0,13,10,James Blake
1990,102226,2186.674279,1,0,0,1,9,David Witt
2001,102529,2186.673346,1,0,0,1,10,Thomas Shimada
2011,103573,2186.672988,11,5,0,6,10,Rik De Voest
1989,101670,2186.670769,1,0,0,1,20,Martin Schaffl
1995,102430,2186.665469,1,0,0,1,38,Adam Peterson
2010,104262,2186.665089,1,0,0,1,31,Flavio Cipolla
2002,103092,2186.664773,1,0,0,1,30,Nuno Matias
2002,102868,2186.664124,1,0,0,1,17,Jonathan Printzlau
1988,101861,2186.661767,1,0,0,1,21,Thomas Buchmayer
2002,103672,2186.660941,1,0,0,1,9,Ricardo Mello
1999,103027,2186.656396,1,0,0,1,21,Markus Menzler
1990,101866,2186.655725,1,0,0,1,20,David Rikl
2011,103914,2186.653698,1,0,0,1,39,Omar Awadhy
2015,105671,2186.651864,3,1,0,2,11,Gastao Elias
1996,101926,2186.651672,1,0,0,1,11,Andrei Merinov
2013,105987,2186.651139,1,0,0,1,10,Mikhail Biryukov
1989,101783,2186.649408,3,1,0,2,18,Mark Petchey
2004,101869,2186.647585,1,0,0,1,4,Juan Luis Tati Rascon
1986,100475,2186.647476,1,0,0,1,41,Matt Mitchell
1996,108381,2186.644274,1,0,0,1,37,Thomas Andersen
2001,103281,2186.640492,1,0,0,1,43,Ladislav Svarc
1987,101059,2186.640393,3,1,0,2,19,Richard Vogel
1999,102413,2186.6402,1,0,0,1,33,Andy Zingman
2015,104770,2186.639969,1,0,0,1,30,Martin Fischer
2003,103281,2186.635339,1,0,0,1,18,Ladislav Svarc
2015,104839,2186.635142,3,1,0,2,19,Yassine Idmbarek
1995,101994,2186.63409,1,0,0,1,12,Remus Farcas
2011,105145,2186.631572,3,1,0,2,21,Jaak Poldma
1989,101674,2186.624889,1,0,0,1,38,Rudiger Haas
1999,103497,2186.624431,1,0,0,1,2,Artem Derepasko
1990,101861,2186.623546,1,0,0,1,13,Thomas Buchmayer
1986,100470,2186.621993,1,0,0,1,34,Juan Carlos Andrade
1988,100241,2186.618398,1,0,0,1,8,Joel Bailey
1986,106962,2186.6169,1,0,0,1,34,Ernesto Vazquez
1992,102069,2186.615499,1,0,0,1,3,Andrei Rybalko
1996,101567,2186.615389,10,4,0,6,9,Hendrik Jan Davids
1991,101066,2186.615274,1,0,0,1,40,Richard Matuszewski
1990,101890,2186.61506,1,0,0,1,34,Jonathan Stark
1986,100546,2186.612556,1,0,0,1,33,Eric Fromm
1992,102524,2186.610714,1,0,0,1,34,Neville Godwin
1998,102455,2186.607939,1,0,0,1,19,Lorenzo Manta
2006,103592,2186.606451,1,0,0,1,35,Jerome Haehnel
1992,101608,2186.604781,1,0,0,1,18,Tom Kempers
2008,108702,2186.603428,1,0,0,1,17,George Kallis
2009,104211,2186.601761,1,0,0,1,10,Roman Valent
1987,100241,2186.601735,1,0,0,1,38,Joel Bailey
1995,102031,2186.601666,26,10,0,16,4,Sandor Noszaly
2011,105367,2186.601348,5,2,0,3,12,Daniel Alejandro Lopez Cassaccia
1989,107374,2186.600162,1,0,0,1,22,John Antonas
2007,108344,2186.599751,1,0,0,1,41,Tai Wei Liu
2006,104535,2186.599006,1,0,0,1,8,Daniel Garza
2009,105464,2186.598208,3,1,0,2,21,Christopher Rungkat
1994,101938,2186.59657,1,0,0,1,11,Bernardo Mota
2006,103976,2186.595565,1,0,0,1,35,Juan Pablo Brzezicki
2008,102254,2186.59448,1,0,0,1,17,Ouassel Hared
2013,105302,2186.5943,1,0,0,1,21,Ante Pavic
1996,102897,2186.592572,3,1,0,2,6,Nir Welgreen
2014,105999,2186.591963,1,0,0,1,7,Bowen Ouyang
1991,102378,2186.589956,1,0,0,1,12,Juan Gisbert Jr
1991,101926,2186.588596,1,0,0,1,30,Andrei Merinov
1999,103167,2186.588133,1,0,0,1,15,Jocelyn Robichaud
1985,107262,2186.585571,1,0,0,1,42,Jacques Grandjean
1993,102286,2186.585029,5,2,0,3,30,Wayne Black
1989,102301,2186.583535,1,0,0,1,18,Sebastien Leblanc
2006,104228,2186.5832,1,0,0,1,29,Guillem Burniol
1994,102543,2186.581364,1,0,0,1,30,Chia Yen Tsai
2004,108659,2186.580878,1,0,0,1,38,Dannio Yahya
1987,107804,2186.578003,1,0,0,1,28,Mihai Vanta
2011,105558,2186.577957,3,1,0,2,27,Guillaume Rufin
2004,104864,2186.577877,1,0,0,1,17,Alex Kuznetsov
2000,102422,2186.577735,3,1,0,2,26,Michael Hill
1997,103005,2186.576372,1,0,0,1,44,Denis Yakimenko
1990,101765,2186.576351,1,0,0,1,1,Tomas Anzari
2015,111153,2186.573343,1,0,0,1,17,Christopher Eubanks
1990,100489,2186.572508,1,0,0,1,25,Larry Stefanki
2003,101750,2186.570549,1,0,0,1,6,Cristiano Caratti
1994,101484,2186.570547,1,0,0,1,16,Vladimir Gabrichidze
1988,100921,2186.570378,1,0,0,1,31,Patrice Kuchna
1989,100985,2186.568403,1,0,0,1,19,Tim Pawsat
2015,108761,2186.56834,1,0,0,1,19,Mikelis Libietis
1995,102768,2186.568008,1,0,0,1,35,Federico Browne
2014,105113,2186.568005,1,0,0,1,4,Patrik Rosenholm
1990,101024,2186.566209,1,0,0,1,13,Christian Geyer
1995,101730,2186.56597,1,0,0,1,15,Piet Norval
1996,101626,2186.563375,1,0,0,1,16,Stephen Noteboom
2013,104803,2186.562422,1,0,0,1,33,Younes Rachidi
2012,105720,2186.562286,1,0,0,1,11,Stanislav Vovk
1989,101549,2186.561116,1,0,0,1,20,Rodolphe Gilbert
1995,107263,2186.560764,1,0,0,1,10,Jacques Radoux
1986,100878,2186.560368,1,0,0,1,8,Christoph Zipf
1988,100909,2186.560234,1,0,0,1,28,Stefan Heckmanns
1998,108994,2186.560174,1,0,0,1,11,Andrew Park
2007,103862,2186.559759,1,0,0,1,3,Michail Elgin
2007,103356,2186.558679,1,0,0,1,21,Michel Kratochvil
2011,104778,2186.557748,1,0,0,1,40,Andrey Kumantsov
1997,101675,2186.55634,3,1,0,2,11,Martin Rodriguez
1997,102588,2186.554081,1,0,0,1,35,Lars Rehmann
1994,102791,2186.551912,1,0,0,1,17,Bobby Kokavec
1998,103753,2186.545983,1,0,0,1,16,Boris Bachert
2004,103529,2186.544942,3,1,0,2,8,Aisam Ul Haq Qureshi
1991,101632,2186.54308,1,0,0,1,44,Per Henricsson
1990,101508,2186.542611,1,0,0,1,11,Magnus Zeile
2008,104192,2186.541301,1,0,0,1,37,Marco Crugnola
1995,102957,2186.540683,1,0,0,1,10,Vadim Kutsenko
2013,103577,2186.540683,1,0,0,1,41,Christopher Kas
1986,110881,2186.540678,3,1,0,2,22,Shu Hua Liu
1994,101231,2186.540499,1,0,0,1,45,Ryan Blake
2010,103401,2186.540472,1,0,0,1,41,Jan Hernych
1992,101534,2186.540436,5,2,0,3,4,Libor Nemecek
2011,103393,2186.538373,1,0,0,1,42,Yuri Schukin
1995,101977,2186.536229,1,0,0,1,35,Patricio Arnold
2003,103402,2186.534917,1,0,0,1,17,Peter Clarke
1990,100711,2186.5341,5,2,0,3,3,Pedro Rebolledo
1985,101500,2186.533969,1,0,0,1,19,Christian Saceanu
2005,104732,2186.531563,1,0,0,1,14,Phillip Simmonds
2002,103490,2186.527966,1,0,0,1,14,Santiago Ventura
1997,102892,2186.527585,1,0,0,1,32,Susheel Narla
1986,101058,2186.527476,3,1,0,2,12,Francisco Yunis
1986,101405,2186.527112,1,0,0,1,37,Ugo Colombini
2008,103226,2186.526993,3,1,0,2,17,Walid Jallali
1997,102929,2186.526761,1,0,0,1,43,Ryan Wolters
1998,102783,2186.525962,27,12,0,15,2,Rainer Schuettler
1988,101783,2186.524246,1,0,0,1,27,Mark Petchey
1990,101044,2186.524165,1,0,0,1,28,Mark Ozer
2001,101969,2186.522744,1,0,0,1,42,Orlin Stanoytchev
1995,102836,2186.522641,3,1,0,2,19,Rogier Wassen
1989,100611,2186.522352,1,0,0,1,45,Mel Purcell
2007,103865,2186.522177,3,1,0,2,35,Prima Simpatiaji
2000,102077,2186.522075,1,0,0,1,20,Alexander Shvec
1997,102473,2186.520776,1,0,0,1,17,Thomas Schiessling
1999,108868,2186.520372,1,0,0,1,9,Mariusz Zielinski
2008,108703,2186.520372,1,0,0,1,17,Eleftherios Christou
1987,101259,2186.520311,1,0,0,1,53,Mike Baroch
2003,103841,2186.518791,1,0,0,1,38,Julio Peralta
1998,101534,2186.517464,1,0,0,1,16,Libor Nemecek
2010,106105,2186.512758,1,0,0,1,34,Guilherme Clezar
2011,108748,2186.50889,1,0,0,1,21,Lukas Mugevicius
1994,103182,2186.508626,1,0,0,1,23,Markus Hipfl
1997,102140,2186.508146,1,0,0,1,32,Bruno Fragoso
2014,106430,2186.507672,1,0,0,1,29,Patrick Ciorcila
2013,105679,2186.507089,1,0,0,1,20,Eduardo Struvay
1993,101083,2186.502572,1,0,0,1,34,Tom Mercer
2007,104453,2186.502547,3,1,0,2,6,Michael Ryderstedt
2003,103693,2186.502526,8,3,0,5,2,Thierry Ascione
2015,132566,2186.501618,1,0,0,1,19,Dmitrii Baskov
2015,200271,2186.501618,1,0,0,1,19,Egor Matvievici
2009,108690,2186.50079,1,0,0,1,21,Ayrton Wibowo
2009,108718,2186.50079,1,0,0,1,11,Vicente Elberto Anasta
2012,103586,2186.50079,1,0,0,1,35,Mariusz Fyrstenberg
2001,108584,2186.500782,1,0,0,1,33,Alexander Vasquez
2009,103978,2186.50026,1,0,0,1,35,Rabie Chaki
2003,103201,2186.500123,1,0,0,1,38,Adrian Garcia
1985,100333,2186.5,1,0,0,1,10,Shigeyuki Nishio
1985,100422,2186.5,1,0,0,1,46,Bruce Manson
1985,100556,2186.5,1,0,0,1,50,Brian Levine
1985,100566,2186.5,1,0,0,1,10,Hitoshi Shirato
1985,100568,2186.5,1,0,0,1,46,John Mattke
1985,100575,2186.5,1,0,0,1,32,Andy Andrews
1985,100722,2186.5,1,0,0,1,50,Michael Fancutt
1985,100799,2186.5,1,0,0,1,44,Carlos Castellan
1985,100801,2186.5,1,0,0,1,50,Richard Akel
1985,100860,2186.5,1,0,0,1,46,William Notar
1985,100863,2186.5,1,0,0,1,44,Gustavo Luza
1985,101076,2186.5,1,0,0,1,44,Cesar Kist
1985,101166,2186.5,1,0,0,1,44,Gustavo Garetto
1985,101412,2186.5,1,0,0,1,10,Shuzo Matsuoka
1985,106930,2186.5,1,0,0,1,44,Eleuterio Martins
1985,107147,2186.5,1,0,0,1,44,Guillermo Minutella
1985,107183,2186.5,1,0,0,1,10,Hatem Mcdadi
1985,107484,2186.5,1,0,0,1,10,Kazuya Morita
1985,107590,2186.5,1,0,0,1,39,Luis Borfiga
1985,107688,2186.5,1,0,0,1,11,Mark Greenan
1985,107700,2186.5,1,0,0,1,50,Mark Long
1985,107819,2186.5,1,0,0,1,10,Minoru Ueda
1985,107845,2186.5,1,0,0,1,26,Necvet Demir
1985,110784,2186.5,1,0,0,1,31,Kamel Harrad
1985,110787,2186.5,1,0,0,1,31,Abdel Halem Azzi
1985,110798,2186.5,1,0,0,1,31,Elias Bramly
1985,110885,2186.5,1,0,0,1,31,Fan Zhang
1985,110896,2186.5,1,0,0,1,31,Hassan Soudani
1985,110940,2186.5,1,0,0,1,31,Miloud Doumbia
1985,110972,2186.5,1,0,0,1,49,Kian Wah Yeo
1985,110984,2186.5,1,0,0,1,49,Selvarajoo Selvarajoo
1985,110988,2186.5,1,0,0,1,43,Islam Ul Haq
1986,100450,2186.5,1,0,0,1,29,Leo Palin
1986,100492,2186.5,1,0,0,1,45,John Austin
1986,100680,2186.5,1,0,0,1,50,Peter Johnston
1986,100835,2186.5,1,0,0,1,43,Hans Dieter Beutel
1986,101325,2186.5,1,0,0,1,50,Jason Goodall
1986,101398,2186.5,1,0,0,1,50,Neil Borwick
1986,101421,2186.5,1,0,0,1,29,Veli Paloheimo
1986,101601,2186.5,1,0,0,1,50,Brett Steven
1986,101650,2186.5,1,0,0,1,8,Shane Barr
1986,107213,2186.5,1,0,0,1,44,Houcine Saber
1986,107481,2186.5,1,0,0,1,44,Karl Hale
1986,107618,2186.5,1,0,0,1,50,Malcolm Elley
1986,107680,2186.5,3,1,0,2,32,Mark Bailey
1986,107838,2186.5,1,0,0,1,26,Nael Zaki
1986,108161,2186.5,1,0,0,1,44,Roland So
1986,108177,2186.5,1,0,0,1,44,Roselle Nilo Natividad
1986,108265,2186.5,1,0,0,1,50,Simon Robinson
1986,108528,2186.5,1,0,0,1,29,Wojceh Jamroz
1986,108552,2186.5,1,0,0,1,32,Yannos Hadjigeorgiou
1986,108838,2186.5,1,0,0,1,22,Vittaya Samrej
1986,110798,2186.5,1,0,0,1,49,Elias Bramly
1986,110846,2186.5,1,0,0,1,44,John Maginley
1986,110858,2186.5,1,0,0,1,32,Phivos Zachariades
1986,110882,2186.5,1,0,0,1,32,Kelvin Ng
1986,110979,2186.5,1,0,0,1,44,Mahader Hassan
1986,111085,2186.5,1,0,0,1,49,Karim Fliss
1986,111111,2186.5,1,0,0,1,44,Victor Pereira
1987,100383,2186.5,1,0,0,1,53,Peter Mcnamara
1987,100445,2186.5,1,0,0,1,53,Steve Denton
1987,100566,2186.5,1,0,0,1,38,Hitoshi Shirato
1987,100649,2186.5,1,0,0,1,52,David Dowlen
1987,100651,2186.5,1,0,0,1,52,Alejandro Ganzabal
1987,100781,2186.5,1,0,0,1,24,Bernhard Pils
1987,100838,2186.5,1,0,0,1,53,Steve Wood
1987,100991,2186.5,1,0,0,1,33,Johnny Goudenbour
1987,101205,2186.5,1,0,0,1,53,Grant Connell
1987,101365,2186.5,1,0,0,1,46,Paul Wekesa
1987,101459,2186.5,1,0,0,1,10,Tomas Nydahl
1987,101619,2186.5,1,0,0,1,24,David Wells Roth
1987,106535,2186.5,3,1,0,2,33,Andres Battad
1987,107263,2186.5,1,0,0,1,33,Jacques Radoux
1987,107534,2186.5,1,0,0,1,46,Kush Bhardwaj
1987,108293,2186.5,1,0,0,1,15,Stefano Mezzadri
1987,110797,2186.5,1,0,0,1,51,Adel Brahim
1987,110798,2186.5,1,0,0,1,51,Elias Bramly
1987,110818,2186.5,1,0,0,1,46,Shovon Jamaly
1987,110820,2186.5,1,0,0,1,46,Mahtabur Rahman
1987,110868,2186.5,1,0,0,1,28,Alioune Toure
1987,110886,2186.5,1,0,0,1,46,Frank Sebaratnam
1987,110895,2186.5,1,0,0,1,51,Abdel Majid Soudani
1987,110896,2186.5,1,0,0,1,51,Hassan Soudani
1987,110914,2186.5,1,0,0,1,34,Robert Dolan
1987,111101,2186.5,1,0,0,1,46,Neil Rajapakse
1988,100398,2186.5,1,0,0,1,49,Julio Goes
1988,100487,2186.5,1,0,0,1,47,Renald Etienne
1988,100616,2186.5,1,0,0,1,38,Andy Kohlberg
1988,100660,2186.5,1,0,0,1,52,Bob Green
1988,100742,2186.5,1,0,0,1,50,Christo Steyn
1988,100826,2186.5,1,0,0,1,38,Juan Antonio Rodriguez
1988,100917,2186.5,1,0,0,1,49,Nelson Aerts
1988,101059,2186.5,1,0,0,1,20,Richard Vogel
1988,101144,2186.5,1,0,0,1,50,Anthony Lane
1988,101308,2186.5,1,0,0,1,3,Neil Broad
1988,101419,2186.5,1,0,0,1,13,Frank Dennhardt
1988,101422,2186.5,1,0,0,1,26,Mark Kaplan
1988,101760,2186.5,1,0,0,1,49,David Kass
1988,102008,2186.5,1,0,0,1,26,Johan Alven
1988,106689,2186.5,1,0,0,1,47,Carlos Alvarado
1988,107929,2186.5,1,0,0,1,47,Patrice Baker
1988,108060,2186.5,1,0,0,1,46,Remi Gilberton
1988,108228,2186.5,1,0,0,1,44,Sebastien Gerard
1988,108471,2186.5,1,0,0,1,16,Victor Lopez
1988,110841,2186.5,1,0,0,1,47,Hervoje Eterovic
1988,110876,2186.5,1,0,0,1,47,Norbert Oduor
1988,111008,2186.5,3,1,0,2,29,John Erik Rustad
1988,111032,2186.5,1,0,0,1,47,Anthony Navarrosa
1988,111069,2186.5,1,0,0,1,39,Mehdi Ben Ismail
1988,111070,2186.5,1,0,0,1,39,Hatem Debbeche
1989,100395,2186.5,1,0,0,1,53,Victor Pecci
1989,100398,2186.5,1,0,0,1,52,Julio Goes
1989,100402,2186.5,1,0,0,1,53,Francisco Gonzalez
1989,100719,2186.5,1,0,0,1,14,Juan Avendano
1989,100790,2186.5,1,0,0,1,56,Bruce Derlin
1989,100802,2186.5,1,0,0,1,54,Charles Honey
1989,100871,2186.5,1,0,0,1,54,Laurie Warder
1989,100899,2186.5,1,0,0,1,30,Jorgen Windahl
1989,100917,2186.5,1,0,0,1,52,Nelson Aerts
1989,100980,2186.5,1,0,0,1,52,Edvaldo Oliveira
1989,100986,2186.5,1,0,0,1,52,Dacio Campos
1989,101003,2186.5,1,0,0,1,52,Ricardo Acioly
1989,101112,2186.5,1,0,0,1,27,Michele Fioroni
1989,101250,2186.5,1,0,0,1,52,Jose Daher
1989,101461,2186.5,1,0,0,1,54,Brett Custer
1989,106978,2186.5,1,0,0,1,27,Fabio Di Mauro
1989,107221,2186.5,1,0,0,1,54,Ian Peter Budge
1989,107388,2186.5,1,0,0,1,54,John Marinov
1989,107991,2186.5,1,0,0,1,28,Peter Orwa
1989,108552,2186.5,1,0,0,1,43,Yannos Hadjigeorgiou
1989,108824,2186.5,1,0,0,1,43,Daryl Delicata
1989,109309,2186.5,1,0,0,1,43,Steven Schranz
1989,110828,2186.5,1,0,0,1,43,Wai Yaw Liu
1989,110829,2186.5,1,0,0,1,43,Barunur Rashid Bhuiyan
1989,110878,2186.5,1,0,0,1,53,Noel Rutherford
1989,110916,2186.5,1,0,0,1,43,Neoclis Neocleous
1989,111021,2186.5,1,0,0,1,53,Eyad Shahadeh
1989,111024,2186.5,1,0,0,1,53,Abdullah Al Khalil
1990,100917,2186.5,1,0,0,1,34,Nelson Aerts
1990,100949,2186.5,1,0,0,1,34,Mauro Menezes
1990,101207,2186.5,1,0,0,1,5,Michael Daniel
1990,101373,2186.5,1,0,0,1,13,Karsten Braasch
1990,101419,2186.5,1,0,0,1,7,Frank Dennhardt
1990,101516,2186.5,1,0,0,1,34,Joao Zwetsch
1990,101615,2186.5,1,0,0,1,34,Otavio Della
1990,101707,2186.5,1,0,0,1,5,Yuval Karutzi
1990,101869,2186.5,1,0,0,1,24,Juan Luis Tati Rascon
1990,102669,2186.5,1,0,0,1,5,Noam Behr
1990,107221,2186.5,1,0,0,1,35,Ian Peter Budge
1991,100857,2186.5,1,0,0,1,53,Sergio Casal
1991,101202,2186.5,1,0,0,1,19,Ian Aler
1991,101248,2186.5,1,0,0,1,13,Pat Crow
1991,101352,2186.5,1,0,0,1,37,Jae Sik Kim
1991,101375,2186.5,1,0,0,1,49,Brian Devening
1991,101581,2186.5,1,0,0,1,38,Jose Luis Aparisi
1991,101680,2186.5,1,0,0,1,42,Zeeshan Ali
1991,101722,2186.5,1,0,0,1,37,Han Cheol Shin
1991,101844,2186.5,1,0,0,1,51,Heath Denman
1991,101884,2186.5,1,0,0,1,25,Frank Ofori
1991,101886,2186.5,1,0,0,1,7,Ohad Weinberg
1991,102067,2186.5,1,0,0,1,30,Emanuel Rasberger
1991,102100,2186.5,1,0,0,1,34,Bartlomiej Dabrowski
1991,106615,2186.5,1,0,0,1,34,Bernard Balleret
1991,106670,2186.5,1,0,0,1,22,Bruce Steel
1991,107375,2186.5,1,0,0,1,51,John Arbanas
1991,108323,2186.5,3,1,0,2,42,Steven Kangwa
1991,108369,2186.5,1,0,0,1,42,Tetsuya Sato
1991,108520,2186.5,1,0,0,1,12,William Kyriakos
1991,108815,2186.5,1,0,0,1,25,Kojo Atiso
1991,110168,2186.5,1,0,0,1,50,Mario Delgado
1991,110893,2186.5,1,0,0,1,25,Mensah Gbeboume
1991,110908,2186.5,1,0,0,1,39,Jerry Williams
1991,110909,2186.5,1,0,0,1,50,Fabio Sical
1991,110924,2186.5,1,0,0,1,50,Carlos Chavez
1991,111002,2186.5,1,0,0,1,26,Hani Al Ali
1991,111029,2186.5,1,0,0,1,26,Saleh Bushnaq
1991,111045,2186.5,1,0,0,1,31,Khalid Hussain Fitiani
1991,111046,2186.5,1,0,0,1,31,Tawfik Al Ibrahim
1991,111060,2186.5,1,0,0,1,34,Christian Collange
1992,101083,2186.5,1,0,0,1,14,Tom Mercer
1992,101089,2186.5,1,0,0,1,29,Pasi Virtanen
1992,101250,2186.5,1,0,0,1,42,Jose Daher
1992,101281,2186.5,1,0,0,1,47,Shelby Cannon
1992,101308,2186.5,1,0,0,1,34,Neil Broad
1992,101605,2186.5,1,0,0,1,44,Jiu Hua Zhang
1992,101664,2186.5,1,0,0,1,44,Andras Lanyi
1992,101794,2186.5,1,0,0,1,29,Darek Nowicki
1992,101892,2186.5,1,0,0,1,47,Axel Finnberg
1992,102132,2186.5,1,0,0,1,14,Ivan Baron
1992,102615,2186.5,1,0,0,1,24,Dennis Van Scheppingen
1992,107201,2186.5,1,0,0,1,33,Hidehiko Tanizawa
1992,107460,2186.5,1,0,0,1,42,Juan Pablo Etchecoin
1992,107524,2186.5,1,0,0,1,29,Kodzo Apeti
1992,108123,2186.5,1,0,0,1,29,Robert Sliwinski
1992,108427,2186.5,1,0,0,1,44,Tomasz Lichon
1992,110826,2186.5,1,0,0,1,35,Asaf Raja
1992,110876,2186.5,1,0,0,1,44,Norbert Oduor
1992,110894,2186.5,1,0,0,1,29,Koko Kunkel
1992,110899,2186.5,3,1,0,2,19,Rashid Hassan
1992,111028,2186.5,1,0,0,1,44,Mohammed Rahizam Abdul Rahim
1992,111031,2186.5,1,0,0,1,35,Derek Yong
1992,111061,2186.5,1,0,0,1,29,Thierry Neiens
1993,100321,2186.5,1,0,0,1,48,Vijay Amritraj
1993,100529,2186.5,1,0,0,1,35,Kevin Curren
1993,100631,2186.5,1,0,0,1,33,Tim Wilkison
1993,100924,2186.5,1,0,0,1,41,Jorge Lozano
1993,101205,2186.5,1,0,0,1,38,Grant Connell
1993,101349,2186.5,1,0,0,1,48,Adam Malik
1993,101536,2186.5,1,0,0,1,48,Murphy Jensen
1993,101764,2186.5,1,0,0,1,44,Yu Hui Lien
1993,101781,2186.5,1,0,0,1,44,Robert Angelo
1993,101989,2186.5,1,0,0,1,22,Patrik Langvardt
1993,102001,2186.5,1,0,0,1,34,German Lopez
1993,102033,2186.5,3,1,0,2,8,Abdelhak Hameurlaine
1993,102119,2186.5,1,0,0,1,44,Chih Jung Chen
1993,102293,2186.5,1,0,0,1,34,Xavier Avila
1993,102382,2186.5,1,0,0,1,18,Julian Knowle
1993,102417,2186.5,1,0,0,1,48,Steven Baldas
1993,102536,2186.5,1,0,0,1,47,James Greenhalgh
1993,106718,2186.5,1,0,0,1,44,Cheng Fong Chang
1993,106741,2186.5,1,0,0,1,40,Christian Camradt
1993,108603,2186.5,1,0,0,1,30,Helge Koll Frafjord
1993,110796,2186.5,1,0,0,1,8,Noureddine Mahmoudi
1993,110941,2186.5,1,0,0,1,30,Karim Afifi
1993,111049,2186.5,1,0,0,1,44,Abdullah Al Mahmeed
1994,101022,2186.5,1,0,0,1,34,Kelly Jones
1994,101126,2186.5,1,0,0,1,47,Chris Pridham
1994,101167,2186.5,1,0,0,1,11,Jaime Cortes
1994,101242,2186.5,1,0,0,1,47,Brad Pearce
1994,101360,2186.5,1,0,0,1,40,Mark Keil
1994,101444,2186.5,1,0,0,1,46,Bonit Wiryawan
1994,101485,2186.5,1,0,0,1,36,Tanakorn Srichaphan
1994,101819,2186.5,1,0,0,1,47,Frederic Vitoux
1994,101983,2186.5,1,0,0,1,45,Andrew Kratzmann
1994,102042,2186.5,1,0,0,1,44,Brandon Coupe
1994,102138,2186.5,1,0,0,1,36,Alexander Tabares
1994,102231,2186.5,1,0,0,1,16,Alex Calatrava
1994,102267,2186.5,1,0,0,1,43,Gwinyai Tongoona
1994,102316,2186.5,1,0,0,1,32,Jong Woong Yoon
1994,102444,2186.5,1,0,0,1,30,Scott Barron
1994,102654,2186.5,1,0,0,1,46,Steven Downs
1994,102903,2186.5,1,0,0,1,7,Eyal Erlich
1994,106941,2186.5,1,0,0,1,30,Eno Polo
1994,108229,2186.5,1,0,0,1,46,Sebastien Hette
1994,108297,2186.5,1,0,0,1,46,Stephane Andriolo
1994,108603,2186.5,1,0,0,1,36,Helge Koll Frafjord
1994,108751,2186.5,1,0,0,1,43,Bader Mohammed Almuqail
1994,108857,2186.5,1,0,0,1,30,Stewart Doyle
1995,100815,2186.5,1,0,0,1,33,David Pate
1995,101368,2186.5,1,0,0,1,17,Christian Miniussi
1995,101596,2186.5,1,0,0,1,36,Mohamed Ridaoui
1995,101617,2186.5,1,0,0,1,39,Dennis Schmid
1995,102076,2186.5,1,0,0,1,32,Mark Merklein
1995,102365,2186.5,1,0,0,1,45,Donny Susetyo
1995,102373,2186.5,1,0,0,1,33,Toshiaki Sakai
1995,102528,2186.5,1,0,0,1,35,Carlos Drada
1995,108820,2186.5,1,0,0,1,30,Ganiyu Adenekan
1995,108871,2186.5,1,0,0,1,43,Kim Huat Khoo
1996,100944,2186.5,1,0,0,1,32,Mikael Pernfors
1996,101354,2186.5,1,0,0,1,34,Andrew Sznajder
1996,101436,2186.5,1,0,0,1,34,George Cosac
1996,101575,2186.5,1,0,0,1,46,Sulistyo Wibowo
1996,101844,2186.5,1,0,0,1,45,Heath Denman
1996,101920,2186.5,1,0,0,1,45,Jamie Morgan
1996,101931,2186.5,1,0,0,1,18,Marcus Hilpert
1996,102180,2186.5,1,0,0,1,9,Charles Auffray
1996,102600,2186.5,1,0,0,1,30,David Miketa
1996,102742,2186.5,1,0,0,1,28,Armand Strombach
1996,102785,2186.5,1,0,0,1,14,Glenn Weiner
1996,102956,2186.5,1,0,0,1,47,Sultan Khalfan
1996,102969,2186.5,1,0,0,1,34,Sergei Yaroshenko
1996,103005,2186.5,1,0,0,1,10,Denis Yakimenko
1996,103166,2186.5,3,1,0,2,19,Vladimir Voltchkov
1996,108669,2186.5,1,0,0,1,29,Mohammed Mahmoudi
1996,108670,2186.5,1,0,0,1,19,Noujeim Hakimi
1996,108671,2186.5,1,0,0,1,19,Sofiane Rais Ali
1996,108708,2186.5,1,0,0,1,34,Duane Williams
1996,108798,2186.5,1,0,0,1,34,Victor Trotsko
1996,108833,2186.5,1,0,0,1,40,Farah Al Somali
1996,108837,2186.5,1,0,0,1,34,Graeme Foster
1996,108842,2186.5,1,0,0,1,40,Zulfiqar Ahmed
1996,108861,2186.5,1,0,0,1,19,Goran Popov
1997,101086,2186.5,1,0,0,1,44,Ronald Agenor
1997,101409,2186.5,1,0,0,1,44,Jaime Yzaga
1997,101485,2186.5,1,0,0,1,33,Tanakorn Srichaphan
1997,101928,2186.5,1,0,0,1,33,Jorge Cordova
1997,102273,2186.5,1,0,0,1,31,David Salvador Estepa
1997,102416,2186.5,1,0,0,1,18,Reed Cordish
1997,102529,2186.5,1,0,0,1,31,Thomas Shimada
1997,102598,2186.5,1,0,0,1,19,Nouhoun Sangare
1997,102687,2186.5,1,0,0,1,49,Herbert Wiltschnig
1997,102777,2186.5,1,0,0,1,34,Larbi Rharnit
1997,102942,2186.5,1,0,0,1,28,Vladimir Pavicevic
1997,102956,2186.5,1,0,0,1,49,Sultan Khalfan
1997,103029,2186.5,1,0,0,1,34,Mehdi Tahiri
1997,103184,2186.5,1,0,0,1,17,Bob Bryan
1997,106816,2186.5,1,0,0,1,28,Daniel Omaboe
1997,107870,2186.5,1,0,0,1,28,Nortay Dowuona
1997,108599,2186.5,1,0,0,1,28,Ivo Lagzdins
1997,108753,2186.5,1,0,0,1,40,Othman Al Anazi
1997,108791,2186.5,1,0,0,1,28,Oskars Vaskis
1997,108796,2186.5,3,1,0,2,33,Rafael Jordan
1997,108822,2186.5,1,0,0,1,28,Andrej Krasevec
1997,108829,2186.5,1,0,0,1,28,Alexander Ofori
1997,108884,2186.5,1,0,0,1,33,Yuan Xiong Hui
1997,108888,2186.5,1,0,0,1,39,Ee Wei Tan
1998,101167,2186.5,1,0,0,1,18,Jaime Cortes
1998,101203,2186.5,1,0,0,1,27,Adrian Graimprey
1998,101263,2186.5,1,0,0,1,40,Luke Jensen
1998,101650,2186.5,1,0,0,1,18,Shane Barr
1998,102018,2186.5,1,0,0,1,18,Tamer El Sawy
1998,102019,2186.5,1,0,0,1,46,Dirk Dier
1998,102502,2186.5,1,0,0,1,17,Paul Harsanyi
1998,102578,2186.5,1,0,0,1,43,Fredrik Bergh
1998,102756,2186.5,1,0,0,1,41,Eduardo Rincon
1998,102769,2186.5,1,0,0,1,16,Andres Schneiter
1998,102819,2186.5,1,0,0,1,34,Ricardo Omana
1998,102922,2186.5,1,0,0,1,16,Tomas Catar
1998,103005,2186.5,1,0,0,1,41,Denis Yakimenko
1998,103101,2186.5,1,0,0,1,27,Daouda Ndiaye
1998,103102,2186.5,1,0,0,1,18,John Hui
1998,103215,2186.5,1,0,0,1,9,Andre Lopes
1998,103821,2186.5,1,0,0,1,9,Danai Udomchoke
1998,107382,2186.5,1,0,0,1,41,John Farrington
1998,108593,2186.5,1,0,0,1,32,Wing Luen Wong
1998,108651,2186.5,1,0,0,1,18,Sandor Martinez Breijo
1998,108661,2186.5,1,0,0,1,18,Dentry Mortimer
1998,108663,2186.5,1,0,0,1,41,Bjorn Munroe
1998,108731,2186.5,1,0,0,1,27,Roland Theisen
1998,108801,2186.5,1,0,0,1,18,Jorge Catala
1998,108840,2186.5,1,0,0,1,18,Alex Zakharia
1998,108880,2186.5,1,0,0,1,34,Sanjeev Tikaram
1999,100997,2186.5,1,0,0,1,42,Roger Smith
1999,101677,2186.5,1,0,0,1,28,Zoran Sevcenko
1999,102490,2186.5,1,0,0,1,28,Pantelis Moschoutis
1999,102668,2186.5,1,0,0,1,34,Tapio Nurminen
1999,102883,2186.5,1,0,0,1,20,Tom Spinks
1999,103053,2186.5,1,0,0,1,28,Nikos Rovas
1999,103109,2186.5,1,0,0,1,35,Talal Ouahabi
1999,103118,2186.5,1,0,0,1,34,Ion Moldovan
1999,103529,2186.5,3,1,0,2,9,Aisam Ul Haq Qureshi
1999,103642,2186.5,1,0,0,1,34,Shan Jiang
1999,103705,2186.5,1,0,0,1,34,Sergei Samoseiko
1999,103715,2186.5,1,0,0,1,21,Kirill Ivanov Smolensky
1999,107382,2186.5,1,0,0,1,42,John Farrington
1999,108632,2186.5,1,0,0,1,18,Federico Camacho
1999,108689,2186.5,1,0,0,1,28,Goran Bosalevski
1999,108756,2186.5,1,0,0,1,28,Goudjo Gbedey
1999,108792,2186.5,1,0,0,1,28,Ognen Nikolovski
1999,108802,2186.5,1,0,0,1,34,David Cardoza
1999,108807,2186.5,1,0,0,1,42,Juan Francisco Barragan
1999,108830,2186.5,1,0,0,1,18,Philippe Lacombe
1999,108841,2186.5,1,0,0,1,42,Mubarak Al Tobaishi
1999,108849,2186.5,1,0,0,1,42,Rohan De Silva
1999,108851,2186.5,1,0,0,1,42,Iman Nilipour
1999,108863,2186.5,1,0,0,1,28,Alvis Tabors
1999,108887,2186.5,1,0,0,1,18,Wael Zeidan
2000,101439,2186.5,1,0,0,1,51,Javier Sanchez
2000,101833,2186.5,1,0,0,1,51,Michael Tebbutt
2000,102536,2186.5,1,0,0,1,37,James Greenhalgh
2000,102785,2186.5,1,0,0,1,50,Glenn Weiner
2000,102956,2186.5,1,0,0,1,51,Sultan Khalfan
2000,103174,2186.5,1,0,0,1,49,Noam Okun
2000,103187,2186.5,1,0,0,1,20,Hisham Hemeda
2000,103342,2186.5,1,0,0,1,33,Miha Gregorc
2000,103377,2186.5,1,0,0,1,37,Seung Hoon Lee
2000,103385,2186.5,1,0,0,1,51,Paul Baccanello
2000,103483,2186.5,1,0,0,1,47,James Shortall
2000,103719,2186.5,1,0,0,1,47,Ruben Torres
2000,103851,2186.5,1,0,0,1,22,Conor Niland
2000,103899,2186.5,1,0,0,1,20,Stian Boretti
2000,103936,2186.5,1,0,0,1,20,Todor Enev
2000,104156,2186.5,1,0,0,1,51,Sunil Kumar
2000,104348,2186.5,1,0,0,1,47,Dias Doskarayev
2000,108584,2186.5,1,0,0,1,37,Alexander Vasquez
2000,108586,2186.5,1,0,0,1,37,Augusto Sanabria
2000,108590,2186.5,1,0,0,1,37,Mohammed Nazreen Fuzi Nasruddin
2000,108595,2186.5,1,0,0,1,40,Mohammed Reza Tavakoli
2000,108600,2186.5,1,0,0,1,33,Sean Cooper
2000,108602,2186.5,1,0,0,1,33,Alti Vahkal
2000,108661,2186.5,1,0,0,1,47,Dentry Mortimer
2000,108799,2186.5,1,0,0,1,47,Jorge Tejada
2000,108812,2186.5,1,0,0,1,47,Jose Baires
2001,102310,2186.5,1,0,0,1,40,Seung Bok Baek
2001,102395,2186.5,1,0,0,1,33,Ville Liukko
2001,102552,2186.5,1,0,0,1,29,Baris Ergun
2001,102554,2186.5,1,0,0,1,42,Diego Moyano
2001,102595,2186.5,1,0,0,1,39,Helge Koll
2001,102805,2186.5,1,0,0,1,43,Matthew Breen
2001,102875,2186.5,1,0,0,1,45,Luke Smith
2001,102918,2186.5,1,0,0,1,29,Efe Ustundag
2001,102956,2186.5,1,0,0,1,45,Sultan Khalfan
2001,103145,2186.5,1,0,0,1,29,Amir Hadad
2001,103216,2186.5,1,0,0,1,33,Clemens Trimmel
2001,103280,2186.5,1,0,0,1,19,Martin Verkerk
2001,103491,2186.5,1,0,0,1,29,Mads Gottlieb
2001,103649,2186.5,1,0,0,1,29,Esat Tanik
2001,103829,2186.5,1,0,0,1,40,Cristian Paiz
2001,103998,2186.5,1,0,0,1,40,Mario Monroy
2001,104027,2186.5,1,0,0,1,40,Pablo Gonzalez
2001,108606,2186.5,1,0,0,1,18,Gert Vilms
2001,108609,2186.5,1,0,0,1,40,Patrick Boza
2001,108610,2186.5,3,1,0,2,18,Tsolak Gevorgyan
2001,108611,2186.5,1,0,0,1,29,Victor Ribas
2001,108613,2186.5,1,0,0,1,29,Davit Babayan
2001,108615,2186.5,3,1,0,2,33,Genaro Deleon
2001,108616,2186.5,1,0,0,1,40,Walter Barahona
2001,108618,2186.5,1,0,0,1,40,Karim Alayli
2001,108620,2186.5,1,0,0,1,40,Adel Al Shatti
2001,108621,2186.5,1,0,0,1,40,Seyed Akbar Taheri Rahaghi
2001,108622,2186.5,3,1,0,2,33,Samir Saadeldin
2001,108624,2186.5,1,0,0,1,40,Hazuan Hizan
2001,108626,2186.5,1,0,0,1,33,Antonio Van Grichen
2001,108627,2186.5,1,0,0,1,33,Kevin Jonckheer
2001,108629,2186.5,1,0,0,1,33,Rodrigo Gabriel
2001,108630,2186.5,1,0,0,1,33,Jamal Darmadi
2001,108636,2186.5,1,0,0,1,33,Lays Salim
2001,108638,2186.5,1,0,0,1,33,Yazan Al Kasim
2002,101638,2186.5,1,0,0,1,8,Sean Karam
2002,101947,2186.5,1,0,0,1,30,Vincenzo Santopadre
2002,102097,2186.5,1,0,0,1,38,Naratorn Srichaphan
2002,102285,2186.5,1,0,0,1,42,Nasser Ghanim Al Khulaifi
2002,102335,2186.5,1,0,0,1,31,Taso Vasiliadis
2002,102405,2186.5,1,0,0,1,42,Mahesh Bhupathi
2002,102406,2186.5,1,0,0,1,42,Thomas Dupre
2002,103045,2186.5,1,0,0,1,14,Reginald Willems
2002,103193,2186.5,1,0,0,1,42,Peter Wessels
2002,103228,2186.5,1,0,0,1,37,Marcos Daniel
2002,103229,2186.5,1,0,0,1,26,Kornel Bardoczky
2002,103427,2186.5,3,1,0,2,31,Yew Ming Si
2002,103693,2186.5,1,0,0,1,37,Thierry Ascione
2002,103704,2186.5,1,0,0,1,26,Vladimir Obradovic
2002,103754,2186.5,1,0,0,1,14,Mark Hilton
2002,103825,2186.5,1,0,0,1,26,Zsolt Tatar
2002,103917,2186.5,1,0,0,1,37,Nicolas Mahut
2002,104014,2186.5,1,0,0,1,14,Lee Childs
2002,104046,2186.5,1,0,0,1,26,Bostjan Osabnik
2002,104136,2186.5,1,0,0,1,38,Santiago Gonzalez
2002,104162,2186.5,1,0,0,1,17,Deniss Pavlovs
2002,104463,2186.5,1,0,0,1,38,Dmitriy Makeyev
2002,104618,2186.5,1,0,0,1,17,Devin Mullings
2002,108582,2186.5,1,0,0,1,31,Luis Perez Chete
2002,108588,2186.5,3,1,0,2,31,Asim Shafik
2002,108604,2186.5,1,0,0,1,26,Pascal Schaul
2002,108617,2186.5,1,0,0,1,38,Hussain Al Ashwak
2002,108629,2186.5,1,0,0,1,38,Rodrigo Gabriel
2002,108642,2186.5,1,0,0,1,26,Hayk Hakobyan
2002,108643,2186.5,1,0,0,1,26,Samuel Fumi
2002,108649,2186.5,1,0,0,1,38,Chris Numbers
2002,108650,2186.5,1,0,0,1,38,Peit Hein Boekel
2002,108654,2186.5,1,0,0,1,38,Tyler Mayers
2002,108659,2186.5,1,0,0,1,31,Dannio Yahya
2002,108661,2186.5,1,0,0,1,17,Dentry Mortimer
2002,108663,2186.5,1,0,0,1,17,Bjorn Munroe
2003,101956,2186.5,1,0,0,1,39,Mark Knowles
2003,101979,2186.5,1,0,0,1,31,Ricardo Mena
2003,102077,2186.5,1,0,0,1,39,Alexander Shvec
2003,102223,2186.5,1,0,0,1,43,Karim Alami
2003,102362,2186.5,1,0,0,1,31,Amro Ghoneim
2003,102652,2186.5,1,0,0,1,38,Christian Vinck
2003,102956,2186.5,1,0,0,1,43,Sultan Khalfan
2003,102983,2186.5,1,0,0,1,18,Henrik Andersson
2003,103037,2186.5,1,0,0,1,14,Andrew Carlson
2003,103503,2186.5,1,0,0,1,15,Robin Vik
2003,103568,2186.5,3,1,0,2,17,Valentin Sanon
2003,103621,2186.5,1,0,0,1,15,Igor Levine
2003,103666,2186.5,1,0,0,1,17,Ilia Kushev
2003,103736,2186.5,1,0,0,1,31,Diego Acuna
2003,103936,2186.5,1,0,0,1,17,Todor Enev
2003,104000,2186.5,1,0,0,1,31,Andrey Dernovskiy
2003,104008,2186.5,1,0,0,1,31,Carlos Avellan
2003,104036,2186.5,1,0,0,1,42,Simon Rea
2003,104261,2186.5,1,0,0,1,31,Peng Sun
2003,104270,2186.5,1,0,0,1,39,Marvin Rolle
2003,104348,2186.5,1,0,0,1,39,Dias Doskarayev
2003,104469,2186.5,1,0,0,1,8,Erling Tveit
2003,107310,2186.5,1,0,0,1,31,Jean Nabi
2003,108588,2186.5,1,0,0,1,39,Asim Shafik
2003,108614,2186.5,1,0,0,1,31,Raoul Behr
2003,108618,2186.5,1,0,0,1,20,Karim Alayli
2003,108621,2186.5,1,0,0,1,39,Seyed Akbar Taheri Rahaghi
2003,108627,2186.5,1,0,0,1,39,Kevin Jonckheer
2003,108637,2186.5,1,0,0,1,39,Nomi Qamar
2003,108641,2186.5,1,0,0,1,39,Fredrik Aarum
2003,108650,2186.5,1,0,0,1,39,Peit Hein Boekel
2003,108663,2186.5,1,0,0,1,39,Bjorn Munroe
2003,108673,2186.5,1,0,0,1,39,Leroy Tujeehut
2003,108676,2186.5,1,0,0,1,39,Joel Allen
2003,108680,2186.5,3,1,0,2,31,Sergey Makashin
2003,108681,2186.5,1,0,0,1,31,Andrey Stepanov
2003,108682,2186.5,1,0,0,1,31,Stephen Nugent
2003,108890,2186.5,1,0,0,1,31,Juan Carlos Rebaza Lozano
2003,108892,2186.5,1,0,0,1,17,Nejc Podkrajsek
2003,108895,2186.5,1,0,0,1,17,Mohammed Fawzy
2003,108900,2186.5,1,0,0,1,17,Thomas Haug
2003,108902,2186.5,1,0,0,1,17,Gwinyai Chingoka
2003,108906,2186.5,1,0,0,1,31,Aziz Avganov
2004,101895,2186.5,3,1,0,2,31,Michael Brown B395
2004,101938,2186.5,1,0,0,1,31,Bernardo Mota
2004,101996,2186.5,1,0,0,1,18,David Mullins
2004,102033,2186.5,1,0,0,1,18,Abdelhak Hameurlaine
2004,102061,2186.5,1,0,0,1,38,Kevin Ullyett
2004,102100,2186.5,1,0,0,1,31,Bartlomiej Dabrowski
2004,102362,2186.5,1,0,0,1,31,Amro Ghoneim
2004,102464,2186.5,1,0,0,1,39,Todd Larkham
2004,102567,2186.5,1,0,0,1,22,George Bastl
2004,102826,2186.5,1,0,0,1,31,Muhammad Khaliq Siddiq
2004,102956,2186.5,1,0,0,1,41,Sultan Khalfan
2004,102969,2186.5,3,1,0,2,18,Sergei Yaroshenko
2004,103046,2186.5,1,0,0,1,38,Janne Ojala
2004,103082,2186.5,1,0,0,1,41,Markus Hantschk
2004,103228,2186.5,1,0,0,1,31,Marcos Daniel
2004,103286,2186.5,1,0,0,1,18,Yohny Romero
2004,103690,2186.5,1,0,0,1,18,Marcin Matkowski
2004,103726,2186.5,1,0,0,1,30,Jean Christophe Faurel
2004,103736,2186.5,1,0,0,1,38,Diego Acuna
2004,104051,2186.5,1,0,0,1,31,Andrej Kracman
2004,104305,2186.5,1,0,0,1,31,Luka Gregorc
2004,104325,2186.5,1,0,0,1,17,Johannes Ager
2004,104469,2186.5,1,0,0,1,31,Erling Tveit
2004,104496,2186.5,1,0,0,1,38,Luis Manuel Flores
2004,104680,2186.5,1,0,0,1,18,Bruno Rosa
2004,104700,2186.5,1,0,0,1,38,Daniel Vallverdu
2004,104816,2186.5,1,0,0,1,41,Karan Rastogi
2004,104826,2186.5,3,1,0,2,31,Federico Sansonetti
2004,105273,2186.5,1,0,0,1,8,Mauricio Echazu
2004,105367,2186.5,1,0,0,1,31,Daniel Alejandro Lopez Cassaccia
2004,108588,2186.5,1,0,0,1,31,Asim Shafik
2004,108628,2186.5,1,0,0,1,18,Jhonnatan Medina Alvarez
2004,108651,2186.5,1,0,0,1,38,Sandor Martinez Breijo
2004,108660,2186.5,1,0,0,1,38,Fadi Youssef
2004,108896,2186.5,1,0,0,1,31,Shahzad Khan
2004,108907,2186.5,1,0,0,1,38,Piero Demichelli
2004,108912,2186.5,1,0,0,1,31,Janis Skroderis
2004,108913,2186.5,1,0,0,1,31,Frederick Sundsten
2004,108914,2186.5,1,0,0,1,18,Rachid Baba Aissa
2004,108918,2186.5,1,0,0,1,38,Favel Antonio Freyre Perdomo
2004,108923,2186.5,1,0,0,1,38,Wahib Maknieh
2004,108927,2186.5,1,0,0,1,31,Edgar Hernandez Perez
2005,101855,2186.5,1,0,0,1,34,Emmanuel Heussner
2005,102382,2186.5,1,0,0,1,41,Julian Knowle
2005,102496,2186.5,1,0,0,1,34,Scott Willinsky
2005,102812,2186.5,1,0,0,1,34,Jicham Zaatini
2005,103230,2186.5,1,0,0,1,6,Tasuku Iwami
2005,103395,2186.5,1,0,0,1,36,Julio Silva
2005,103607,2186.5,3,1,0,2,17,Victor Estrella
2005,103963,2186.5,1,0,0,1,34,Filip Urban
2005,104001,2186.5,1,0,0,1,18,Brian Wilson
2005,104010,2186.5,1,0,0,1,39,Dieter Kindlmann
2005,104378,2186.5,1,0,0,1,8,Yordan Kanev
2005,104531,2186.5,1,0,0,1,34,Sergio Ramirez
2005,104558,2186.5,1,0,0,1,41,Mohammed Abdulla
2005,104618,2186.5,3,1,0,2,17,Devin Mullings
2005,104700,2186.5,1,0,0,1,26,Daniel Vallverdu
2005,104711,2186.5,1,0,0,1,40,G Jones
2005,104775,2186.5,1,0,0,1,34,Adam Kellner
2005,104816,2186.5,1,0,0,1,41,Karan Rastogi
2005,104926,2186.5,1,0,0,1,7,Fabio Fognini
2005,108602,2186.5,1,0,0,1,34,Alti Vahkal
2005,108651,2186.5,1,0,0,1,34,Sandor Martinez Breijo
2005,108925,2186.5,1,0,0,1,34,Ahmad Rabeea Muhammad
2005,108926,2186.5,1,0,0,1,34,David Kvernadze
2005,108934,2186.5,1,0,0,1,34,Thomas Drouet
2005,108935,2186.5,1,0,0,1,34,Marius Tangen
2005,108936,2186.5,1,0,0,1,34,Oskar Saarne
2005,108937,2186.5,1,0,0,1,17,Mikk Irdoja
2005,108938,2186.5,1,0,0,1,17,Charles Irie
2005,108939,2186.5,1,0,0,1,34,Rasid Winklaar
2005,108943,2186.5,1,0,0,1,17,Augusto Ricciardi Castelli
2005,108944,2186.5,1,0,0,1,34,Stanislav Bykov
2005,108946,2186.5,1,0,0,1,34,Brett Baudinet
2006,102571,2186.5,1,0,0,1,40,Gregory Carraz
2006,102655,2186.5,1,0,0,1,36,Jimy Szymanski
2006,102856,2186.5,1,0,0,1,34,Gustavo Kuerten
2006,102864,2186.5,1,0,0,1,7,Frank Moser
2006,102881,2186.5,1,0,0,1,27,David Skoch
2006,102885,2186.5,1,0,0,1,40,Vishal Uppal
2006,102956,2186.5,1,0,0,1,40,Sultan Khalfan
2006,103053,2186.5,1,0,0,1,30,Nikos Rovas
2006,103520,2186.5,1,0,0,1,38,Pavel Snobel
2006,103643,2186.5,1,0,0,1,16,Lauri Kiiski
2006,103739,2186.5,1,0,0,1,36,Jose De Armas
2006,103782,2186.5,1,0,0,1,40,Rameez Junaid
2006,103893,2186.5,1,0,0,1,40,Paolo Lorenzi
2006,103949,2186.5,1,0,0,1,36,Ivan Cerovic
2006,103956,2186.5,1,0,0,1,30,Stefan Wauters
2006,104208,2186.5,1,0,0,1,15,Damian Patriarca
2006,104299,2186.5,3,1,0,2,30,Hiu Tung Yu
2006,104503,2186.5,1,0,0,1,37,Guillermo Hormazabal
2006,104582,2186.5,1,0,0,1,30,Rok Jarc
2006,104888,2186.5,1,0,0,1,16,Martin Rmus
2006,105014,2186.5,1,0,0,1,34,Antal Van Der Duim
2006,105098,2186.5,1,0,0,1,35,Alexandre Sidorenko
2006,108660,2186.5,1,0,0,1,36,Fadi Youssef
2006,108914,2186.5,1,0,0,1,30,Rachid Baba Aissa
2006,108923,2186.5,1,0,0,1,36,Wahib Maknieh
2006,108930,2186.5,1,0,0,1,36,Juan Carlos Ramirez
2006,108946,2186.5,1,0,0,1,36,Brett Baudinet
2006,108951,2186.5,1,0,0,1,16,Leonardo Ramirez
2006,108954,2186.5,1,0,0,1,36,Carlos Alvarez
2006,108958,2186.5,1,0,0,1,30,Damion Johnson
2006,108959,2186.5,1,0,0,1,30,Eldad Campbell
2006,108961,2186.5,1,0,0,1,36,Abd Hazli Bin Zainuddin
2006,108962,2186.5,1,0,0,1,36,Razlan Rawi
2006,108963,2186.5,1,0,0,1,36,Mohammed Faizal Bin Othman
2006,108967,2186.5,1,0,0,1,30,Vitaliy Pavlov
2006,108968,2186.5,1,0,0,1,30,Jason Sankey
2006,108971,2186.5,1,0,0,1,30,Georgio Bedran
2007,102033,2186.5,1,0,0,1,35,Abdelhak Hameurlaine
2007,102881,2186.5,1,0,0,1,46,David Skoch
2007,102956,2186.5,1,0,0,1,46,Sultan Khalfan
2007,103385,2186.5,1,0,0,1,46,Paul Baccanello
2007,103872,2186.5,1,0,0,1,35,Dimitar Grabuloski
2007,103994,2186.5,1,0,0,1,35,Philip Riise Hansen
2007,104011,2186.5,1,0,0,1,19,Lefteris Alexiou
2007,104113,2186.5,1,0,0,1,41,Carlos Salamanca
2007,104586,2186.5,1,0,0,1,45,Lukas Rosol
2007,104613,2186.5,1,0,0,1,19,Candy Idoko
2007,104676,2186.5,1,0,0,1,30,Andreas Beck
2007,104684,2186.5,1,0,0,1,8,Navdeep Singh
2007,104724,2186.5,1,0,0,1,40,Eduardo Schwank
2007,104868,2186.5,1,0,0,1,34,James Ward
2007,104952,2186.5,1,0,0,1,35,Martin Pedersen
2007,104996,2186.5,1,0,0,1,41,Alexander Blom
2007,105145,2186.5,1,0,0,1,19,Jaak Poldma
2007,105231,2186.5,1,0,0,1,18,Luka Belic
2007,105464,2186.5,1,0,0,1,41,Christopher Rungkat
2007,108684,2186.5,1,0,0,1,35,Mehdi Bouabbane
2007,108946,2186.5,1,0,0,1,41,Brett Baudinet
2007,108981,2186.5,1,0,0,1,35,Luis Javier Cuellar Contreras
2007,108982,2186.5,1,0,0,1,41,Yasir Khan
2007,108983,2186.5,1,0,0,1,41,Ali Ismaeel
2007,108984,2186.5,1,0,0,1,41,Henry So
2007,108986,2186.5,1,0,0,1,35,Gilbert Wong
2007,108987,2186.5,1,0,0,1,35,Rihards Emulins
2007,108988,2186.5,1,0,0,1,35,Mohamed Redha Ouahab
2008,101779,2186.5,1,0,0,1,38,Pavel Vizner
2008,102233,2186.5,1,0,0,1,31,Leander Paes
2008,103080,2186.5,1,0,0,1,38,Paul Hanley
2008,103201,2186.5,1,0,0,1,39,Adrian Garcia
2008,103739,2186.5,1,0,0,1,38,Jose De Armas
2008,103822,2186.5,1,0,0,1,23,Scott Lipsky
2008,103864,2186.5,1,0,0,1,17,Mohamed Mamoun
2008,104136,2186.5,1,0,0,1,38,Santiago Gonzalez
2008,104188,2186.5,1,0,0,1,38,Diego Camacho
2008,104270,2186.5,1,0,0,1,31,Marvin Rolle
2008,104711,2186.5,1,0,0,1,41,G Jones
2008,104831,2186.5,1,0,0,1,42,Bartolome Salva Vidal
2008,104942,2186.5,1,0,0,1,31,Roman Recarte
2008,104986,2186.5,1,0,0,1,42,Vishnu Vardhan
2008,104996,2186.5,3,1,0,2,31,Alexander Blom
2008,105003,2186.5,1,0,0,1,31,Wan Gao
2008,105098,2186.5,1,0,0,1,28,Alexandre Sidorenko
2008,105111,2186.5,3,1,0,2,8,Ivan Endara
2008,105131,2186.5,1,0,0,1,19,Tim Goransson
2008,105194,2186.5,1,0,0,1,40,Nick Lindahl
2008,105577,2186.5,1,0,0,1,38,Vasek Pospisil
2008,105662,2186.5,1,0,0,1,38,Tomislav Jotovski
2008,108687,2186.5,1,0,0,1,38,Rami Osman
2008,108689,2186.5,1,0,0,1,38,Goran Bosalevski
2008,108694,2186.5,1,0,0,1,38,Jason Engelhardt
2008,108697,2186.5,1,0,0,1,31,Mahmoud Ezz
2008,108698,2186.5,1,0,0,1,31,Slah Mbarek
2008,108700,2186.5,1,0,0,1,31,Revaz Osadze
2008,108705,2186.5,1,0,0,1,17,Anis Ghorbel
2008,108983,2186.5,1,0,0,1,31,Ali Ismaeel
2008,108985,2186.5,1,0,0,1,38,Ali Ghareeb
2008,108993,2186.5,1,0,0,1,42,Abdulla Hajji
2008,108996,2186.5,1,0,0,1,34,Mahmoud Nader Al Baloushi
2009,102254,2186.5,1,0,0,1,38,Ouassel Hared
2009,102630,2186.5,1,0,0,1,38,Slimane Saoudi
2009,102826,2186.5,1,0,0,1,38,Muhammad Khaliq Siddiq
2009,103789,2186.5,1,0,0,1,38,Irakli Labadze
2009,104081,2186.5,1,0,0,1,43,Boris Pashanski
2009,104402,2186.5,1,0,0,1,21,Clement Morel
2009,104456,2186.5,1,0,0,1,44,Colin Ebelthite
2009,104603,2186.5,1,0,0,1,38,Andrei Ciumac
2009,104945,2186.5,1,0,0,1,38,James Mcgee
2009,105066,2186.5,1,0,0,1,38,Grzegorz Panfil
2009,105334,2186.5,1,0,0,1,38,Luis David Martinez
2009,105633,2186.5,1,0,0,1,38,Mohamed Safwat
2009,105842,2186.5,1,0,0,1,38,Di Wu
2009,106201,2186.5,1,0,0,1,38,Maxim Dubarenco
2009,108591,2186.5,1,0,0,1,38,Adam Jaya
2009,108628,2186.5,1,0,0,1,21,Jhonnatan Medina Alvarez
2009,108697,2186.5,1,0,0,1,38,Mahmoud Ezz
2009,108706,2186.5,1,0,0,1,21,Sulaiman Al Rawahi
2009,108709,2186.5,1,0,0,1,38,Dario Acosta
2009,108714,2186.5,1,0,0,1,38,Christian Saravia
2009,108716,2186.5,1,0,0,1,21,Amaury Gomez
2009,108719,2186.5,1,0,0,1,38,Nemanja Kontic
2009,108721,2186.5,1,0,0,1,38,Philippos Tsangaridis
2009,108723,2186.5,1,0,0,1,21,Alexander Tavkhelidze
2009,108727,2186.5,1,0,0,1,21,Tyler Chin
2009,108960,2186.5,1,0,0,1,38,Michael Lai
2009,108961,2186.5,1,0,0,1,38,Abd Hazli Bin Zainuddin
2009,108978,2186.5,1,0,0,1,38,Nick Van Rosberg
2009,108982,2186.5,1,0,0,1,38,Yasir Khan
2009,108993,2186.5,1,0,0,1,46,Abdulla Hajji
2010,102830,2186.5,1,0,0,1,40,Paulo Carvallo
2010,103229,2186.5,1,0,0,1,40,Kornel Bardoczky
2010,103668,2186.5,1,0,0,1,40,Lazar Magdincev
2010,103760,2186.5,1,0,0,1,40,Haluk Akkoyun
2010,104234,2186.5,3,1,0,2,22,Predrag Rusevski
2010,104250,2186.5,1,0,0,1,47,Prakash Amritraj
2010,104253,2186.5,1,0,0,1,44,Juan Martin Aranguren
2010,104654,2186.5,1,0,0,1,40,Baris Erguden
2010,104658,2186.5,1,0,0,1,22,Gustavo Ramirez
2010,104901,2186.5,3,1,0,2,22,Vladimir Ivanov
2010,105145,2186.5,1,0,0,1,40,Jaak Poldma
2010,105161,2186.5,1,0,0,1,19,Yann Marti
2010,105269,2186.5,1,0,0,1,34,Marcelo Demoliner
2010,105305,2186.5,1,0,0,1,22,Valentin Dimov
2010,105357,2186.5,1,0,0,1,48,John Millman
2010,105438,2186.5,1,0,0,1,46,Inigo Cervantes Huegun
2010,105662,2186.5,1,0,0,1,22,Tomislav Jotovski
2010,105717,2186.5,1,0,0,1,40,Tzvetan Mihov
2010,105831,2186.5,1,0,0,1,31,Marko Djokovic
2010,105916,2186.5,1,0,0,1,40,Marton Fucsovics
2010,106081,2186.5,1,0,0,1,34,Thomas Jun Facchini Takemoto
2010,106123,2186.5,1,0,0,1,34,Tiago Fernandes
2010,106186,2186.5,1,0,0,1,45,Jason Kubler
2010,108703,2186.5,1,0,0,1,22,Eleftherios Christou
2010,108717,2186.5,1,0,0,1,40,Francis Casey Alcantara
2010,108728,2186.5,1,0,0,1,40,Cheuk Wai Hui
2010,108737,2186.5,1,0,0,1,40,Marco Antonio Rojas
2010,108738,2186.5,1,0,0,1,40,Claudio Dias Conduto
2010,108739,2186.5,1,0,0,1,40,Wilfredo Gonzalez
2010,108741,2186.5,1,0,0,1,40,Mohd Assri Merzuki
2010,108745,2186.5,1,0,0,1,22,Gino Meeuwsen
2010,108750,2186.5,1,0,0,1,22,Adrian Forberg Skogeng
2010,108956,2186.5,1,0,0,1,40,Jesus Francisco Felix
2010,108974,2186.5,1,0,0,1,40,Christopher Koutrouzas
2010,108982,2186.5,1,0,0,1,40,Yasir Khan
2010,108986,2186.5,1,0,0,1,22,Gilbert Wong
2010,108993,2186.5,1,0,0,1,47,Abdulla Hajji
2011,102999,2186.5,1,0,0,1,42,Stefano Galvani
2011,103531,2186.5,1,0,0,1,38,Thomas Oger
2011,103714,2186.5,1,0,0,1,20,Andreas Vinciguerra
2011,103936,2186.5,1,0,0,1,38,Todor Enev
2011,104217,2186.5,1,0,0,1,43,Simon Stadler
2011,104454,2186.5,1,0,0,1,38,Murad Inoyatov
2011,104550,2186.5,1,0,0,1,42,Ricardo Hocevar
2011,104789,2186.5,1,0,0,1,45,Sherif Sabry
2011,104909,2186.5,1,0,0,1,38,Sunu Wahyu Trijati
2011,105028,2186.5,1,0,0,1,41,Jesse Levine
2011,105094,2186.5,1,0,0,1,38,Paris Gemouchidis
2011,105177,2186.5,1,0,0,1,38,Aditya Hari Sasongko
2011,105300,2186.5,1,0,0,1,35,Sergio Gutierrez Ferrol
2011,105334,2186.5,1,0,0,1,38,Luis David Martinez
2011,105357,2186.5,1,0,0,1,46,John Millman
2011,105408,2186.5,1,0,0,1,38,Soren Wedege
2011,105431,2186.5,1,0,0,1,21,Ariel Behar
2011,105493,2186.5,1,0,0,1,21,Tomislav Brkic
2011,105521,2186.5,1,0,0,1,12,Juan Sebastian Vivanco
2011,105606,2186.5,1,0,0,1,38,Mohsen Hossein Zade
2011,106026,2186.5,1,0,0,1,45,Yuki Bhambri
2011,106158,2186.5,1,0,0,1,38,Suk Young Jeong
2011,106243,2186.5,1,0,0,1,18,Mate Delic
2011,108735,2186.5,1,0,0,1,38,Rares Cuzdriorean
2011,108749,2186.5,1,0,0,1,38,Sergis Kyratzis
2011,108760,2186.5,1,0,0,1,38,Slim Hamza
2011,108761,2186.5,1,0,0,1,38,Mikelis Libietis
2011,108762,2186.5,1,0,0,1,38,Andres Weisskopf
2011,108763,2186.5,1,0,0,1,38,Alberto Emmanuel Alvarado Larin
2011,108766,2186.5,1,0,0,1,38,Samir Iftikhar
2011,108771,2186.5,1,0,0,1,21,Romain Radwan
2011,108772,2186.5,1,0,0,1,21,Julius Tverijonas
2011,108773,2186.5,1,0,0,1,21,Julius Gotovskis
2011,108774,2186.5,1,0,0,1,5,Marco Aurelio Nunez
2011,108916,2186.5,1,0,0,1,38,Ricardo Gonzalez Diaz
2011,108978,2186.5,1,0,0,1,38,Nick Van Rosberg
2011,108982,2186.5,1,0,0,1,21,Yasir Khan
2012,102886,2186.5,1,0,0,1,42,Frantisek Cermak
2012,103454,2186.5,1,0,0,1,43,Nicolas Massu
2012,103544,2186.5,1,0,0,1,35,Andy Ram
2012,103690,2186.5,1,0,0,1,11,Marcin Matkowski
2012,103877,2186.5,1,0,0,1,42,Mike Scheidweiler
2012,103969,2186.5,1,0,0,1,42,Roman Borvanov
2012,104215,2186.5,1,0,0,1,42,Andrei Gorban
2012,104216,2186.5,1,0,0,1,43,Maximo Gonzalez
2012,104251,2186.5,1,0,0,1,42,Ti Chen
2012,104258,2186.5,1,0,0,1,42,Juan Enrique Crosa
2012,104454,2186.5,1,0,0,1,42,Murad Inoyatov
2012,104654,2186.5,1,0,0,1,42,Baris Erguden
2012,104702,2186.5,1,0,0,1,42,Michael Leong
2012,104934,2186.5,1,0,0,1,42,Thomas Kromann
2012,104949,2186.5,1,0,0,1,42,Weerapat Doakmaiklee
2012,104971,2186.5,1,0,0,1,40,Blake Strode
2012,105221,2186.5,1,0,0,1,35,Mauricio Doria Medina
2012,105294,2186.5,1,0,0,1,40,Dennis Lajola
2012,105357,2186.5,1,0,0,1,47,John Millman
2012,105812,2186.5,1,0,0,1,42,David Agung Susanto
2012,106077,2186.5,1,0,0,1,42,Mike Vermeer
2012,106165,2186.5,1,0,0,1,42,Diego Hidalgo
2012,106199,2186.5,1,0,0,1,35,Darius Florin Bragusi
2012,106247,2186.5,1,0,0,1,35,Nik Razborsek
2012,106325,2186.5,1,0,0,1,46,Jabor Al Mutawa
2012,106342,2186.5,1,0,0,1,42,Martins Podzus
2012,106410,2186.5,1,0,0,1,11,Jorge Brian Panta Herreros
2012,108687,2186.5,1,0,0,1,35,Rami Osman
2012,108762,2186.5,1,0,0,1,42,Andres Weisskopf
2012,108763,2186.5,1,0,0,1,35,Alberto Emmanuel Alvarado Larin
2012,108775,2186.5,1,0,0,1,42,Aymeric Mara
2012,108777,2186.5,1,0,0,1,42,Jae Min Seol
2012,108782,2186.5,1,0,0,1,35,Mahammad Abid
2012,108787,2186.5,1,0,0,1,42,Carlos Taborga
2012,108788,2186.5,1,0,0,1,42,Jose Perdomo
2012,108789,2186.5,1,0,0,1,35,Rafa Orantes
2013,103586,2186.5,1,0,0,1,41,Mariusz Fyrstenberg
2013,103657,2186.5,1,0,0,1,43,Ivo Klec
2013,103877,2186.5,1,0,0,1,41,Mike Scheidweiler
2013,104477,2186.5,1,0,0,1,39,Jorge Aguilar
2013,104893,2186.5,1,0,0,1,42,Maxime Authom
2013,105299,2186.5,1,0,0,1,41,Dzmitry Zhyrmont
2013,105493,2186.5,1,0,0,1,34,Tomislav Brkic
2013,105579,2186.5,1,0,0,1,41,Kittipong Wachiramanowong
2013,105711,2186.5,1,0,0,1,40,Dino Marcan
2013,105899,2186.5,1,0,0,1,41,Martin Cuevas
2013,105933,2186.5,1,0,0,1,11,Roberto Quiroz
2013,106246,2186.5,1,0,0,1,21,Robin Kern
2013,106325,2186.5,1,0,0,1,44,Jabor Al Mutawa
2013,106342,2186.5,1,0,0,1,11,Martins Podzus
2013,106412,2186.5,1,0,0,1,41,Lucas Gomez
2013,107552,2186.5,1,0,0,1,41,Laurent Bram
2013,108718,2186.5,1,0,0,1,41,Vicente Elberto Anasta
2013,108760,2186.5,1,0,0,1,41,Slim Hamza
2013,108762,2186.5,1,0,0,1,34,Andres Weisskopf
2013,108778,2186.5,1,0,0,1,41,Christos Hadjigeorgiou
2013,108785,2186.5,1,0,0,1,41,Anthony Marshall
2013,109698,2186.5,1,0,0,1,41,Christoffer Konigsfeldt
2013,110476,2186.5,1,0,0,1,44,Mousa Shanan Zayed
2013,111167,2186.5,3,1,0,2,34,Ugo Nastasi
2013,111751,2186.5,1,0,0,1,41,Andres Bucaro
2013,121648,2186.5,1,0,0,1,41,Tunde Segodo
2013,122260,2186.5,1,0,0,1,41,Jaan Kononov
2013,122261,2186.5,1,0,0,1,41,Marek Marksoo
2013,123814,2186.5,1,0,0,1,34,Markus Kerner
2013,123983,2186.5,1,0,0,1,41,Nerman Fatic
2013,124063,2186.5,1,0,0,1,34,Santiago Maresca
2013,125571,2186.5,3,1,0,2,34,Christian Garay
2013,125782,2186.5,1,0,0,1,34,Kasparas Zemaitelis
2014,104789,2186.5,1,0,0,1,40,Sherif Sabry
2014,104839,2186.5,1,0,0,1,40,Yassine Idmbarek
2014,104857,2186.5,1,0,0,1,32,Robert Farah
2014,105009,2186.5,1,0,0,1,40,Elbert Sie
2014,105072,2186.5,1,0,0,1,32,Sanam Singh
2014,105233,2186.5,1,0,0,1,44,Jeevan Nedunchezhiyan
2014,105271,2186.5,1,0,0,1,40,Gonzalo Escobar
2014,105450,2186.5,1,0,0,1,40,Mike Urbanija
2014,105471,2186.5,1,0,0,1,32,Cesar Ramirez
2014,105561,2186.5,1,0,0,1,24,Alessandro Giannessi
2014,105590,2186.5,1,0,0,1,32,Uladzimir Ignatik
2014,105747,2186.5,1,0,0,1,32,Karim Mohamed Maamoun
2014,105912,2186.5,1,0,0,1,40,Diego Galeano
2014,106100,2186.5,1,0,0,1,40,Micke Kontinen
2014,108982,2186.5,1,0,0,1,37,Yasir Khan
2014,109520,2186.5,1,0,0,1,40,Herkko Pollanen
2014,109529,2186.5,1,0,0,1,37,Quang Huy Ngo
2014,110476,2186.5,1,0,0,1,44,Mousa Shanan Zayed
2014,111751,2186.5,1,0,0,1,32,Andres Bucaro
2014,117365,2186.5,3,1,0,2,32,Petros Chrysochos
2014,118591,2186.5,1,0,0,1,40,Russell Moseley
2014,134886,2186.5,1,0,0,1,32,Sharmal Dissanayake
2014,144771,2186.5,1,0,0,1,40,Sebastian Quiros
2014,144774,2186.5,1,0,0,1,40,William Kirkman
2014,144777,2186.5,1,0,0,1,32,Constantinos Ioannides
2015,104822,2186.5,1,0,0,1,44,N Vijay Sundar Prashanth
2015,105026,2186.5,1,0,0,1,9,Takuto Niki
2015,105120,2186.5,1,0,0,1,37,Andres Molteni
2015,105250,2186.5,1,0,0,1,36,Mehdi Jdi
2015,105633,2186.5,1,0,0,1,44,Mohamed Safwat
2015,105733,2186.5,1,0,0,1,45,Rhyne Williams
2015,106227,2186.5,1,0,0,1,36,Ji Sung Nam
2015,106325,2186.5,1,0,0,1,44,Jabor Al Mutawa
2015,106381,2186.5,1,0,0,1,19,Temur Ismailov
2015,106412,2186.5,1,0,0,1,19,Lucas Gomez
2015,108618,2186.5,1,0,0,1,36,Karim Alayli
2015,108747,2186.5,1,0,0,1,36,Dineshkanthan Thangarajah
2015,108748,2186.5,1,0,0,1,11,Lukas Mugevicius
2015,108763,2186.5,1,0,0,1,36,Alberto Emmanuel Alvarado Larin
2015,108768,2186.5,1,0,0,1,36,Gabriel Flores Ruiz
2015,108789,2186.5,1,0,0,1,36,Rafa Orantes
2015,111794,2186.5,1,0,0,1,36,Kamil Majchrzak
2015,118591,2186.5,1,0,0,1,4,Russell Moseley
2015,121908,2186.5,1,0,0,1,36,Naser Al Obaidly
2015,122548,2186.5,1,0,0,1,36,Edan Leshem
2015,123965,2186.5,1,0,0,1,19,Rodrigo Banzer
2015,123983,2186.5,1,0,0,1,36,Nerman Fatic
2015,126681,2186.5,1,0,0,1,36,Dawood Sayed Hashim
2015,127326,2186.5,1,0,0,1,19,Ben Fatael
2015,144854,2186.5,1,0,0,1,36,Rudolfs Mednis
2015,145022,2186.5,1,0,0,1,36,Nour Nehme
2015,200270,2186.5,1,0,0,1,19,Alex Knaff
1987,100417,2186.499604,1,0,0,1,24,Hans Gildemeister
2004,102967,2186.499362,3,1,0,2,5,Marc Gicquel
1999,101230,2186.499208,1,0,0,1,43,Andrei Chesnokov
2001,103015,2186.498731,1,0,0,1,28,Daniel Melo
2009,104234,2186.49845,1,0,0,1,38,Predrag Rusevski
1991,108136,2186.498417,1,0,0,1,49,Roberto Raffa
2001,103285,2186.498171,1,0,0,1,14,Radek Stepanek
2010,106024,2186.498024,1,0,0,1,22,Dovydas Sakinis
1992,101477,2186.497004,1,0,0,1,22,Chris Bailey
2015,105827,2186.494827,3,1,0,2,11,Laurynas Grigelis
1985,101407,2186.49444,1,0,0,1,22,David Engel
1994,101699,2186.493013,1,0,0,1,27,Alois Beust
1999,108651,2186.490889,3,1,0,2,18,Sandor Martinez Breijo
2009,104215,2186.488209,3,1,0,2,21,Andrei Gorban
2009,105430,2186.488209,3,1,0,2,21,Radu Albot
1993,108390,2186.48648,1,0,0,1,6,Thomas Prerovsky
2014,105490,2186.486184,1,0,0,1,9,Jui Chen Hung
1987,100908,2186.486031,1,0,0,1,24,Tobias Svantesson
2002,103472,2186.484947,3,1,0,2,17,Karim Maamoun
2008,104230,2186.483511,3,1,0,2,18,Daniel Koellerer
2007,104479,2186.481268,1,0,0,1,35,Sarvar Ikramov
1988,107497,2186.481211,1,0,0,1,38,Kenichi Kiyomiya
2014,104377,2186.481207,1,0,0,1,32,Theodoros Angelinos
2014,105463,2186.481207,1,0,0,1,32,Charalampos Kapogiannis
2009,103581,2186.480606,1,0,0,1,41,Flavio Saretta
2006,105497,2186.480476,1,0,0,1,8,Jose Hernandez
1993,100727,2186.479849,1,0,0,1,18,Raul Antonio Viver
2006,104488,2186.479685,1,0,0,1,15,Armin Sandbichler
1989,110822,2186.479658,3,1,0,2,28,Faisal Rahman
1995,101764,2186.479628,1,0,0,1,43,Yu Hui Lien
1999,102842,2186.479628,1,0,0,1,46,Toby Mitchell
2004,103553,2186.479628,1,0,0,1,39,Alun Jones
2008,102033,2186.479628,1,0,0,1,17,Abdelhak Hameurlaine
2014,105909,2186.479628,1,0,0,1,32,Sam Barry
2015,103188,2186.479628,1,0,0,1,41,Michael Russell
2015,105934,2186.479628,1,0,0,1,36,Chuhan Wang
2009,103829,2186.479538,1,0,0,1,21,Cristian Paiz
2009,105499,2186.479538,3,1,0,2,21,Christopher Diaz Figueroa
1995,101066,2186.478838,1,0,0,1,42,Richard Matuszewski
2010,104299,2186.478836,3,1,0,2,22,Hiu Tung Yu
1991,108147,2186.478807,1,0,0,1,12,Rodrigo Faria
2005,103964,2186.478726,1,0,0,1,20,Tobias Klein
1997,108992,2186.478625,1,0,0,1,35,Alexei Belov
1990,108043,2186.477978,1,0,0,1,17,Ralph Kok
1993,101672,2186.475364,1,0,0,1,20,Michael Geserer
2008,103763,2186.474875,3,1,0,2,6,Martin Slanar
2009,104595,2186.474115,1,0,0,1,31,Sascha Kloer
2001,102968,2186.473672,1,0,0,1,23,Jonathan Erlich
2007,104700,2186.468875,1,0,0,1,19,Daniel Vallverdu
1985,109456,2186.468693,1,0,0,1,43,Carlos Lozano
1995,101420,2186.462969,3,1,0,2,16,Vaclav Roubicek
2004,103921,2186.462687,3,1,0,2,8,Sonchat Ratiwatana
2015,104095,2186.462109,1,0,0,1,38,David Guez
1996,102332,2186.461629,1,0,0,1,44,Adolf Musil
1996,101432,2186.461027,1,0,0,1,34,Dimitri Poliakov
1992,100532,2186.460104,1,0,0,1,41,Johan Kriek
2011,106105,2186.460104,1,0,0,1,41,Guilherme Clezar
2013,106291,2186.459317,1,0,0,1,42,Luke Saville
2015,121971,2186.459317,1,0,0,1,36,Duilio Vallebuona
1989,101107,2186.459256,1,0,0,1,54,Charles Merzbacher
2004,103987,2186.459195,1,0,0,1,8,Alessandro Camarco
1988,108468,2186.458906,1,0,0,1,14,Victor Caballero
2007,103967,2186.45859,1,0,0,1,21,Michael Lammer
2012,102967,2186.458466,1,0,0,1,43,Marc Gicquel
2010,108748,2186.457224,1,0,0,1,22,Lukas Mugevicius
2010,102434,2186.456979,1,0,0,1,41,Vincent Spadea
2001,102076,2186.456034,3,1,0,2,33,Mark Merklein
1989,101074,2186.449693,1,0,0,1,33,Carlos Di Laura
2005,104438,2186.447669,1,0,0,1,34,Oscar Rodriguez Sanchez
1992,101779,2186.447658,1,0,0,1,7,Pavel Vizner
2009,104890,2186.447398,1,0,0,1,4,Andreas Haider Maurer
1997,101906,2186.447357,1,0,0,1,31,Yasufumi Yamamoto
2014,105169,2186.447137,1,0,0,1,32,Jean Andersen
2007,103229,2186.445495,3,1,0,2,19,Kornel Bardoczky
2000,102139,2186.444835,1,0,0,1,33,Eyal Ran
2009,105440,2186.443553,1,0,0,1,30,Arsenije Zlatanovic
1998,103602,2186.441943,1,0,0,1,34,Fernando Gonzalez
2010,103860,2186.440585,1,0,0,1,30,Timo Nieminen
2001,102520,2186.438835,1,0,0,1,32,Olivier Malcor
1997,102835,2186.435237,1,0,0,1,21,Luke Milligan
2000,108603,2186.432455,1,0,0,1,20,Helge Koll Frafjord
2001,102702,2186.43146,1,0,0,1,18,Relja Fiser Dulic
1997,102067,2186.430274,1,0,0,1,17,Emanuel Rasberger
1995,108602,2186.42968,3,1,0,2,20,Alti Vahkal
1996,102165,2186.429295,1,0,0,1,33,Srinath Prahlad
1997,101865,2186.426844,1,0,0,1,13,Albert Chang
2012,106281,2186.426811,1,0,0,1,25,Liam Broady
2006,104500,2186.426619,1,0,0,1,14,Somdev Devvarman
1992,110962,2186.424587,1,0,0,1,19,Midodji Segbeaya
1987,100715,2186.423628,5,2,0,3,3,Jim Gurfein
1991,101957,2186.420187,1,0,0,1,8,Milen Velev
1999,102395,2186.419459,11,5,0,6,2,Ville Liukko
2011,108594,2186.419422,1,0,0,1,38,Johnny Arcilla
2000,103564,2186.417873,1,0,0,1,13,Jakub Herm Zahlava
1989,101570,2186.415518,1,0,0,1,20,Vicente Solves
2001,102808,2186.414892,1,0,0,1,20,Kalle Flygt
2014,104813,2186.414651,1,0,0,1,32,Grega Zemlja
2010,104651,2186.412089,1,0,0,1,34,Martin Alund
2000,101821,2186.411532,1,0,0,1,18,Peter Tramacchi
2000,102615,2186.411003,3,1,0,2,21,Dennis Van Scheppingen
1994,101502,2186.407905,1,0,0,1,29,Torben Theine
2004,104681,2186.407002,1,0,0,1,19,Sebastian Rieschick
1993,101108,2186.406969,1,0,0,1,22,Richard Schmidt
2012,105111,2186.401266,1,0,0,1,42,Ivan Endara
2008,102950,2186.401006,1,0,0,1,30,Fernando Vicente
2002,103198,2186.397494,3,1,0,2,19,Justin Bower
1990,101955,2186.397196,4,1,0,3,11,Luis Herrera
2014,104589,2186.395844,1,0,0,1,20,Chris Guccione
2010,105731,2186.394094,1,0,0,1,40,Steven Diez
2006,103653,2186.392408,1,0,0,1,7,Jasper Smit
1988,101159,2186.390096,1,0,0,1,27,Gustav Fichardt
2008,104234,2186.388381,3,1,0,2,31,Predrag Rusevski
2003,108667,2186.386638,1,0,0,1,17,Kwasi Ahenkora
2005,102318,2186.384962,48,22,0,26,2,Andrei Pavel
2000,102574,2186.382024,1,0,0,1,26,Gabriel Trifu
1988,101055,2186.381586,5,2,0,3,24,Heiner Moraing
1998,102834,2186.379383,4,1,0,3,11,Paul Goldstein
2009,104372,2186.374713,3,1,0,2,23,Alex Bogdanovic
1990,101968,2186.374564,1,0,0,1,16,Ola Kristiansson
2002,102800,2186.373484,1,0,0,1,17,Nenad Zimonjic
1993,101339,2186.373297,3,1,0,2,16,Agustin Moreno
2008,104397,2186.370042,1,0,0,1,10,Laurent Recouderc
1987,100690,2186.367195,1,0,0,1,29,Marco Armellini
2012,106426,2186.366613,1,0,0,1,11,Christian Garin
2014,110536,2186.365271,1,0,0,1,17,Kevin King
1999,103817,2186.364848,1,0,0,1,7,Yu Jr Wang
2003,101723,2186.358541,3,1,0,2,35,Magnus Larsson
1987,108002,2186.357179,1,0,0,1,43,Philippe Lacombrade
1988,107128,2186.355669,1,0,0,1,21,Grant Saacks
2008,104707,2186.354538,1,0,0,1,18,Denis Matsukevitch
1998,102795,2186.348216,1,0,0,1,17,Scott Humphries
1985,101029,2186.344008,16,7,0,9,1,Ricki Osterthun
1994,101512,2186.343939,1,0,0,1,23,Trevor Kronemann
1993,101732,2186.340346,1,0,0,1,10,Pietro Pennisi
1993,101360,2186.339179,3,1,0,2,23,Mark Keil
1992,101897,2186.338472,7,3,0,4,3,Fernando Meligeni
1988,101295,2186.330732,7,3,0,4,8,Toshihisa Tsuchihashi
2014,110636,2186.326725,1,0,0,1,18,Clay Thompson
2010,108721,2186.32646,1,0,0,1,22,Philippos Tsangaridis
2006,103193,2186.324725,1,0,0,1,5,Peter Wessels
2013,104944,2186.318603,1,0,0,1,30,Niels Desein
1994,106906,2186.312302,1,0,0,1,37,Dusan Prchlik
2002,102223,2186.309591,3,1,0,2,30,Karim Alami
1990,106967,2186.300118,1,0,0,1,10,Ettore Rossetti
1986,100910,2186.299938,3,1,0,2,15,Magnus Tideman
2011,106244,2186.29949,1,0,0,1,26,Oliver Golding
2000,102457,2186.2994,1,0,0,1,24,Miles Maclagan
2015,105436,2186.298138,1,0,0,1,18,Markus Eriksson
1985,100540,2186.297682,1,0,0,1,15,Drew Gitlin
2013,105431,2186.295652,1,0,0,1,34,Ariel Behar
2013,122687,2186.295652,1,0,0,1,34,Rodrigo Senattore
1994,100855,2186.295537,1,0,0,1,7,Scott Davis
1994,102300,2186.293999,1,0,0,1,34,Gouichi Motomura
2008,105015,2186.293802,1,0,0,1,35,Franco Skugor
2000,103131,2186.293007,1,0,0,1,8,Michihisa Onoda
2002,103358,2186.291602,1,0,0,1,18,Nicolas Todero
1997,101567,2186.289858,3,1,0,2,21,Hendrik Jan Davids
2003,104230,2186.289613,1,0,0,1,15,Daniel Koellerer
1991,108263,2186.288561,1,0,0,1,27,Silvio Moine
1999,102572,2186.288163,1,0,0,1,14,Igor Gaudi
2015,144707,2186.286597,1,0,0,1,6,Mikael Ymer
2005,104219,2186.285813,1,0,0,1,5,Stephane Bohli
1991,101331,2186.285766,1,0,0,1,22,Alex Nizet
2004,104392,2186.281272,1,0,0,1,35,Franco Ferreiro
2010,108980,2186.280685,1,0,0,1,11,Luis Delgado
1995,102600,2186.280238,1,0,0,1,17,David Miketa
1996,103171,2186.277981,1,0,0,1,23,Raemon Sluiter
2008,105220,2186.276198,1,0,0,1,7,Jun Chao Xu
2012,104644,2186.270793,1,0,0,1,9,Riccardo Ghedin
1986,101380,2186.267973,1,0,0,1,9,Amit Naor
1991,101014,2186.266613,1,0,0,1,21,John Ross
1996,101341,2186.266289,1,0,0,1,11,Pablo Albano
1993,101123,2186.266236,6,2,0,4,6,Alexander Mronz
2007,103007,2186.265991,1,0,0,1,9,Mounir El Aarej
1992,101577,2186.265615,3,1,0,2,35,Jia Ping Xia
2014,105731,2186.261901,1,0,0,1,16,Steven Diez
1996,101686,2186.261288,1,0,0,1,32,Franco Davin
1992,106718,2186.260013,1,0,0,1,6,Cheng Fong Chang
1990,101823,2186.258672,1,0,0,1,13,Gerald Mandl
1993,101576,2186.25609,3,1,0,2,7,Ryuso Tsujino
2010,105497,2186.252948,1,0,0,1,40,Jose Hernandez
1990,100592,2186.249823,1,0,0,1,23,Robert Vant Hof
1985,100669,2186.246225,1,0,0,1,24,Charles Bud Cox
2004,104171,2186.244352,1,0,0,1,21,Richard Bloomfield
1998,102522,2186.242903,1,0,0,1,10,Fabio Maggi
2015,106169,2186.240181,1,0,0,1,11,Vladyslav Manafov
2003,102234,2186.239336,1,0,0,1,15,Oliver Gross
2014,104043,2186.238311,1,0,0,1,29,Marc Lopez
2003,104618,2186.232915,1,0,0,1,8,Devin Mullings
1995,100944,2186.2329,1,0,0,1,21,Mikael Pernfors
2008,103185,2186.226397,1,0,0,1,38,Mike Bryan
1985,107178,2186.22504,1,0,0,1,10,Haruo Nakano
2012,103925,2186.222014,1,0,0,1,32,Gabriel Moraru
1985,101121,2186.218739,1,0,0,1,26,Alaaddin Karagoz
2000,103397,2186.217675,1,0,0,1,13,Alexandre Simoni
1994,102203,2186.217484,1,0,0,1,39,Jonathan Leach
1989,107170,2186.217112,1,0,0,1,20,Hans Priller
2005,104003,2186.215978,1,0,0,1,9,Victor Crivoi
2011,104330,2186.210188,5,2,0,3,17,Rajeev Ram
1992,101765,2186.2084,3,1,0,2,34,Tomas Anzari
2003,103007,2186.208344,1,0,0,1,30,Mounir El Aarej
1990,101308,2186.205206,3,1,0,2,17,Neil Broad
2003,102785,2186.203841,1,0,0,1,6,Glenn Weiner
1994,102030,2186.19402,3,1,0,2,22,Andrew Foster
1991,101647,2186.192113,5,2,0,3,15,Byron Black
1997,102996,2186.188751,1,0,0,1,23,Franz Stauder
1990,100719,2186.188405,1,0,0,1,27,Juan Avendano
2011,105807,2186.184788,1,0,0,1,33,Pablo Carreno Busta
2000,101890,2186.183068,1,0,0,1,43,Jonathan Stark
1987,101247,2186.174531,1,0,0,1,26,Stephen Botfield
2004,102987,2186.173914,1,0,0,1,21,Andre Sa
2006,103826,2186.169682,1,0,0,1,8,Carlos Palencia
1985,100839,2186.16856,1,0,0,1,18,Laird Dunlop
2011,105161,2186.166946,1,0,0,1,18,Yann Marti
2002,102743,2186.165064,1,0,0,1,18,Ben Ellwood
2004,102381,2186.158393,3,1,0,2,17,Werner Eschauer
1986,100770,2186.158217,9,4,0,5,8,Peter Moraing
2014,105063,2186.156111,1,0,0,1,23,Andrea Arnaboldi
2014,105930,2186.15599,1,0,0,1,34,Daniel Kosakowski
2000,101263,2186.154215,1,0,0,1,45,Luke Jensen
1997,101904,2186.15371,1,0,0,1,23,Chris Haggard
1999,102348,2186.15131,3,1,0,2,32,Hideki Kaneko
1992,101110,2186.14734,1,0,0,1,30,David De Miguel
1998,103484,2186.14693,1,0,0,1,19,James Blake
1999,101373,2186.144386,3,1,0,2,17,Karsten Braasch
1989,101283,2186.143622,1,0,0,1,25,Dirk Leppen
2007,104070,2186.141735,1,0,0,1,39,Jesse Witten
2006,103849,2186.141394,1,0,0,1,7,Francesco Aldi
1993,101932,2186.139888,23,9,0,14,4,Jared Palmer
2006,102539,2186.138253,1,0,0,1,7,Bohdan Ulihrach
2003,103963,2186.137619,1,0,0,1,14,Filip Urban
1993,101420,2186.13705,1,0,0,1,34,Vaclav Roubicek
2001,102667,2186.135268,1,0,0,1,7,Satoshi Iwabuchi
1994,101531,2186.133357,1,0,0,1,33,Mario Visconti
1997,101536,2186.132206,1,0,0,1,20,Murphy Jensen
2007,103924,2186.131547,1,0,0,1,34,Marc Fornell Mestres
1999,103995,2186.129264,1,0,0,1,33,Pedro Leao
1987,100641,2186.127379,1,0,0,1,43,Jan Van Langendonck
2010,103543,2186.125867,3,1,0,2,31,David Marrero
1989,100880,2186.122264,1,0,0,1,9,Russell Barlow
1990,106874,2186.121579,1,0,0,1,9,Dick Bosse
2007,105062,2186.118591,1,0,0,1,3,Mikhail Kukushkin
1996,101906,2186.118024,1,0,0,1,32,Yasufumi Yamamoto
1988,100691,2186.116043,1,0,0,1,50,Ivo Werner
1990,107201,2186.114959,1,0,0,1,27,Hidehiko Tanizawa
1991,101664,2186.113141,1,0,0,1,50,Andras Lanyi
1986,100938,2186.112057,1,0,0,1,9,Jaromir Becka
1989,101193,2186.111952,1,0,0,1,21,James Schor
2007,104679,2186.111288,1,0,0,1,35,Jamie Murray
1990,102139,2186.105596,1,0,0,1,5,Eyal Ran
2013,105591,2186.104836,1,0,0,1,22,Matt Reid
1993,102795,2186.104359,1,0,0,1,20,Scott Humphries
1992,101128,2186.103491,1,0,0,1,32,Michael Walker
2001,102715,2186.102819,3,1,0,2,11,Ignacio Hirigoyen
1993,102539,2186.102744,1,0,0,1,18,Bohdan Ulihrach
2014,104667,2186.101296,1,0,0,1,7,Philipp Oswald
1987,107828,2186.100008,1,0,0,1,27,Morees Dubruyn
2003,104171,2186.099801,1,0,0,1,19,Richard Bloomfield
2012,104003,2186.096461,3,1,0,2,11,Victor Crivoi
2011,104864,2186.095793,1,0,0,1,41,Alex Kuznetsov
2011,104783,2186.095242,1,0,0,1,10,Mikhail Ledovskikh
2008,105831,2186.093958,1,0,0,1,7,Marko Djokovic
1997,103318,2186.093749,1,0,0,1,17,Zeljko Krajan
1991,100437,2186.092826,1,0,0,1,36,Bjorn Borg
1985,100947,2186.092469,1,0,0,1,45,Doug Burke
2006,104437,2186.091789,1,0,0,1,16,Dekel Valtzer
1994,102394,2186.091259,4,1,0,3,3,Johan Van Herck
2004,103178,2186.090598,1,0,0,1,3,Johan Settergren
2005,102821,2186.085418,3,1,0,2,7,Cecil Mamiit
2003,103395,2186.084617,1,0,0,1,9,Julio Silva
1998,102464,2186.082839,3,1,0,2,10,Todd Larkham
1986,101000,2186.08204,1,0,0,1,20,Carl Limberger
1985,107696,2186.081091,1,0,0,1,10,Mark Jeffrey
1991,108235,2186.080984,1,0,0,1,3,Sergej Skakun
1990,102171,2186.078107,1,0,0,1,4,Reinhard Wawra
2007,104059,2186.076862,1,0,0,1,35,Rasmus Norby
2002,103082,2186.07623,1,0,0,1,14,Markus Hantschk
2004,104286,2186.07623,1,0,0,1,38,Vishal Punna
2013,103454,2186.07623,1,0,0,1,40,Nicolas Massu
2008,104807,2186.076104,1,0,0,1,17,Mehdi Ziadi
1986,100551,2186.075966,14,6,0,8,6,Brad Drewett
2012,104789,2186.075445,3,1,0,2,35,Sherif Sabry
1985,101509,2186.07444,1,0,0,1,11,Patrick Flynn
1986,101006,2186.074163,3,1,0,2,25,Bruno Dadillon
2003,102574,2186.073402,1,0,0,1,39,Gabriel Trifu
2002,103009,2186.072712,1,0,0,1,21,Razvan Sabau
2012,105565,2186.072646,1,0,0,1,42,Ya Nan Ma
1999,102577,2186.070857,1,0,0,1,16,Steven Randjelovic
2013,103582,2186.070612,5,2,0,3,10,Michael Berrer
2002,103065,2186.066641,1,0,0,1,8,Kepler Orellana
1992,101672,2186.065018,1,0,0,1,34,Michael Geserer
2002,103371,2186.063846,1,0,0,1,12,Emin Agaev
1999,101843,2186.062594,1,0,0,1,16,Sergi Bruguera
2004,103837,2186.062363,1,0,0,1,28,Didac Perez
1994,101418,2186.062239,1,0,0,1,6,Herve Grenier
2008,104580,2186.062073,1,0,0,1,17,Haithem Abid
2003,103730,2186.061887,1,0,0,1,21,Jonathan Marray
2010,104673,2186.059181,1,0,0,1,40,Julio Cesar Campozano
1989,108367,2186.05867,1,0,0,1,20,Tertius Reynders
1992,101124,2186.057282,18,7,0,11,7,Paolo Cane
2001,101890,2186.056628,1,0,0,1,22,Jonathan Stark
1999,103374,2186.056144,1,0,0,1,9,Zoltan Boroczky
1994,102539,2186.054106,1,0,0,1,16,Bohdan Ulihrach
2005,103878,2186.052284,1,0,0,1,36,Zach Dailey
1995,101788,2186.050273,1,0,0,1,24,Doug Flach
2007,104027,2186.047637,1,0,0,1,41,Pablo Gonzalez
1995,102405,2186.047539,7,3,0,4,10,Mahesh Bhupathi
2004,104355,2186.0463,1,0,0,1,19,Lester Cook
1998,102162,2186.042572,1,0,0,1,37,Chris Woodruff
1987,101123,2186.039514,1,0,0,1,43,Alexander Mronz
2002,103559,2186.03898,1,0,0,1,14,David Sherwood
1990,101787,2186.036679,1,0,0,1,35,Darren Patten
2011,106000,2186.036679,1,0,0,1,12,Damir Dzumhur
1995,101771,2186.036496,1,0,0,1,44,Ashley Naumann
2002,104004,2186.03529,1,0,0,1,18,Filip Prpic
1998,103472,2186.035161,1,0,0,1,18,Karim Maamoun
2011,104477,2186.03431,1,0,0,1,42,Jorge Aguilar
1999,101938,2186.033818,1,0,0,1,9,Bernardo Mota
1988,107170,2186.032519,1,0,0,1,21,Hans Priller
1999,101906,2186.030324,1,0,0,1,32,Yasufumi Yamamoto
2008,104478,2186.025508,1,0,0,1,7,Hyun Woo Nam
2013,105874,2186.025413,3,1,0,2,10,Albano Olivetti
1989,100910,2186.024783,1,0,0,1,21,Magnus Tideman
2002,101543,2186.023951,1,0,0,1,37,Jeff Tarango
2007,102287,2186.023626,3,1,0,2,33,Albert Portas
1998,101745,2186.023018,1,0,0,1,36,Roberto Jabali
2007,108685,2186.021779,3,1,0,2,19,Frederick Sletting Johnsen
1987,101032,2186.021623,1,0,0,1,27,Henry Somerville
2012,105402,2186.020921,1,0,0,1,9,Peerakiat Siriluethaiwattana
1990,101726,2186.020831,1,0,0,1,5,Boaz Merenstein
1991,102154,2186.020757,8,3,0,5,13,Marcos Ondruska
1998,102457,2186.020256,1,0,0,1,10,Miles Maclagan
2000,103029,2186.019931,1,0,0,1,36,Mehdi Tahiri
2009,103592,2186.018034,1,0,0,1,4,Jerome Haehnel
2013,102800,2186.017901,1,0,0,1,41,Nenad Zimonjic
1991,101076,2186.017055,1,0,0,1,12,Cesar Kist
1997,103273,2186.016368,1,0,0,1,33,Dong Hyun Kim
1990,101250,2186.016332,1,0,0,1,28,Jose Daher
1994,106536,2186.016332,1,0,0,1,30,Andres Filimonov
2014,105586,2186.016332,1,0,0,1,40,Alexander Lazov
2004,104228,2186.015369,1,0,0,1,30,Guillem Burniol
1988,101765,2186.014803,1,0,0,1,20,Tomas Anzari
2006,104317,2186.013406,1,0,0,1,26,David Luque Velasco
1989,101214,2186.01212,4,1,0,3,16,Bryan Shelton
1985,101267,2186.011137,1,0,0,1,6,Michael Oberleitner
1987,101263,2186.010067,1,0,0,1,24,Luke Jensen
1993,102173,2186.009138,1,0,0,1,18,Rainer Falenti
2014,105882,2186.006985,1,0,0,1,25,Stefano Travaglia
2010,104783,2186.006847,1,0,0,1,26,Mikhail Ledovskikh
2000,102617,2186.006133,1,0,0,1,21,Kim Tiilikainen
1991,101284,2186.005876,5,2,0,3,9,Lars Anders Wahlgren
2009,105431,2186.004773,1,0,0,1,11,Ariel Behar
1989,101508,2186.004052,1,0,0,1,20,Magnus Zeile
1999,103824,2186.003443,1,0,0,1,9,Orest Tereshchuk
2010,105877,2186.002005,1,0,0,1,11,Emilio Gomez
2011,104479,2186.001934,1,0,0,1,21,Sarvar Ikramov
2000,104022,2186.001525,14,6,0,8,2,Mikhail Youzhny
2010,101404,2186.000778,1,0,0,1,5,Thomas Muster
2013,125783,2185.999151,1,0,0,1,34,Magloire Yakpa
2002,103104,2185.999147,1,0,0,1,10,Bjorn Rehnquist
1992,102030,2185.998745,1,0,0,1,22,Andrew Foster
1990,101962,2185.998447,1,0,0,1,30,Younes El Aynaoui
2013,106374,2185.997528,1,0,0,1,40,Filip Veger
1988,108372,2185.996836,1,0,0,1,44,Thibault Kuentz
2007,104736,2185.996078,3,1,0,2,32,Farrukh Dustov
2012,106232,2185.996078,3,1,0,2,11,Roberto Cid
2002,102250,2185.996049,1,0,0,1,38,Emanuel Couto
2011,108759,2185.996049,1,0,0,1,38,Sami Ghorbel
2015,104676,2185.996049,1,0,0,1,40,Andreas Beck
2014,105059,2185.995987,1,0,0,1,7,Kento Takeuchi
2002,103317,2185.995163,1,0,0,1,17,Gabor Jaross
1992,100864,2185.99447,1,0,0,1,42,Martin Wostenholme
2008,104342,2185.994418,1,0,0,1,38,Matias Silva
1987,101017,2185.993744,1,0,0,1,37,Gap Taik Ro
2004,108890,2185.993684,1,0,0,1,18,Juan Carlos Rebaza Lozano
2001,103290,2185.992857,1,0,0,1,7,Radim Zitko
1991,101584,2185.992532,1,0,0,1,22,Keith Evans
2005,108612,2185.992137,1,0,0,1,17,Sergei Cuptov
2001,104205,2185.991772,1,0,0,1,9,Taras Demyanekno
2013,108761,2185.991663,1,0,0,1,11,Mikelis Libietis
2009,108958,2185.990291,1,0,0,1,38,Damion Johnson
2006,103676,2185.989976,1,0,0,1,15,Michael Yani
1998,103451,2185.9892,1,0,0,1,32,Bjorn Phau
2014,105679,2185.986162,1,0,0,1,17,Eduardo Struvay
2005,104258,2185.984812,1,0,0,1,17,Juan Enrique Crosa
1985,108257,2185.982988,1,0,0,1,10,Shoichi Tatsuno
1988,101761,2185.982077,3,1,0,2,2,Jaime Oncins
2008,105341,2185.981959,1,0,0,1,27,Thomas Fabbiano
1999,102135,2185.978878,1,0,0,1,8,Emilio Benfele Alvarez
1985,107502,2185.977732,1,0,0,1,10,Kenzo Ukon U004
2010,104619,2185.977379,1,0,0,1,24,Jesse Huta Galung
2014,106381,2185.976872,1,0,0,1,9,Temur Ismailov
1987,101429,2185.976561,1,0,0,1,43,Stephane Grenier
1994,101961,2185.975998,1,0,0,1,33,Martin Stringari
1985,100255,2185.975706,1,0,0,1,47,Roscoe Tanner
1986,100869,2185.975706,1,0,0,1,46,Jon Sorbo
1986,101144,2185.975706,1,0,0,1,8,Anthony Lane
1986,101232,2185.975706,1,0,0,1,21,Nicklas Kroon
1986,101609,2185.975706,1,0,0,1,46,David Wheaton
1987,100253,2185.975706,1,0,0,1,47,Tom Gullikson
1987,100906,2185.975706,1,0,0,1,47,Antony Emerson
1987,101155,2185.975706,1,0,0,1,27,James Turner
1987,101549,2185.975706,1,0,0,1,50,Rodolphe Gilbert
1987,108018,2185.975706,1,0,0,1,50,Pierre Lemoine
1988,101570,2185.975706,1,0,0,1,6,Vicente Solves
1989,101556,2185.975706,1,0,0,1,54,Carl Turich
1989,101847,2185.975706,1,0,0,1,12,Bret Richardson
1989,102358,2185.975706,1,0,0,1,38,Thomas Enqvist
1991,100286,2185.975706,1,0,0,1,43,Harold Solomon
1991,100587,2185.975706,1,0,0,1,52,Steve Guy
1994,101317,2185.975706,1,0,0,1,45,John Sullivan
1994,106782,2185.975706,1,0,0,1,36,Colin Grant
1995,101096,2185.975706,1,0,0,1,34,Gary Muller
1995,101841,2185.975706,1,0,0,1,23,Aleksandar Kitinov
1995,102872,2185.975706,1,0,0,1,45,James Sekulov
1996,102862,2185.975706,1,0,0,1,45,Allen Belobrajdic
1997,102842,2185.975706,1,0,0,1,47,Toby Mitchell
1997,103154,2185.975706,1,0,0,1,47,Jaymon Crabb
1997,108593,2185.975706,3,1,0,2,33,Wing Luen Wong
1997,108833,2185.975706,1,0,0,1,33,Farah Al Somali
1998,108795,2185.975706,1,0,0,1,18,Jean Noel Said
1999,103009,2185.975706,1,0,0,1,23,Razvan Sabau
1999,103198,2185.975706,1,0,0,1,46,Justin Bower
1999,108618,2185.975706,1,0,0,1,34,Karim Alayli
1999,108662,2185.975706,1,0,0,1,18,Lavaughn Munroe
2000,100997,2185.975706,1,0,0,1,20,Roger Smith
2000,102331,2185.975706,1,0,0,1,20,Ilou Lonfo
2000,102714,2185.975706,1,0,0,1,47,Ekkarin Pisuth Arnonth
2000,102889,2185.975706,1,0,0,1,47,Hee Sung Chung
2000,108605,2185.975706,1,0,0,1,20,Sacha Thoma
2000,108608,2185.975706,1,0,0,1,20,Marwan Zewar
2001,102751,2185.975706,1,0,0,1,43,Todd Perry
2001,104270,2185.975706,1,0,0,1,33,Marvin Rolle
2001,108633,2185.975706,1,0,0,1,33,Juan Carlos Gonzalez
2001,108635,2185.975706,1,0,0,1,33,Juan Pablo Barboza
2002,103535,2185.975706,1,0,0,1,40,Olivier Patience
2002,108666,2185.975706,1,0,0,1,17,Harutyun Sofyan
2003,103435,2185.975706,1,0,0,1,35,Massimo Dellacqua
2003,103647,2185.975706,1,0,0,1,39,Jun Kato
2003,104299,2185.975706,5,2,0,3,8,Hiu Tung Yu
2003,104444,2185.975706,1,0,0,1,41,Ryan Henry
2003,108598,2185.975706,1,0,0,1,31,Rolando Ruel
2004,103851,2185.975706,1,0,0,1,18,Conor Niland
2004,108922,2185.975706,3,1,0,2,31,Will Farah Lebar
2004,108925,2185.975706,1,0,0,1,31,Ahmad Rabeea Muhammad
2004,108926,2185.975706,1,0,0,1,18,David Kvernadze
2005,102945,2185.975706,1,0,0,1,40,Luke Bourgeois
2005,103775,2185.975706,1,0,0,1,38,Felipe Parada
2005,105367,2185.975706,1,0,0,1,26,Daniel Alejandro Lopez Cassaccia
2005,108932,2185.975706,1,0,0,1,34,Pfungwa Mahefu
2006,103467,2185.975706,1,0,0,1,36,Victor Bruthans
2006,103623,2185.975706,1,0,0,1,38,Jacob Adaktusson
2006,108644,2185.975706,1,0,0,1,36,Patrick Chucri
2006,108957,2185.975706,1,0,0,1,30,Jorge Villanueva
2006,108974,2185.975706,1,0,0,1,16,Christopher Koutrouzas
2007,103803,2185.975706,3,1,0,2,35,Ashkan Shokoofi
2007,103820,2185.975706,1,0,0,1,44,Alan Mackin
2007,104297,2185.975706,1,0,0,1,40,Rogerio Dutra Silva
2007,105098,2185.975706,1,0,0,1,26,Alexandre Sidorenko
2007,108651,2185.975706,1,0,0,1,35,Sandor Martinez Breijo
2007,108975,2185.975706,1,0,0,1,19,Petros Baghdatis
2008,103849,2185.975706,1,0,0,1,37,Francesco Aldi
2008,104486,2185.975706,1,0,0,1,38,Horia Tecau
2008,105159,2185.975706,1,0,0,1,31,Vaja Uzakov
2008,105454,2185.975706,1,0,0,1,40,Brydan Klein
2008,105464,2185.975706,3,1,0,2,31,Christopher Rungkat
2008,108707,2185.975706,1,0,0,1,31,Cesar Escobar Serrano
2009,104270,2185.975706,1,0,0,1,21,Marvin Rolle
2009,104504,2185.975706,1,0,0,1,43,Ross Hutchins
2009,108726,2185.975706,1,0,0,1,21,Dominic Pagon
2010,103514,2185.975706,1,0,0,1,22,Young Jun Kim
2010,104695,2185.975706,1,0,0,1,44,Fritz Wolmarans
2010,104775,2185.975706,3,1,0,2,22,Adam Kellner
2010,105084,2185.975706,1,0,0,1,46,James Lemke
2010,108945,2185.975706,1,0,0,1,22,Juan Sebastian Langton
2011,105159,2185.975706,1,0,0,1,38,Vaja Uzakov
2011,108769,2185.975706,1,0,0,1,21,Johann Coles
2011,108974,2185.975706,1,0,0,1,21,Christopher Koutrouzas
2012,103860,2185.975706,1,0,0,1,42,Timo Nieminen
2012,104162,2185.975706,1,0,0,1,35,Deniss Pavlovs
2012,104219,2185.975706,1,0,0,1,45,Stephane Bohli
2013,103174,2185.975706,1,0,0,1,41,Noam Okun
2013,111797,2185.975706,1,0,0,1,11,Nicolas Jarry
2014,106238,2185.975706,1,0,0,1,39,Andres Artunedo Martinavarr
2014,108985,2185.975706,1,0,0,1,32,Ali Ghareeb
2015,104603,2185.975706,1,0,0,1,36,Andrei Ciumac
2015,105099,2185.975706,1,0,0,1,40,Antonio Veic
2015,105428,2185.975706,1,0,0,1,19,Marcus Daniell
2015,111442,2185.975706,1,0,0,1,41,Jordan Thompson
2015,133301,2185.975706,1,0,0,1,19,Giovani Samaha
2009,104738,2185.974946,1,0,0,1,41,Caio Zampieri
1991,108227,2185.974917,1,0,0,1,49,Sebastian Soresini
1996,102359,2185.974916,1,0,0,1,44,Andrew Richardson
2008,107552,2185.9744,1,0,0,1,17,Laurent Bram
2004,101947,2185.974197,1,0,0,1,37,Vincenzo Santopadre
1990,101007,2185.974128,1,0,0,1,34,Guillermo Rivas
2008,104667,2185.973,1,0,0,1,18,Philipp Oswald
2009,104454,2185.972435,3,1,0,2,11,Murad Inoyatov
2013,106228,2185.972237,1,0,0,1,20,Juan Ignacio Londero
1997,108603,2185.972115,1,0,0,1,10,Helge Koll Frafjord
1999,102169,2185.972077,1,0,0,1,41,Michael Joyce
1991,102171,2185.971716,1,0,0,1,17,Reinhard Wawra
2006,104253,2185.971616,1,0,0,1,9,Juan Martin Aranguren
1992,102374,2185.969703,24,11,0,13,3,Alex Corretja
1988,100825,2185.968222,5,2,0,3,14,Hugo Chapacu
1986,101582,2185.964985,1,0,0,1,19,Gilbert Schaller
2014,111790,2185.964203,1,0,0,1,13,Brayden Schnur
2001,103754,2185.96225,1,0,0,1,21,Mark Hilton
2014,106237,2185.961911,1,0,0,1,9,Chieh Fu Wang
1989,107382,2185.961181,1,0,0,1,22,John Farrington
2010,104604,2185.96081,1,0,0,1,22,Ruben Gonzales
1993,102701,2185.958542,1,0,0,1,36,Marcelo Rios
2007,103403,2185.957212,1,0,0,1,7,Takahiro Terachi
1995,101490,2185.956974,1,0,0,1,37,Daniel Orsanic
2003,108897,2185.956947,1,0,0,1,31,Inam Gul
2000,103281,2185.956944,1,0,0,1,47,Ladislav Svarc
2010,103600,2185.956941,1,0,0,1,41,Mohammad Ghareeb
1998,102235,2185.956843,1,0,0,1,19,Tommy Ho
1989,101066,2185.956772,38,16,0,22,5,Richard Matuszewski
1985,107639,2185.956156,1,0,0,1,18,Marcel Van Der Merwe
1994,101375,2185.955425,1,0,0,1,44,Brian Devening
1985,106962,2185.955366,1,0,0,1,30,Ernesto Vazquez
1988,100868,2185.955366,1,0,0,1,50,Craig A Miller
1988,101502,2185.955366,1,0,0,1,50,Torben Theine
1996,103164,2185.955366,1,0,0,1,36,Artemi Tchernenko
1998,101417,2185.955366,1,0,0,1,41,Mario Rincon
2000,102512,2185.955366,1,0,0,1,49,Joseph Sirianni
2002,103823,2185.955366,1,0,0,1,37,Denis Gremelmayr
2003,104291,2185.955366,1,0,0,1,31,Malek Jaziri
2012,105376,2185.955366,1,0,0,1,44,Peter Gojowczyk
2013,104934,2185.955366,1,0,0,1,41,Thomas Kromann
2013,104952,2185.955366,1,0,0,1,41,Martin Pedersen
2013,106381,2185.955366,1,0,0,1,41,Temur Ismailov
2013,108972,2185.955366,1,0,0,1,41,Ibrahim Abou Chahine
2014,111442,2185.955366,1,0,0,1,42,Jordan Thompson
2015,104007,2185.955366,1,0,0,1,40,Andre Ghem
1998,102348,2185.95523,1,0,0,1,31,Hideki Kaneko
1986,108257,2185.955095,1,0,0,1,8,Shoichi Tatsuno
2009,108729,2185.954577,1,0,0,1,21,Hassan Al Mousa
2011,103999,2185.954577,1,0,0,1,42,Thiago Alves
1986,100781,2185.954237,1,0,0,1,37,Bernhard Pils
2001,103413,2185.953821,1,0,0,1,9,Genius Chidzikwe
1996,101893,2185.953208,1,0,0,1,20,Patrick Mohr
2003,103029,2185.951631,1,0,0,1,30,Mehdi Tahiri
1992,102119,2185.94801,1,0,0,1,6,Chih Jung Chen
1991,101953,2185.946812,1,0,0,1,38,Kentaro Masuda
2004,104468,2185.945409,1,0,0,1,5,Gilles Simon
1990,101881,2185.945191,1,0,0,1,13,Oliver Fuchs
1994,108995,2185.944792,1,0,0,1,7,Otakar Jurecka
1991,100920,2185.941643,1,0,0,1,21,Robert Seguso
2001,102650,2185.940344,1,0,0,1,8,Roberto Carretero
1992,100744,2185.939724,1,0,0,1,41,Peter Doohan
1999,108593,2185.939055,1,0,0,1,33,Wing Luen Wong
1988,101674,2185.938875,1,0,0,1,36,Rudiger Haas
2011,104604,2185.938509,1,0,0,1,21,Ruben Gonzales
2013,103672,2185.938291,1,0,0,1,39,Ricardo Mello
2007,103675,2185.93815,1,0,0,1,39,Diego Junqueira
2013,105283,2185.937437,1,0,0,1,31,Gerard Granollers
1997,101573,2185.937414,1,0,0,1,32,Carl Chang
2004,103877,2185.937393,1,0,0,1,31,Mike Scheidweiler
2003,108901,2185.936572,1,0,0,1,17,Zibusiso Ncube
2011,105288,2185.936447,1,0,0,1,38,Guillermo Rivera Aranguiz
2003,103363,2185.93634,1,0,0,1,15,Diego Ayala
1990,101886,2185.936253,1,0,0,1,5,Ohad Weinberg
2005,103290,2185.935878,1,0,0,1,16,Radim Zitko
1991,100810,2185.935875,1,0,0,1,49,Paul Chamberlin
2012,103531,2185.935875,1,0,0,1,42,Thomas Oger
2009,104586,2185.935639,1,0,0,1,4,Lukas Rosol
1991,100892,2185.93509,1,0,0,1,12,Alexandre Hocevar
2001,103546,2185.93509,1,0,0,1,39,Patricio Arquez
2005,103975,2185.93509,1,0,0,1,38,Eric Nunez
2014,104970,2185.93454,1,0,0,1,29,Matteo Viola
2012,105493,2185.934335,1,0,0,1,42,Tomislav Brkic
2010,105229,2185.934019,1,0,0,1,14,Philip Bester
1992,101953,2185.93281,1,0,0,1,33,Kentaro Masuda
1988,101924,2185.932018,1,0,0,1,15,Stefano Pescosolido
1997,101812,2185.931979,3,1,0,2,11,Raviv Weidenfeld
1995,102015,2185.930738,1,0,0,1,14,Tomislav Prpic
1985,100362,2185.927867,21,9,0,12,9,Peter Fleming
1991,101862,2185.926096,13,6,0,7,4,Maurice Ruah
2002,103097,2185.926039,1,0,0,1,12,Trevor Spracklin
1987,101327,2185.925654,1,0,0,1,19,Cyril Suk
2004,103264,2185.923789,1,0,0,1,7,Mariano Puerta
2003,108603,2185.922754,1,0,0,1,8,Helge Koll Frafjord
2012,105757,2185.922192,1,0,0,1,20,Sandro Ehrat
1991,101570,2185.920526,1,0,0,1,38,Vicente Solves
2008,104082,2185.918985,1,0,0,1,6,Hiroki Kondo
2010,105657,2185.91874,1,0,0,1,10,Marius Copil
1989,102080,2185.917245,1,0,0,1,25,Will Bull
2007,104484,2185.91652,1,0,0,1,19,Lawal Shehu
2005,103737,2185.915055,5,2,0,3,35,Edgardo Massa
1992,108195,2185.914744,1,0,0,1,10,Salahaddine Adbib
1986,101502,2185.913364,1,0,0,1,15,Torben Theine
1990,100532,2185.913332,1,0,0,1,29,Johan Kriek
1997,102224,2185.91281,1,0,0,1,24,Miguel Pastura
2001,102502,2185.908456,1,0,0,1,14,Paul Harsanyi
1998,101389,2185.907837,1,0,0,1,17,Oren Motevassel
2000,103242,2185.906771,1,0,0,1,28,Juan Giner
1997,102778,2185.902494,1,0,0,1,11,Abdul Hamid Makhkamov
2005,104230,2185.901841,3,1,0,2,15,Daniel Koellerer
1994,108856,2185.899825,1,0,0,1,30,Mark Farren
2007,102585,2185.899504,1,0,0,1,35,Sebastian Prieto
1992,107093,2185.897403,1,0,0,1,7,Gil Kovalski
2000,102410,2185.895014,1,0,0,1,16,David Caldwell
1991,102090,2185.893688,1,0,0,1,7,Ofer Sela
1987,101115,2185.892211,8,3,0,5,14,Jorge Bardou
2004,102473,2185.892127,1,0,0,1,17,Thomas Schiessling
2003,103967,2185.891231,1,0,0,1,18,Michael Lammer
2002,103063,2185.888987,3,1,0,2,15,Sebastien De Chaunac
2006,102667,2185.887319,5,2,0,3,6,Satoshi Iwabuchi
2004,103948,2185.887251,1,0,0,1,26,Maximilian Abel
1988,101593,2185.887045,1,0,0,1,20,Chris Garner
2012,104473,2185.886684,1,0,0,1,21,Walter Trusendi
1991,101224,2185.88463,1,0,0,1,21,Kenny Thorne
2003,102802,2185.883548,3,1,0,2,17,Gunther Darkey
2013,104219,2185.878852,1,0,0,1,24,Stephane Bohli
2007,102539,2185.877232,3,1,0,2,22,Bohdan Ulihrach
2005,104099,2185.876453,1,0,0,1,31,Israel Matos Gil
1991,101108,2185.875391,1,0,0,1,46,Richard Schmidt
1988,101366,2185.8752,1,0,0,1,44,David Macpherson
2003,103808,2185.873198,1,0,0,1,16,Potito Starace
2006,102381,2185.871027,1,0,0,1,15,Werner Eschauer
2006,102965,2185.869148,3,1,0,2,16,Jamie Delgado
2007,102202,2185.866243,3,1,0,2,6,Kenneth Carlsen
1995,102226,2185.865202,1,0,0,1,32,David Witt
2009,108712,2185.864497,1,0,0,1,38,Brandon Burke
2009,108941,2185.864497,1,0,0,1,38,Damar Johnson
2010,104579,2185.862242,1,0,0,1,5,Romain Jouan
1989,102540,2185.86122,1,0,0,1,19,Peter Hajek
1996,103240,2185.860971,1,0,0,1,12,Kevin Kim
1995,101398,2185.859296,1,0,0,1,22,Neil Borwick
1989,101013,2185.858076,1,0,0,1,39,Henrik Sundstrom
2011,103850,2185.857884,1,0,0,1,23,Sebastian Decoud
1997,102055,2185.850889,5,2,0,3,20,Bertrand Madsen
2010,104136,2185.849796,1,0,0,1,41,Santiago Gonzalez
1992,101375,2185.846528,3,1,0,2,7,Brian Devening
1989,101567,2185.842131,1,0,0,1,21,Hendrik Jan Davids
1986,101736,2185.842007,11,5,0,6,3,Andre Agassi
1991,101531,2185.840819,1,0,0,1,17,Mario Visconti
1991,101128,2185.836615,1,0,0,1,40,Michael Walker
2007,103997,2185.835972,5,2,0,3,7,Lukasz Kubot
1990,100982,2185.835325,1,0,0,1,6,Charlton Eagle
1988,101745,2185.834714,1,0,0,1,2,Roberto Jabali
1987,107940,2185.834194,1,0,0,1,38,Paul Chaput
2011,103676,2185.834003,7,3,0,4,13,Michael Yani
1988,101065,2185.833215,1,0,0,1,28,Joel Figueras
1987,108008,2185.828999,1,0,0,1,16,Phillip Williamson
2012,102382,2185.826813,1,0,0,1,9,Julian Knowle
2015,105173,2185.82542,58,28,0,30,3,Adrian Mannarino
1994,103017,2185.825206,1,0,0,1,7,Nicolas Kiefer
2009,105070,2185.824324,1,0,0,1,38,Hans Podlipnik Castillo
1997,101318,2185.822384,17,7,0,10,21,Javier Frana
1997,101989,2185.822027,1,0,0,1,36,Patrik Langvardt
2008,103752,2185.821981,1,0,0,1,24,Simon Greul
1995,101989,2185.819714,1,0,0,1,38,Patrik Langvardt
1988,101710,2185.817518,3,1,0,2,19,Martin Blackman
1997,102256,2185.81274,1,0,0,1,21,Nick Weal
2012,106277,2185.809227,1,0,0,1,9,Ariez Elyaas Deen Heshaam
1989,107028,2185.807652,1,0,0,1,41,Francisco Pinto
1992,101295,2185.804759,1,0,0,1,33,Toshihisa Tsuchihashi
1986,101111,2185.802607,1,0,0,1,15,Rudiger Benz
2008,104721,2185.798619,7,2,0,5,2,Josselin Ouanna
2013,105916,2185.797517,5,2,0,3,10,Marton Fucsovics
1996,101735,2185.796692,39,18,0,21,3,Richard Fromberg
2001,103530,2185.796549,1,0,0,1,14,Zack Fleishman
2004,102886,2185.793028,3,1,0,2,17,Frantisek Cermak
2001,102238,2185.792423,1,0,0,1,30,Alberto Berasategui
2013,104644,2185.791935,1,0,0,1,25,Riccardo Ghedin
1992,102348,2185.79063,1,0,0,1,7,Hideki Kaneko
1992,100904,2185.785417,1,0,0,1,32,George Bezecny
2015,105098,2185.784823,1,0,0,1,10,Alexandre Sidorenko
1995,102023,2185.784534,1,0,0,1,7,Petr Luxa
2001,102263,2185.784498,5,2,0,3,7,Yong Il Yoon
2004,103230,2185.783785,1,0,0,1,6,Tasuku Iwami
2000,103834,2185.777036,1,0,0,1,36,Levar Harper Griffith
1997,103405,2185.773554,1,0,0,1,12,Rodolfo Rake
2010,104025,2185.771617,1,0,0,1,11,Amer Delic
1985,100485,2185.769091,4,1,0,3,9,Tsuyoshi Fukui
1996,102050,2185.768941,1,0,0,1,17,Marco Meneschincheri
1991,101338,2185.766957,1,0,0,1,28,Olivier Soules
1996,103133,2185.765903,1,0,0,1,6,Olivier Mutis
2005,104743,2185.764337,1,0,0,1,34,Kamil Capkovic
2012,104850,2185.763143,1,0,0,1,26,Jonathan Dasnieres De Veigy
1988,100951,2185.761851,1,0,0,1,30,Alessandro De Minicis
1986,100367,2185.758119,1,0,0,1,18,Belus Prajoux
1998,101536,2185.757351,1,0,0,1,26,Murphy Jensen
1992,101823,2185.755909,1,0,0,1,6,Gerald Mandl
1999,102554,2185.753072,1,0,0,1,23,Diego Moyano
1997,103297,2185.746953,1,0,0,1,18,Alex Kim
2004,103403,2185.741336,3,1,0,2,6,Takahiro Terachi
1997,102118,2185.740147,8,3,0,5,2,Radomir Vasek
2001,103824,2185.738689,1,0,0,1,9,Orest Tereshchuk
2005,105227,2185.73732,1,0,0,1,15,Marin Cilic
1998,102808,2185.737266,1,0,0,1,31,Kalle Flygt
1998,103487,2185.73535,1,0,0,1,7,Federico Luzzi
1989,101398,2185.735194,1,0,0,1,27,Neil Borwick
2008,104314,2185.733189,7,3,0,4,9,Brian Dabul
1987,100918,2185.732759,1,0,0,1,20,Harald Rittersbacher
1996,101719,2185.730334,3,1,0,2,24,Frederic Fontang
2007,104660,2185.727684,5,2,0,3,19,Sergiy Stakhovsky
2012,105207,2185.727681,1,0,0,1,35,Andrei Daescu
1989,101477,2185.725202,21,9,0,12,4,Chris Bailey
2003,103052,2185.724193,1,0,0,1,23,Mariano Delfino
1989,100819,2185.721145,1,0,0,1,19,Daniel Montes De Oca
1985,101085,2185.719525,1,0,0,1,27,Corrado Aprili
2006,108948,2185.718407,1,0,0,1,30,Alexandr Zotov
2010,105589,2185.713901,1,0,0,1,18,Gerald Melzer
2001,102234,2185.712079,3,1,0,2,8,Oliver Gross
2008,104149,2185.709311,3,1,0,2,9,Adrian Cruciat
1987,100733,2185.704361,1,0,0,1,37,Woo Ryong Lee
1989,100892,2185.700575,3,1,0,2,41,Alexandre Hocevar
1988,101311,2185.695528,1,0,0,1,21,Kent Kinnear
1990,102146,2185.695167,1,0,0,1,8,Jordi Burillo
1991,102226,2185.693099,6,2,0,4,13,David Witt
1997,102381,2185.692495,1,0,0,1,17,Werner Eschauer
1995,101332,2185.692473,3,1,0,2,7,Gilad Bloom
2001,102269,2185.690369,3,1,0,2,14,Jeff Salzenstein
1989,100951,2185.687902,1,0,0,1,41,Alessandro De Minicis
2007,104770,2185.68624,1,0,0,1,18,Martin Fischer
1987,100569,2185.684434,1,0,0,1,38,Toru Yonezawa
1997,101997,2185.683061,24,10,0,14,7,Marzio Martelli
2010,105098,2185.680884,3,1,0,2,32,Alexandre Sidorenko
2010,103821,2185.677974,1,0,0,1,9,Danai Udomchoke
2008,103420,2185.673078,1,0,0,1,25,Michal Tabara
2014,105634,2185.673052,1,0,0,1,15,Viktor Galovic
2007,103914,2185.670298,1,0,0,1,38,Omar Awadhy
1986,101126,2185.664604,1,0,0,1,5,Chris Pridham
1991,100759,2185.658703,3,1,0,2,7,Danie Visser
2015,123921,2185.656302,1,0,0,1,17,Calvin Hemery
1993,102100,2185.655843,3,1,0,2,21,Bartlomiej Dabrowski
2014,105783,2185.654866,1,0,0,1,12,Chase Buchanan
1989,106923,2185.652869,1,0,0,1,15,Eduardo Mandarino
1999,102817,2185.651352,3,1,0,2,41,Edwin Kempes
2014,105245,2185.647385,1,0,0,1,16,Fabiano De Paula
2012,105529,2185.646673,1,0,0,1,31,Carlos Gomez Herrera
1990,100919,2185.646581,1,0,0,1,30,Khalid Outaleb
1991,101672,2185.645186,1,0,0,1,17,Michael Geserer
2008,102720,2185.643465,1,0,0,1,10,Tomas Zib
2013,105906,2185.64187,1,0,0,1,30,Kevin Krawietz
2002,103080,2185.639045,1,0,0,1,11,Paul Hanley
2013,119511,2185.631727,1,0,0,1,41,Loic Didavi
1988,101322,2185.630283,3,1,0,2,38,Shigeru Ota
1994,102117,2185.626772,1,0,0,1,34,Eduardo Nicolas
2008,105147,2185.626424,1,0,0,1,6,Tatsuma Ito
2004,102910,2185.622704,1,0,0,1,28,Salvador Navarro
1999,102902,2185.621751,1,0,0,1,19,Thomas Blake
1989,101862,2185.621028,1,0,0,1,18,Maurice Ruah
1994,101973,2185.61891,1,0,0,1,23,Viktor Nagy
1993,108008,2185.616983,1,0,0,1,14,Phillip Williamson
2005,105229,2185.614862,1,0,0,1,13,Philip Bester
2002,102630,2185.613505,1,0,0,1,10,Slimane Saoudi
1998,101761,2185.610387,3,1,0,2,40,Jaime Oncins
1985,100607,2185.609688,25,11,0,14,13,Eduardo Bengoechea
1994,101976,2185.609516,1,0,0,1,36,Federico Dondo
1997,101654,2185.60907,1,0,0,1,20,Michael Shyjan
2005,104037,2185.608179,1,0,0,1,38,Phillip Harboe
1993,101368,2185.604852,7,3,0,4,4,Christian Miniussi
2012,105916,2185.597946,5,2,0,3,24,Marton Fucsovics
2008,105738,2185.597521,1,0,0,1,38,Tsung Hua Yang
2006,103525,2185.594542,3,1,0,2,16,Ivan Miranda
2014,104672,2185.592807,3,1,0,2,39,Vincent Millot
2009,104171,2185.589474,1,0,0,1,40,Richard Bloomfield
2003,103752,2185.589394,1,0,0,1,16,Simon Greul
2005,103843,2185.584775,5,2,0,3,34,Marco Chiudinelli
2004,102768,2185.582565,3,1,0,2,25,Federico Browne
1990,101435,2185.580747,1,0,0,1,14,Brian Gyetko
1996,102097,2185.579905,3,1,0,2,10,Naratorn Srichaphan
2002,102817,2185.579148,3,1,0,2,10,Edwin Kempes
1991,101670,2185.578493,1,0,0,1,9,Martin Schaffl
2005,104181,2185.57324,1,0,0,1,15,Victor Ionita
1994,101574,2185.573022,1,0,0,1,11,Alejandro Aramburu
2005,103762,2185.572701,1,0,0,1,7,John Paul Fruttero
2012,103967,2185.572473,1,0,0,1,42,Michael Lammer
2015,104117,2185.572473,1,0,0,1,40,Giovanni Lapentti
2005,102267,2185.572016,1,0,0,1,34,Gwinyai Tongoona
2005,108901,2185.572016,1,0,0,1,34,Zibusiso Ncube
2004,102985,2185.569477,1,0,0,1,34,Gustavo Marcaccio
2002,103131,2185.56641,1,0,0,1,6,Michihisa Onoda
1987,100731,2185.564249,1,0,0,1,52,Hector Ortiz
1994,102854,2185.564188,3,1,0,2,17,Sjeng Schalken
2008,105554,2185.56232,1,0,0,1,23,Daniel Evans
2004,102565,2185.561867,5,2,0,3,19,Alexander Waske
2004,103110,2185.561674,3,1,0,2,21,Daniele Bracciali
1998,103082,2185.56095,1,0,0,1,10,Markus Hantschk
1987,100993,2185.559672,3,1,0,2,24,Loic Courteau
1996,102194,2185.556708,1,0,0,1,31,Min Kyu Han
2013,122279,2185.556447,1,0,0,1,14,Romain Bogaerts
1991,101444,2185.552788,1,0,0,1,42,Bonit Wiryawan
1995,103029,2185.552396,1,0,0,1,36,Mehdi Tahiri
2003,103865,2185.551873,1,0,0,1,31,Prima Simpatiaji
2013,104851,2185.550862,1,0,0,1,40,Gianluca Naso
2013,105254,2185.550164,1,0,0,1,40,Nikola Mektic
2002,102644,2185.54949,38,16,0,22,7,Franco Squillari
2015,111513,2185.547954,1,0,0,1,18,Laslo Djere
2012,105872,2185.545813,1,0,0,1,21,Christian Lindell
1990,101430,2185.54569,1,0,0,1,25,Sergio Cortes
1987,101783,2185.541148,1,0,0,1,4,Mark Petchey
1986,100924,2185.541036,1,0,0,1,25,Jorge Lozano
1998,102067,2185.540869,1,0,0,1,16,Emanuel Rasberger
1987,101767,2185.538541,1,0,0,1,21,Lars Jonsson
1998,103184,2185.536214,6,2,0,4,11,Bob Bryan
1998,102713,2185.533904,1,0,0,1,18,Jing Zhu Yang
2001,103637,2185.533904,1,0,0,1,40,Marcelo Amador
1992,102039,2185.533414,1,0,0,1,10,Gaurav Natekar
2008,108997,2185.532484,1,0,0,1,37,Clint Bowles
2014,105436,2185.532045,1,0,0,1,18,Markus Eriksson
1997,101682,2185.531118,1,0,0,1,31,David Adams
2005,103286,2185.530081,1,0,0,1,26,Yohny Romero
2011,105941,2185.529574,1,0,0,1,42,Felipe Rios
1990,102132,2185.528547,1,0,0,1,9,Ivan Baron
1987,101315,2185.526841,1,0,0,1,31,Enrico Cocchi
1990,101574,2185.525909,3,1,0,2,23,Alejandro Aramburu
2013,105100,2185.525733,1,0,0,1,25,Edward Corrie
1986,101448,2185.525064,1,0,0,1,25,Tasos Bavelas
1987,100907,2185.522724,1,0,0,1,42,Luca Bottazzi
2006,102987,2185.515884,1,0,0,1,34,Andre Sa
2002,104269,2185.513394,3,1,0,2,15,Fernando Verdasco
2008,105273,2185.512914,1,0,0,1,38,Mauricio Echazu
2014,106342,2185.512188,1,0,0,1,40,Martins Podzus
2010,104166,2185.51213,1,0,0,1,43,Alex Bogomolov Jr
2010,104154,2185.511651,3,1,0,2,22,Paul Capdeville
2003,102585,2185.511402,1,0,0,1,38,Sebastian Prieto
2003,102076,2185.511351,1,0,0,1,39,Mark Merklein
1994,101584,2185.510432,1,0,0,1,44,Keith Evans
2007,104273,2185.508848,12,5,0,7,3,Edouard Roger Vasselin
2014,106415,2185.507792,1,0,0,1,10,Yoshihito Nishioka
2014,103926,2185.507698,1,0,0,1,34,Daniel Munoz De La Nava
2001,102497,2185.506984,1,0,0,1,11,Mashiska Washington
2008,104997,2185.505912,1,0,0,1,18,Igor Sijsling
2007,104997,2185.503968,1,0,0,1,35,Igor Sijsling
1990,101314,2185.501633,1,0,0,1,24,Woody Hunt
1989,101721,2185.500321,1,0,0,1,21,Markus Zillner
1989,102118,2185.499764,1,0,0,1,7,Radomir Vasek
1988,101820,2185.497197,1,0,0,1,15,Marc Rosset
1990,101514,2185.496605,1,0,0,1,10,Mike Briggs
2014,106412,2185.493439,1,0,0,1,9,Lucas Gomez
1994,102743,2185.492906,1,0,0,1,8,Ben Ellwood
2009,105539,2185.49263,1,0,0,1,6,Evgeny Donskoy
1986,101485,2185.492038,3,1,0,2,22,Tanakorn Srichaphan
1988,107182,2185.492038,3,1,0,2,23,Hassan El Arousy
2011,105707,2185.491876,1,0,0,1,42,Nicolaas Scholtz
2012,105074,2185.490743,10,4,0,6,6,Ruben Bemelmans
1990,101255,2185.48967,1,0,0,1,33,Greg Van Emburgh
2010,104997,2185.486259,7,3,0,4,10,Igor Sijsling
2012,104778,2185.485751,1,0,0,1,10,Andrey Kumantsov
2013,126209,2185.483101,1,0,0,1,11,Peter Bertran
1990,101155,2185.482978,1,0,0,1,17,James Turner
1993,101937,2185.48244,1,0,0,1,35,Robbie Koenig
2007,104424,2185.48198,9,4,0,5,7,Go Soeda
2011,104729,2185.47834,1,0,0,1,6,Ivan Nedelko
2008,104781,2185.477543,1,0,0,1,6,Yuichi Ito
1989,101385,2185.477272,1,0,0,1,27,Mario Carnevale
2002,102687,2185.47699,1,0,0,1,15,Herbert Wiltschnig
2008,103926,2185.476384,1,0,0,1,37,Daniel Munoz De La Nava
2009,103594,2185.476065,1,0,0,1,35,Oliver Marach
1997,102428,2185.475778,1,0,0,1,41,Johan Hede
2006,105155,2185.475064,1,0,0,1,8,Pedro Sousa
1985,100585,2185.473243,1,0,0,1,46,Van Winitsky
1986,101030,2185.473243,1,0,0,1,46,Goran Prpic
1994,100947,2185.473243,1,0,0,1,43,Doug Burke
2007,105259,2185.473243,1,0,0,1,9,Andrei Karatchenia
2008,104830,2185.473243,1,0,0,1,28,Matteo Marrai
2010,105262,2185.473243,1,0,0,1,34,Fernando Romboli
2012,105175,2185.473243,1,0,0,1,43,Kristijan Mesaros
2013,105441,2185.473243,1,0,0,1,42,John Patrick Smith
2014,105917,2185.473243,1,0,0,1,16,Gianni Mina
2006,108952,2185.473241,3,1,0,2,30,Jose Roberto Velasco
1993,102529,2185.472564,1,0,0,1,34,Thomas Shimada
2009,105254,2185.472458,1,0,0,1,43,Nikola Mektic
2014,104446,2185.471672,1,0,0,1,32,Dinko Halachev
1990,101172,2185.470286,1,0,0,1,28,Royce Deppe
1990,100836,2185.468833,1,0,0,1,14,Glenn Michibata
2009,104826,2185.468457,3,1,0,2,11,Federico Sansonetti
2003,103046,2185.466244,1,0,0,1,17,Janne Ojala
2006,105166,2185.465342,1,0,0,1,13,Peter Polansky
1990,101329,2185.465223,1,0,0,1,7,Christer Allgardh
1993,100832,2185.464894,1,0,0,1,9,Constantinos Efremoglou
1987,101328,2185.464685,1,0,0,1,27,Mihnea Ion Nastase
2004,103334,2185.463795,1,0,0,1,8,Ronaldo Carvalho
2002,103033,2185.463234,3,1,0,2,17,Helder Lopes
2005,104569,2185.462934,3,1,0,2,17,Lado Chikhladze
1989,107688,2185.462495,1,0,0,1,18,Mark Greenan
2002,103403,2185.461404,1,0,0,1,6,Takahiro Terachi
2014,106283,2185.459205,1,0,0,1,18,Mitchell Krueger
2015,105493,2185.45811,3,1,0,2,19,Tomislav Brkic
1995,102667,2185.457754,1,0,0,1,33,Satoshi Iwabuchi
1999,103061,2185.454215,1,0,0,1,15,Jan Boruszewski
2013,104081,2185.453778,1,0,0,1,41,Boris Pashanski
1990,102223,2185.453777,1,0,0,1,30,Karim Alami
2004,102554,2185.453777,1,0,0,1,36,Diego Moyano
2011,103969,2185.453777,1,0,0,1,41,Roman Borvanov
2009,105180,2185.453717,1,0,0,1,41,Daniel Dutra Da Silva
1989,110830,2185.452992,1,0,0,1,43,Chee Leong Wong
1991,101506,2185.452992,1,0,0,1,34,Eoin Collins
1991,110892,2185.452992,1,0,0,1,25,Katore Agnamba
1993,101771,2185.452992,1,0,0,1,46,Ashley Naumann
1994,108833,2185.452992,1,0,0,1,36,Farah Al Somali
1997,101835,2185.452992,1,0,0,1,31,Arne Thoms
1997,108813,2185.452992,1,0,0,1,33,Rafael Goscinny
1998,101638,2185.452992,1,0,0,1,18,Sean Karam
1998,103298,2185.452992,1,0,0,1,18,Piotr Szczepanik
1999,103499,2185.452992,1,0,0,1,34,Aqeel Khan
1999,108846,2185.452992,1,0,0,1,34,Syed Nasir Sherazi
2001,108623,2185.452992,3,1,0,2,33,Rabi Bouhassoun
2001,108639,2185.452992,1,0,0,1,18,Maxime Koffi
2003,103864,2185.452992,3,1,0,2,17,Mohamed Mamoun
2003,104093,2185.452992,1,0,0,1,17,Nickolai Dyachok
2003,108893,2185.452992,1,0,0,1,17,Tarek Ben Soltane
2004,101316,2185.452992,1,0,0,1,31,Juan Rios
2004,101871,2185.452992,1,0,0,1,37,Alexander Reichel
2006,103205,2185.452992,3,1,0,2,30,Emilio Daniel Baez Britez
2006,108969,2185.452992,1,0,0,1,30,Antoine Breikeh
2006,108972,2185.452992,1,0,0,1,30,Ibrahim Abou Chahine
2006,108975,2185.452992,1,0,0,1,16,Petros Baghdatis
2007,104210,2185.452992,1,0,0,1,35,Ryan Russell
2008,103109,2185.452992,1,0,0,1,17,Talal Ouahabi
2008,103292,2185.452992,1,0,0,1,39,Gaston Gaudio
2008,108706,2185.452992,1,0,0,1,31,Sulaiman Al Rawahi
2010,104251,2185.452992,1,0,0,1,22,Ti Chen
2011,104958,2185.452992,1,0,0,1,43,Carsten Ball
2015,122513,2185.452992,1,0,0,1,19,Andrei Soltoianu
2015,134114,2185.452992,1,0,0,1,19,Jad Ballout
1987,101216,2185.452544,5,2,0,3,28,Olli Rahnasto
2012,104516,2185.451899,1,0,0,1,32,Arnau Brugues Davi
2002,108660,2185.451418,1,0,0,1,31,Fadi Youssef
1985,100641,2185.451412,3,1,0,2,26,Jan Van Langendonck
1986,109456,2185.451412,3,1,0,2,32,Carlos Lozano
1999,103568,2185.451412,3,1,0,2,18,Valentin Sanon
2004,108644,2185.451412,3,1,0,2,31,Patrick Chucri
2008,105085,2185.451412,3,1,0,2,17,Artem Smirnov
1997,103007,2185.450054,1,0,0,1,34,Mounir El Aarej
1994,102282,2185.449493,1,0,0,1,7,Tetsuya Chaen
1999,104339,2185.446429,1,0,0,1,9,Mario Ancic
1994,101171,2185.442287,1,0,0,1,36,Armando Perez
1994,102524,2185.439522,1,0,0,1,35,Neville Godwin
1993,101670,2185.43896,1,0,0,1,18,Martin Schaffl
2015,104905,2185.43702,1,0,0,1,18,Nicolas Barrientos
1992,101612,2185.435131,1,0,0,1,18,Roland Burtscher
1997,101660,2185.435102,1,0,0,1,46,Francisco Montana
1997,101506,2185.434287,1,0,0,1,28,Eoin Collins
2004,108909,2185.434192,1,0,0,1,31,Jalil Khan
1988,101720,2185.434012,1,0,0,1,5,Agustin Garizzio
1996,101123,2185.433532,1,0,0,1,41,Alexander Mronz
2010,105070,2185.433531,1,0,0,1,44,Hans Podlipnik Castillo
1988,101027,2185.431922,1,0,0,1,20,Jaroslav Bulant
2012,104917,2185.431206,1,0,0,1,35,Anas Fattar
1988,101925,2185.430753,1,0,0,1,20,Massimo Boscatto
1993,102834,2185.428258,1,0,0,1,14,Paul Goldstein
2002,104196,2185.420169,1,0,0,1,28,Carlos Cuadrado
2002,103395,2185.41819,3,1,0,2,9,Julio Silva
2010,104385,2185.415552,1,0,0,1,43,Lars Poerschke
2005,108614,2185.41511,1,0,0,1,17,Raoul Behr
2008,104676,2185.414706,12,5,0,7,3,Andreas Beck
1997,102869,2185.408145,36,16,0,20,2,Galo Blanco
1986,101059,2185.402267,1,0,0,1,19,Richard Vogel
1988,101663,2185.402107,1,0,0,1,33,Eugenio Rossi
1991,102375,2185.401098,8,3,0,5,28,Dinu Pescariu
2014,104499,2185.401091,9,4,0,5,17,Jimmy Wang
2013,108748,2185.39637,3,1,0,2,34,Lukas Mugevicius
2003,104392,2185.394956,1,0,0,1,9,Franco Ferreiro
2002,102087,2185.394756,12,5,0,7,9,Oleg Ogorodov
2010,105159,2185.394038,1,0,0,1,22,Vaja Uzakov
1985,100854,2185.393458,1,0,0,1,24,Leighton Alfred
1997,100997,2185.391689,5,2,0,3,19,Roger Smith
2006,104453,2185.388997,1,0,0,1,7,Michael Ryderstedt
1992,102178,2185.386494,1,0,0,1,34,Scott Gessner
2012,103914,2185.379755,1,0,0,1,38,Omar Awadhy
1990,101584,2185.372124,1,0,0,1,31,Keith Evans
2003,104460,2185.37058,1,0,0,1,18,Dustin Brown
1987,100887,2185.369615,1,0,0,1,42,Eric Korita
1993,101574,2185.368228,1,0,0,1,26,Alejandro Aramburu
1999,102965,2185.36678,3,1,0,2,10,Jamie Delgado
1996,101675,2185.363481,1,0,0,1,3,Martin Rodriguez
2009,103523,2185.363474,6,2,0,4,9,Rohan Bopanna
1986,100241,2185.362111,1,0,0,1,8,Joel Bailey
2006,105028,2185.358572,1,0,0,1,18,Jesse Levine
2002,103270,2185.356782,1,0,0,1,28,Kristian Capalik
2004,103478,2185.356531,1,0,0,1,30,Diego Veronelli
2012,104839,2185.352398,5,2,0,3,34,Yassine Idmbarek
2004,104311,2185.351064,3,1,0,2,18,Leonardo Tavares
1986,100794,2185.347548,3,1,0,2,8,Srinivasan Vasudevan
2005,104371,2185.346059,24,11,0,13,3,Ivo Minar
1999,102077,2185.343687,1,0,0,1,10,Alexander Shvec
1986,101128,2185.341743,1,0,0,1,24,Michael Walker
1988,101325,2185.341149,1,0,0,1,27,Jason Goodall
1998,103413,2185.340716,1,0,0,1,18,Genius Chidzikwe
2006,104501,2185.335742,1,0,0,1,9,Xin Yuan Yu
2008,104235,2185.331992,1,0,0,1,22,Matwe Middelkoop
1992,101731,2185.331696,3,1,0,2,34,Nuno Marques
1997,101577,2185.32639,5,2,0,3,7,Jia Ping Xia
2007,102694,2185.323629,1,0,0,1,34,Lars Burgsmuller
1991,101956,2185.323335,5,2,0,3,5,Mark Knowles
1986,100691,2185.306837,7,3,0,4,8,Ivo Werner
1999,102086,2185.306038,5,2,0,3,7,Igor Kornienko
1999,101389,2185.304141,1,0,0,1,22,Oren Motevassel
1995,102834,2185.302347,1,0,0,1,19,Paul Goldstein
2010,105449,2185.301186,1,0,0,1,18,Steve Johnson
1991,101745,2185.299065,3,1,0,2,12,Roberto Jabali
1997,102578,2185.29337,1,0,0,1,2,Fredrik Bergh
1998,101543,2185.289903,53,24,0,29,2,Jeff Tarango
2010,104850,2185.28955,1,0,0,1,21,Jonathan Dasnieres De Veigy
1999,101805,2185.286294,3,1,0,2,29,David Nainkin
1985,100785,2185.285944,1,0,0,1,13,Jesus Colas
2004,104043,2185.285387,21,9,0,12,7,Marc Lopez
1989,101262,2185.285186,3,1,0,2,9,Rikard Bergh
1988,101267,2185.285161,1,0,0,1,9,Michael Oberleitner
2009,105730,2185.284079,2,0,0,2,12,Devin Britton
2003,103240,2185.280264,1,0,0,1,14,Kevin Kim
1985,100704,2185.279728,1,0,0,1,19,Billy Nealon
1988,101043,2185.266044,1,0,0,1,2,Johan Vekemans
1999,102520,2185.262437,1,0,0,1,30,Olivier Malcor
1986,100858,2185.254719,1,0,0,1,8,Hans Fredborg
1996,101687,2185.252727,3,1,0,2,20,David Dilucia
1994,102834,2185.251983,1,0,0,1,12,Paul Goldstein
2014,111156,2185.242867,1,0,0,1,16,Nathan Pasha
1997,101374,2185.237901,1,0,0,1,37,Leonardo Lavalle
1993,101422,2185.236622,6,2,0,4,16,Mark Kaplan
2002,104325,2185.228068,1,0,0,1,23,Johannes Ager
2008,103682,2185.227839,1,0,0,1,8,Kyu Tae Im
2008,103860,2185.225699,1,0,0,1,17,Timo Nieminen
2008,105349,2185.225699,1,0,0,1,17,Harri Heliovaara
2004,101965,2185.221999,31,14,0,17,8,Wayne Ferreira
2001,102300,2185.221284,5,2,0,3,7,Gouichi Motomura
2006,107098,2185.221206,3,1,0,2,30,Gilles Kremer
1988,101956,2185.217505,1,0,0,1,21,Mark Knowles
1988,107102,2185.214562,1,0,0,1,15,Giovanni Lelli Mami
2010,104162,2185.21225,1,0,0,1,40,Deniss Pavlovs
2005,103877,2185.208782,1,0,0,1,34,Mike Scheidweiler
1987,101080,2185.208677,15,6,0,9,13,Lawson Duncan
2000,102851,2185.208197,1,0,0,1,10,Giorgio Galimberti
1988,101726,2185.206725,1,0,0,1,10,Boaz Merenstein
1986,101233,2185.204077,8,3,0,5,7,Alex Antonitsch
2002,103988,2185.202953,1,0,0,1,27,Mariano Albert Ferrando
1994,101274,2185.201623,1,0,0,1,18,Udo Riglewski
2007,102800,2185.195306,1,0,0,1,30,Nenad Zimonjic
1988,101505,2185.192202,1,0,0,1,28,Darren Kirk
1986,101598,2185.181662,3,1,0,2,20,Eduardo Velez
2013,110602,2185.1781,1,0,0,1,18,Dennis Novak
1993,101184,2185.175314,1,0,0,1,15,Damir Buljevic
2005,104760,2185.17273,1,0,0,1,18,Scott Oudsema
1992,101147,2185.167442,29,13,0,16,6,Claudio Mezzadri
2002,101150,2185.167302,1,0,0,1,14,Gianluca Pozzi
2008,103437,2185.166252,1,0,0,1,18,Francesco Piccari
1992,102026,2185.165511,1,0,0,1,18,Jan Kodes Jr
2007,104646,2185.164116,1,0,0,1,8,Purav Raja
2012,104953,2185.157635,1,0,0,1,10,Nikolai Fidirko
1989,107818,2185.152558,1,0,0,1,18,Miles Walker
1991,100836,2185.152553,11,5,0,6,7,Glenn Michibata
2009,105960,2185.150828,1,0,0,1,39,Evan King
1998,102780,2185.148595,1,0,0,1,15,Frederic Niemeyer
2003,103403,2185.14433,1,0,0,1,6,Takahiro Terachi
2003,103799,2185.143398,3,1,0,2,30,Eric Prodon
2012,106053,2185.141791,1,0,0,1,9,Philip Davydenko
2010,105872,2185.13754,1,0,0,1,21,Christian Lindell
1987,108378,2185.134773,1,0,0,1,30,Thierry Van Den Daele
1998,101938,2185.133895,1,0,0,1,32,Bernardo Mota
2013,104807,2185.132456,1,0,0,1,33,Mehdi Ziadi
2011,106207,2185.131129,1,0,0,1,18,Mate Pavic
1998,103852,2185.130175,1,0,0,1,31,Feliciano Lopez
2000,103007,2185.126121,1,0,0,1,36,Mounir El Aarej
1988,101235,2185.12494,1,0,0,1,22,Paul Haarhuis
1991,100826,2185.118594,1,0,0,1,35,Juan Antonio Rodriguez
2005,104171,2185.115092,1,0,0,1,14,Richard Bloomfield
2012,103470,2185.113006,1,0,0,1,39,Robert Kendrick
2008,104195,2185.112003,1,0,0,1,25,Simone Vagnozzi
1993,101874,2185.108591,1,0,0,1,13,Ciprian Petre Porumb
1997,101490,2185.105928,1,0,0,1,17,Daniel Orsanic
1998,102238,2185.101764,56,32,0,24,2,Alberto Berasategui
1987,100645,2185.092858,6,2,0,4,10,Huub Van Boeckel
1995,101124,2185.092794,1,0,0,1,26,Paolo Cane
1994,102161,2185.092516,1,0,0,1,29,Robert Kroll
2009,104019,2185.089358,23,10,0,13,20,Kristof Vliegen
2008,105099,2185.087679,1,0,0,1,18,Antonio Veic
1987,101043,2185.087392,1,0,0,1,30,Johan Vekemans
2014,108761,2185.08576,1,0,0,1,9,Mikelis Libietis
1987,100489,2185.081566,3,1,0,2,26,Larry Stefanki
2007,105131,2185.079889,1,0,0,1,21,Tim Goransson
1988,100770,2185.07421,1,0,0,1,38,Peter Moraing
1995,100857,2185.068438,1,0,0,1,37,Sergio Casal
2000,103799,2185.067844,1,0,0,1,27,Eric Prodon
2001,104180,2185.067824,5,2,0,3,9,Gilles Muller
1991,101483,2185.067314,1,0,0,1,12,Ricardo Camargo
1988,108055,2185.067291,3,1,0,2,39,Raymond Suarez
2008,104569,2185.065801,1,0,0,1,8,Lado Chikhladze
1992,101413,2185.065582,3,1,0,2,6,Felix Barrientos
1999,102347,2185.064368,1,0,0,1,10,Dmitri Tomashevich
2011,104007,2185.064088,1,0,0,1,41,Andre Ghem
2003,108657,2185.063827,3,1,0,2,8,Alexander Skrypko
2013,104905,2185.062222,1,0,0,1,20,Nicolas Barrientos
1986,108378,2185.059992,3,1,0,2,23,Thierry Van Den Daele
1986,101323,2185.05784,1,0,0,1,23,Tim Trigueiro
2008,105103,2185.057521,1,0,0,1,17,Pavel Katliarov
2010,103110,2185.050863,1,0,0,1,30,Daniele Bracciali
2014,117357,2185.0499,1,0,0,1,7,Omar Jasika
2009,105936,2185.049766,1,0,0,1,30,Filip Krajinovic
1990,108571,2185.047314,1,0,0,1,5,Yuval Hirsch
2012,105132,2185.0461,21,9,0,12,6,Jurgen Zopp
1993,101906,2185.044823,8,3,0,5,7,Yasufumi Yamamoto
1999,102436,2185.041978,3,1,0,2,16,Borut Urh
2003,103035,2185.036068,1,0,0,1,7,Alessio Di Mauro
2000,103061,2185.035923,1,0,0,1,25,Jan Boruszewski
2013,103523,2185.032382,1,0,0,1,25,Rohan Bopanna
2010,105006,2185.031776,1,0,0,1,40,Chu Huan Yi
2010,104292,2185.03095,5,2,0,3,11,Izak Van Der Merwe
1995,108686,2185.028842,3,1,0,2,35,Alejandro Aramburu Acuna
2005,105048,2185.025427,1,0,0,1,14,Alex Clayton
2015,106261,2185.024926,1,0,0,1,35,Dennis Novikov
1988,101156,2185.024274,3,1,0,2,39,Juan Pino
2002,108662,2185.02262,1,0,0,1,17,Lavaughn Munroe
2015,106207,2185.021011,1,0,0,1,25,Mate Pavic
1999,102239,2185.02027,1,0,0,1,32,Francisco Costa
2000,103852,2185.01859,1,0,0,1,36,Feliciano Lopez
1996,103216,2185.017954,1,0,0,1,25,Clemens Trimmel
1997,102780,2185.015508,1,0,0,1,16,Frederic Niemeyer
1991,101576,2185.015099,1,0,0,1,7,Ryuso Tsujino
1999,102772,2185.014068,3,1,0,2,34,Yu Zhang
1987,199999,2185.013719,1,0,0,1,27,U Unknown
1993,101982,2185.010643,1,0,0,1,34,Jordi Mas
2003,102207,2185.009393,1,0,0,1,24,Jan Weinzierl
1999,102921,2185.007463,1,0,0,1,33,Ota Fukarek
2012,103165,2185.00694,1,0,0,1,21,Gorka Fraile
2013,104166,2185.006886,15,6,0,9,4,Alex Bogomolov Jr
1991,101237,2185.00322,23,10,0,13,3,Danilo Marcelino
1989,101125,2185.002123,1,0,0,1,24,Ville Jansson
1997,102997,2185.002106,1,0,0,1,2,Hermes Gamonal
1989,100920,2185.000773,28,12,0,16,4,Robert Seguso
2001,103642,2184.998471,1,0,0,1,10,Shan Jiang
1998,101412,2184.997882,1,0,0,1,31,Shuzo Matsuoka
2007,103296,2184.995229,3,1,0,2,19,Ivaylo Traykov
1989,102110,2184.995221,1,0,0,1,18,Daniel Nestor
1995,102047,2184.992903,1,0,0,1,42,Pier Gauthier
1996,103102,2184.990461,5,2,0,3,33,John Hui
1994,101441,2184.988438,5,2,0,3,6,Martin Sinner
1994,101561,2184.988113,5,2,0,3,21,Nicklas Utgren
1988,101447,2184.987108,1,0,0,1,16,Santiago Mora
2011,104967,2184.974284,1,0,0,1,18,Alexander Sadecky
2011,105262,2184.973656,1,0,0,1,41,Fernando Romboli
1994,101205,2184.97305,6,2,0,4,8,Grant Connell
1986,108368,2184.972901,1,0,0,1,8,Tetsu Kuramitsu
1998,103344,2184.970874,5,2,0,3,9,Ivan Ljubicic
1999,101833,2184.969324,5,2,0,3,46,Michael Tebbutt
2014,104658,2184.968774,1,0,0,1,32,Gustavo Ramirez
2007,104234,2184.968276,3,1,0,2,9,Predrag Rusevski
2004,104612,2184.967554,1,0,0,1,13,Daniel Yoo
1985,108256,2184.966422,1,0,0,1,10,Shoichi Horiuchi
1998,102093,2184.965589,48,21,0,27,2,Martin Damm
1985,106700,2184.96474,1,0,0,1,20,Carlos Gomez
2013,104113,2184.964193,1,0,0,1,20,Carlos Salamanca
2015,104802,2184.957799,1,0,0,1,37,Fabrice Martin
2010,104505,2184.957532,3,1,0,2,5,Konstantin Kravchuk
2014,105386,2184.953517,1,0,0,1,40,Janez Semrajc
2000,102735,2184.943801,1,0,0,1,14,Cedric Kauffmann
1998,102868,2184.933163,1,0,0,1,37,Jonathan Printzlau
2002,104416,2184.933128,1,0,0,1,8,Tiago Godinho
2005,103700,2184.92889,3,1,0,2,37,Juan Pablo Guzman
2005,102696,2184.928698,3,1,0,2,17,Guillaume Couillard
2015,105812,2184.928698,3,1,0,2,20,David Agung Susanto
1989,101114,2184.928423,1,0,0,1,18,Charles Beckman
2010,105284,2184.926744,1,0,0,1,22,Tuna Altuna
1996,102061,2184.918928,1,0,0,1,31,Kevin Ullyett
2003,103714,2184.918603,22,10,0,12,3,Andreas Vinciguerra
1993,101358,2184.918086,38,15,0,23,4,Olivier Delaitre
1992,101982,2184.917219,1,0,0,1,24,Jordi Mas
1997,101822,2184.917141,1,0,0,1,10,Luis Lobo
1991,101616,2184.916151,1,0,0,1,3,Serge Soulie
1989,101247,2184.91506,1,0,0,1,26,Stephen Botfield
1986,100892,2184.909505,1,0,0,1,2,Alexandre Hocevar
2004,102538,2184.907957,5,2,0,3,9,Tuomas Ketola
1985,108351,2184.904876,1,0,0,1,10,Takeshi Murakami
2009,105987,2184.904066,1,0,0,1,6,Mikhail Biryukov
2013,104882,2184.903335,26,11,0,15,11,Blaz Kavcic
2006,104004,2184.90235,1,0,0,1,18,Filip Prpic
1992,101983,2184.900506,1,0,0,1,9,Andrew Kratzmann
1991,101356,2184.899706,1,0,0,1,15,Buff Farrow
2003,102269,2184.898483,7,3,0,4,6,Jeff Salzenstein
2014,106228,2184.897277,1,0,0,1,17,Juan Ignacio Londero
2002,102865,2184.896743,1,0,0,1,6,Doug Bohaboy
1995,101284,2184.893636,1,0,0,1,21,Lars Anders Wahlgren
1996,101280,2184.892102,1,0,0,1,37,Mikael Stadling
1988,101184,2184.891827,1,0,0,1,9,Damir Buljevic
2011,105668,2184.886795,5,2,0,3,12,Jerzy Janowicz
1989,100931,2184.885788,1,0,0,1,25,Andrew Burrow
1998,101979,2184.878873,3,1,0,2,18,Ricardo Mena
2010,105827,2184.878302,5,2,0,3,11,Laurynas Grigelis
2011,103926,2184.877017,1,0,0,1,39,Daniel Munoz De La Nava
2009,104896,2184.863216,3,1,0,2,15,Bruno Agostinelli
2000,102320,2184.86314,3,1,0,2,37,Lazaro Navarro Batles
1996,101871,2184.859252,1,0,0,1,32,Alexander Reichel
1993,102650,2184.855594,3,1,0,2,9,Roberto Carretero
1987,100398,2184.8548,5,2,0,3,5,Julio Goes
2012,104820,2184.851381,1,0,0,1,32,Erik Chvojka
2012,106071,2184.848856,53,26,0,27,4,Bernard Tomic
2008,103746,2184.842337,1,0,0,1,8,Miguel Gallardo Valles
2012,104893,2184.842052,1,0,0,1,12,Maxime Authom
1989,100863,2184.839488,1,0,0,1,15,Gustavo Luza
2001,101761,2184.839166,1,0,0,1,11,Jaime Oncins
1998,101249,2184.834321,1,0,0,1,2,Andrei Olhovskiy
2009,103893,2184.831851,1,0,0,1,4,Paolo Lorenzi
1991,101847,2184.829972,1,0,0,1,9,Bret Richardson
2004,104925,2184.829834,5,2,0,3,7,Novak Djokovic
1994,101636,2184.822174,8,3,0,5,12,Wade Mcguire
2007,108944,2184.817927,1,0,0,1,9,Stanislav Bykov
1987,101447,2184.812897,1,0,0,1,14,Santiago Mora
2006,104714,2184.807693,1,0,0,1,3,Julian Reister
2000,103505,2184.807405,3,1,0,2,20,Vasilis Mazarakis
2010,105012,2184.806252,1,0,0,1,40,Alexander Bury
2000,101889,2184.802482,10,4,0,6,16,Todd Woodbridge
1986,100565,2184.799859,1,0,0,1,8,Lloyd Bourne
1989,101417,2184.797682,1,0,0,1,18,Mario Rincon
2009,103503,2184.79675,1,0,0,1,27,Robin Vik
2010,106006,2184.790886,1,0,0,1,19,Agustin Velotti
1987,101308,2184.789463,1,0,0,1,3,Neil Broad
1985,100804,2184.784341,1,0,0,1,17,Henri De Wet
2001,102347,2184.781079,1,0,0,1,11,Dmitri Tomashevich
1990,102210,2184.77971,1,0,0,1,12,Rene Hanak
2004,103104,2184.778684,1,0,0,1,25,Bjorn Rehnquist
1996,101373,2184.778014,1,0,0,1,18,Karsten Braasch
1998,103053,2184.77386,1,0,0,1,10,Nikos Rovas
1993,102118,2184.773583,1,0,0,1,17,Radomir Vasek
2013,104003,2184.766654,1,0,0,1,19,Victor Crivoi
2014,106034,2184.762751,1,0,0,1,32,Yasutaka Uchiyama
1988,101579,2184.761811,1,0,0,1,25,Patrik Wennberg
1996,102831,2184.76026,6,2,0,4,3,Jacobo Diaz
1988,101012,2184.759763,28,12,0,16,9,Massimiliano Narducci
2003,104154,2184.753198,1,0,0,1,9,Paul Capdeville
2005,103408,2184.752201,3,1,0,2,33,Brian Vahaly
1989,101165,2184.749949,5,2,0,3,5,Mario Tabares
2002,103254,2184.749497,5,2,0,3,14,Yves Allegro
1987,100785,2184.747526,1,0,0,1,24,Jesus Colas
2012,105166,2184.745571,1,0,0,1,15,Peter Polansky
2005,105252,2184.745146,1,0,0,1,6,Takahiro Ittogi
2002,103523,2184.744144,1,0,0,1,8,Rohan Bopanna
2007,103805,2184.739699,1,0,0,1,11,Catalin Gard
1988,101211,2184.734037,1,0,0,1,28,Otis Smith
1992,101174,2184.723617,20,8,0,12,3,Fernando Roese
2013,104847,2184.722001,1,0,0,1,21,Adrien Bossel
2002,103185,2184.719928,3,1,0,2,20,Mike Bryan
2000,102768,2184.717337,9,4,0,5,19,Federico Browne
1991,101728,2184.716318,3,1,0,2,34,Laszlo Markovits
2011,104106,2184.709,1,0,0,1,25,Ludovic Walter
2014,106321,2184.707464,1,0,0,1,7,Xin Gao
1989,106937,2184.706664,1,0,0,1,27,Emilio Marturano
1993,101938,2184.705812,1,0,0,1,35,Bernardo Mota
1990,100553,2184.700449,8,3,0,5,5,Nduka Odizor
2004,104523,2184.693542,3,1,0,2,18,Frederico Gil
2012,104986,2184.691694,3,1,0,2,11,Vishnu Vardhan
2005,104284,2184.691564,1,0,0,1,28,Frank Condor
2001,103454,2184.690186,51,23,0,28,3,Nicolas Massu
2000,102287,2184.689768,45,22,0,23,4,Albert Portas
2004,103154,2184.688874,1,0,0,1,7,Jaymon Crabb
2009,104415,2184.6852,1,0,0,1,24,Colin Fleming
2003,108904,2184.683324,1,0,0,1,8,Nigel Badza
2003,102529,2184.682142,1,0,0,1,18,Thomas Shimada
1996,101561,2184.672522,1,0,0,1,20,Nicklas Utgren
1990,101800,2184.670482,1,0,0,1,13,Daniele Balducci
1989,101426,2184.669568,11,5,0,6,20,Kent Carlsson
2003,103242,2184.668289,1,0,0,1,7,Juan Giner
1995,102998,2184.667434,1,0,0,1,15,Jan Michael Gambill
1996,102588,2184.663305,1,0,0,1,32,Lars Rehmann
2009,108710,2184.661829,1,0,0,1,11,Shendrit Deari
2015,104349,2184.659868,5,2,0,3,11,Rui Machado
1993,101958,2184.649736,1,0,0,1,26,Pierre Bouteyre
2001,102957,2184.649245,9,4,0,5,9,Vadim Kutsenko
2010,103292,2184.64553,1,0,0,1,42,Gaston Gaudio
2012,105283,2184.637423,1,0,0,1,32,Gerard Granollers
2007,104121,2184.635447,3,1,0,2,28,Tobias Summerer
1997,102912,2184.630628,1,0,0,1,35,Igor Tchelychev
2015,104308,2184.629536,5,2,0,3,5,Michal Przysiezny
1993,101654,2184.625206,1,0,0,1,41,Michael Shyjan
1991,101681,2184.622877,3,1,0,2,8,Chris Wilkinson
1985,100974,2184.618012,1,0,0,1,21,Jeff Klaparda
1987,106749,2184.610996,1,0,0,1,43,Christoph Geukens
2015,105015,2184.599939,1,0,0,1,36,Franco Skugor
1994,102382,2184.589116,1,0,0,1,16,Julian Knowle
1996,102834,2184.587309,1,0,0,1,18,Paul Goldstein
1995,103110,2184.585099,1,0,0,1,23,Daniele Bracciali
1988,100835,2184.584744,1,0,0,1,9,Hans Dieter Beutel
2011,104718,2184.583778,1,0,0,1,5,Luis Diaz Barriga
2014,104651,2184.581851,3,1,0,2,38,Martin Alund
1987,101198,2184.580233,1,0,0,1,16,Steve Kennedy
1990,101475,2184.57973,14,6,0,8,1,Carlos Costa
1987,100812,2184.573967,1,0,0,1,20,Gerald Mild
1993,102615,2184.573364,1,0,0,1,25,Dennis Van Scheppingen
1991,101328,2184.572849,1,0,0,1,17,Mihnea Ion Nastase
2000,102145,2184.570909,1,0,0,1,19,Francisco Cabello
2015,104467,2184.568394,7,3,0,4,19,Lamine Ouahab
1986,100562,2184.565472,1,0,0,1,21,Tom Cain
2015,105450,2184.565369,1,0,0,1,36,Mike Urbanija
2010,106058,2184.563529,1,0,0,1,13,Jack Sock
1985,101126,2184.558552,1,0,0,1,18,Chris Pridham
1988,107388,2184.556667,1,0,0,1,11,John Marinov
1986,100863,2184.555808,3,1,0,2,18,Gustavo Luza
2005,108628,2184.555564,3,1,0,2,8,Jhonnatan Medina Alvarez
1992,102382,2184.549163,1,0,0,1,18,Julian Knowle
1995,102207,2184.546522,1,0,0,1,31,Jan Weinzierl
1996,101917,2184.542012,23,10,0,13,6,Grant Stafford
1992,100926,2184.539213,1,0,0,1,20,Ken Flach
2009,104503,2184.538387,1,0,0,1,38,Guillermo Hormazabal
2004,103297,2184.534661,1,0,0,1,34,Alex Kim
1992,101216,2184.534223,1,0,0,1,29,Olli Rahnasto
1999,102961,2184.533605,1,0,0,1,19,Nicklas Timfjord
1992,101109,2184.532844,1,0,0,1,18,Tarik Benhabiles
1994,102085,2184.525884,3,1,0,2,13,Sasa Hirszon
2006,104639,2184.521401,1,0,0,1,10,Wayne Odesnik
2011,105471,2184.52103,1,0,0,1,5,Cesar Ramirez
1990,101029,2184.519283,3,1,0,2,13,Ricki Osterthun
2011,103656,2184.518479,47,22,0,25,4,Albert Montanes
2005,102802,2184.514748,1,0,0,1,17,Gunther Darkey
1996,101766,2184.512431,5,2,0,3,25,Bill Behrens
2013,106201,2184.510737,5,2,0,3,11,Maxim Dubarenco
1991,100829,2184.508792,32,15,0,17,3,Jan Gunnarsson
1992,101009,2184.503281,1,0,0,1,37,John Sobel
2006,108588,2184.49781,1,0,0,1,8,Asim Shafik
1996,101862,2184.496509,1,0,0,1,16,Maurice Ruah
2014,126207,2184.493818,1,0,0,1,14,Francis Tiafoe
2004,104386,2184.481862,13,6,0,7,3,Janko Tipsarevic
1991,101149,2184.477368,1,0,0,1,34,Morten Christensen
2004,104503,2184.476692,1,0,0,1,37,Guillermo Hormazabal
2011,105091,2184.474802,1,0,0,1,11,Peter Torebko
2009,104098,2184.473377,31,14,0,17,12,Dmitry Tursunov
1999,102791,2184.464753,1,0,0,1,15,Bobby Kokavec
1995,102562,2184.464395,14,5,0,9,3,Jiri Novak
1993,101472,2184.464085,1,0,0,1,39,Tino Anda
2002,103986,2184.463964,1,0,0,1,10,Radoslav Lukaev
1995,101424,2184.462978,1,0,0,1,34,Brent Haygarth
2009,105001,2184.458672,3,1,0,2,7,Mao Xin Gong
2008,104823,2184.446396,3,1,0,2,8,Bruno Rodriguez
1989,101377,2184.442485,25,11,0,14,5,Christian Bergstrom
2012,105781,2184.434238,1,0,0,1,10,Andrei Vasilevski
2015,103781,2184.433867,21,9,0,12,12,Jurgen Melzer
2009,105032,2184.426023,3,1,0,2,22,Samuel Groth
1988,101389,2184.417805,1,0,0,1,10,Oren Motevassel
2009,105723,2184.41242,3,1,0,2,5,Andrey Kuznetsov
1988,106733,2184.404117,1,0,0,1,26,Chris Louw
2008,105231,2184.400104,1,0,0,1,18,Luka Belic
2005,104283,2184.399705,1,0,0,1,7,Minh Quan Do
2013,105427,2184.398215,1,0,0,1,6,Milos Sekulic
1998,103285,2184.39631,1,0,0,1,5,Radek Stepanek
2003,103843,2184.394343,1,0,0,1,7,Marco Chiudinelli
2000,102687,2184.39207,3,1,0,2,19,Herbert Wiltschnig
2011,104676,2184.385906,8,3,0,5,2,Andreas Beck
2012,103676,2184.382582,3,1,0,2,9,Michael Yani
2009,105149,2184.380349,1,0,0,1,35,Reda El Amrani
1986,101237,2184.378177,1,0,0,1,2,Danilo Marcelino
2007,104992,2184.376768,3,1,0,2,9,Syrym Abdukhalikov
1997,102002,2184.369157,13,6,0,7,3,Davide Scala
1994,102132,2184.367741,1,0,0,1,27,Ivan Baron
2010,104217,2184.364188,1,0,0,1,25,Simon Stadler
2008,103076,2184.361503,1,0,0,1,18,Justin Oneal
2002,103857,2184.358078,1,0,0,1,10,Igor Kunitsyn
2002,103891,2184.348373,1,0,0,1,8,Alexandros Jakupovic
2006,104681,2184.344555,1,0,0,1,17,Sebastian Rieschick
1991,102132,2184.33447,1,0,0,1,21,Ivan Baron
2000,103401,2184.328765,1,0,0,1,21,Jan Hernych
1992,101687,2184.322084,4,1,0,3,12,David Dilucia
1996,101573,2184.316787,1,0,0,1,33,Carl Chang
2004,103657,2184.313397,1,0,0,1,7,Ivo Klec
1995,102235,2184.313023,30,14,0,16,3,Tommy Ho
1989,101912,2184.307722,1,0,0,1,30,Felipe Rivera
2000,103348,2184.299051,1,0,0,1,23,Timo Fleischfresser
2000,102957,2184.29406,5,2,0,3,13,Vadim Kutsenko
2011,104171,2184.292329,1,0,0,1,23,Richard Bloomfield
2012,104729,2184.279576,1,0,0,1,10,Ivan Nedelko
2001,103457,2184.277781,1,0,0,1,32,Petr Kralert
2011,104372,2184.277548,1,0,0,1,23,Alex Bogdanovic
1995,101766,2184.268438,1,0,0,1,19,Bill Behrens
2000,102497,2184.266892,1,0,0,1,16,Mashiska Washington
2013,105967,2184.265257,8,3,0,5,5,Henri Laaksonen
2002,102425,2184.263846,1,0,0,1,8,Niko Karagiannis
2015,111511,2184.258176,1,0,0,1,21,Noah Rubin
2000,101746,2184.254307,8,3,0,5,2,Renzo Furlan
2004,103582,2184.253129,1,0,0,1,23,Michael Berrer
1992,101441,2184.251333,1,0,0,1,26,Martin Sinner
1997,103112,2184.247861,1,0,0,1,11,Ruben Fernandez
2004,104035,2184.244186,1,0,0,1,11,Bobby Reynolds
2003,104372,2184.243397,7,3,0,4,19,Alex Bogdanovic
1985,101018,2184.242384,1,0,0,1,30,Edoardo Mazza
2005,104593,2184.242305,1,0,0,1,22,Daniel Gimeno Traver
2012,105655,2184.235966,4,1,0,3,8,Hiroki Moriya
2003,102836,2184.233169,1,0,0,1,18,Rogier Wassen
2007,102667,2184.22829,1,0,0,1,7,Satoshi Iwabuchi
2006,103700,2184.226299,5,2,0,3,7,Juan Pablo Guzman
2015,104714,2184.213555,3,1,0,2,17,Julian Reister
2004,103521,2184.2135,1,0,0,1,25,Andrea Stoppini
1989,102071,2184.208937,1,0,0,1,18,Robert Janecek
1993,101262,2184.207082,3,1,0,2,34,Rikard Bergh
2004,102545,2184.201271,1,0,0,1,35,Pedro Braga
1987,100596,2184.200074,1,0,0,1,19,Bill Cowan
1997,103176,2184.188268,1,0,0,1,11,David Sanchez
1985,101580,2184.187578,1,0,0,1,5,Roger Rasheed
1997,101890,2184.183053,42,18,0,24,0,Jonathan Stark
2006,105066,2184.182225,1,0,0,1,14,Grzegorz Panfil
2007,102548,2184.175385,1,0,0,1,32,Juan Antonio Marin
2000,102405,2184.166801,1,0,0,1,24,Mahesh Bhupathi
2007,104812,2184.165087,6,2,0,4,12,Scoville Jenkins
1998,102939,2184.155666,6,2,0,4,7,Jean Baptiste Perlant
2010,103782,2184.153018,1,0,0,1,25,Rameez Junaid
1986,100715,2184.15149,3,1,0,2,18,Jim Gurfein
2000,102961,2184.146325,1,0,0,1,23,Nicklas Timfjord
2003,104339,2184.139125,36,15,0,21,3,Mario Ancic
2001,102458,2184.135416,1,0,0,1,7,Jim Thomas
2005,103754,2184.131215,1,0,0,1,20,Mark Hilton
2010,106071,2184.122184,10,4,0,6,9,Bernard Tomic
2009,104717,2184.114273,8,3,0,5,9,Brendan Evans
1999,102139,2184.108213,3,1,0,2,19,Eyal Ran
1992,102378,2184.094196,4,1,0,3,11,Juan Gisbert Jr
2004,102271,2184.093375,34,15,0,19,2,Hicham Arazi
2013,105270,2184.092659,1,0,0,1,26,Maxime Teixeira
2014,104291,2184.090333,19,8,0,11,3,Malek Jaziri
1997,102143,2184.088467,2,0,0,2,5,Nicolas Thomann
2015,105641,2184.084099,10,4,0,6,16,Blaz Rola
1997,102025,2184.081145,40,18,0,22,2,Mikael Tillstrom
1996,102543,2184.077146,3,1,0,2,10,Chia Yen Tsai
2001,101868,2184.071813,1,0,0,1,19,Dick Norman
2015,104944,2184.071555,1,0,0,1,21,Niels Desein
1993,102287,2184.070221,1,0,0,1,17,Albert Portas
2008,104692,2184.067902,1,0,0,1,21,Alexander Slabinsky
1990,101462,2184.059647,14,5,0,9,6,Francisco Roig
1994,101179,2184.059105,40,19,0,21,4,Jean Philippe Fleurian
1985,100935,2184.058336,12,5,0,7,1,Michael Robertson
1988,101329,2184.056944,17,8,0,9,2,Christer Allgardh
1992,108378,2184.05312,1,0,0,1,11,Thierry Van Den Daele
1995,101407,2184.048875,1,0,0,1,21,David Engel
2008,104926,2184.047518,34,16,0,18,3,Fabio Fognini
2003,103925,2184.047013,1,0,0,1,9,Gabriel Moraru
1993,102687,2184.044559,1,0,0,1,18,Herbert Wiltschnig
2004,108908,2184.038104,1,0,0,1,18,Mario Alberto Cayo
2014,104898,2184.032895,41,18,0,23,4,Robin Haase
2000,102755,2184.029398,1,0,0,1,26,Alex Witt
1990,101364,2184.027507,3,1,0,2,19,Bret Garnett
1986,101274,2184.027131,3,1,0,2,15,Udo Riglewski
2013,104627,2184.010247,1,0,0,1,19,Boy Westerhof
1992,102478,2184.00542,1,0,0,1,11,Jorg Schors
2006,103490,2184.004573,3,1,0,2,15,Santiago Ventura
2009,105662,2183.998189,1,0,0,1,11,Tomislav Jotovski
1988,100904,2183.99795,2,0,0,2,20,George Bezecny
1992,102029,2183.994931,2,0,0,2,10,Filip Dewulf
1995,101660,2183.99281,4,1,0,3,18,Francisco Montana
2003,104439,2183.982004,1,0,0,1,3,Vadim Davletshin
2000,102463,2183.98065,1,0,0,1,23,Lucas Arnold Ker
1996,102533,2183.975452,1,0,0,1,18,Jens Knippschild
1996,102220,2183.973644,14,5,0,9,3,Patrik Fredriksson
1994,102263,2183.970531,1,0,0,1,32,Yong Il Yoon
1986,101190,2183.968182,11,5,0,6,8,Darren Cahill
2003,101532,2183.967054,6,2,0,4,16,Francisco Clavet
1998,102577,2183.960293,1,0,0,1,19,Steven Randjelovic
2011,103675,2183.96024,8,3,0,5,11,Diego Junqueira
2006,105030,2183.95137,1,0,0,1,14,Michael Venus
1996,102528,2183.948936,1,0,0,1,11,Carlos Drada
2005,103165,2183.946981,1,0,0,1,18,Gorka Fraile
2006,103534,2183.943566,3,1,0,2,5,Nicolas Devilder
1995,101608,2183.937456,1,0,0,1,24,Tom Kempers
1993,102178,2183.929226,1,0,0,1,18,Scott Gessner
2014,104993,2183.909275,1,0,0,1,24,Martin Vaisse
1993,101563,2183.906309,3,1,0,2,36,Joseph Lizardo
2013,104214,2183.903376,1,0,0,1,22,Igor Andreev
2014,104905,2183.893639,1,0,0,1,17,Nicolas Barrientos
1986,100307,2183.89012,1,0,0,1,15,Paul Torre
2001,103068,2183.889529,1,0,0,1,32,Chemseddine Belal
1999,101462,2183.889516,1,0,0,1,32,Francisco Roig
1996,102473,2183.877471,1,0,0,1,17,Thomas Schiessling
2009,104308,2183.872533,4,1,0,3,11,Michal Przysiezny
2003,103114,2183.863992,1,0,0,1,19,Martin Lee
2002,104126,2183.863607,1,0,0,1,18,Adam Kennedy
2015,106109,2183.860445,1,0,0,1,35,Alex Bolt
1990,107172,2183.84718,1,0,0,1,4,Harald Mair
2010,105558,2183.835922,7,3,0,4,10,Guillaume Rufin
2007,104714,2183.828374,1,0,0,1,3,Julian Reister
1989,100431,2183.826809,8,3,0,5,11,Mansour Bahrami
1985,108295,2183.824151,1,0,0,1,10,Stephan Bienz
1994,102596,2183.816808,1,0,0,1,18,Christian Hill
1988,106650,2183.815117,1,0,0,1,28,Brad Properjohn
2009,104644,2183.814319,1,0,0,1,23,Riccardo Ghedin
1996,102169,2183.8141,41,19,0,22,7,Michael Joyce
1993,101276,2183.812839,33,17,0,16,3,Horacio De La Pena
2006,103808,2183.800891,30,13,0,17,3,Potito Starace
2014,106293,2183.794346,1,0,0,1,21,Kimmer Coppejans
1985,100647,2183.793125,1,0,0,1,10,Kiyotaka Tachibana
1985,101233,2183.785474,5,2,0,3,6,Alex Antonitsch
2012,104963,2183.754554,1,0,0,1,6,Yannick Mertens
2007,103694,2183.752431,46,19,0,27,3,Olivier Rochus
2006,102282,2183.751928,1,0,0,1,6,Tetsuya Chaen
2011,103694,2183.745764,29,13,0,16,6,Olivier Rochus
1995,101270,2183.744067,1,0,0,1,28,Thomas Gollwitzer
2012,104505,2183.742179,3,1,0,2,6,Konstantin Kravchuk
1992,102796,2183.736793,1,0,0,1,5,Magnus Norman
1997,103185,2183.730788,1,0,0,1,14,Mike Bryan
2000,103792,2183.718831,1,0,0,1,8,Joji Miyao
2001,101937,2183.715482,1,0,0,1,10,Robbie Koenig
1996,101030,2183.703677,1,0,0,1,14,Goran Prpic
2002,102023,2183.696579,1,0,0,1,6,Petr Luxa
2000,104188,2183.685646,1,0,0,1,12,Diego Camacho
1990,101143,2183.685392,1,0,0,1,13,Branislav Stankovic
2003,103353,2183.673255,1,0,0,1,15,Ingo Neumuller
2004,102834,2183.66715,10,4,0,6,10,Paul Goldstein
1998,102910,2183.665812,1,0,0,1,31,Salvador Navarro
2006,104807,2183.660602,1,0,0,1,30,Mehdi Ziadi
1985,100639,2183.656643,20,8,0,12,14,Blaine Willenborg
2012,103657,2183.647392,1,0,0,1,21,Ivo Klec
2010,103017,2183.64081,4,1,0,3,24,Nicolas Kiefer
1995,102348,2183.626978,1,0,0,1,7,Hideki Kaneko
1985,101190,2183.617397,23,11,0,12,1,Darren Cahill
2000,103888,2183.609362,7,3,0,4,14,Mardy Fish
1998,102720,2183.608229,1,0,0,1,10,Tomas Zib
2015,106216,2183.60703,2,0,0,2,12,Bjorn Fratangelo
1990,102093,2183.600922,1,0,0,1,12,Martin Damm
2014,103808,2183.598353,3,1,0,2,23,Potito Starace
1992,100972,2183.597867,32,14,0,18,12,Todd Witsken
2008,104334,2183.581097,1,0,0,1,18,Alberto Brizzi
1985,100600,2183.580764,11,5,0,6,27,Pascal Portes
2003,104046,2183.570645,3,1,0,2,17,Bostjan Osabnik
1990,107345,2183.566803,1,0,0,1,26,Jin So Lee
1999,102287,2183.544501,32,14,0,18,7,Albert Portas
2012,105029,2183.528589,1,0,0,1,10,Sergey Betov
1995,101298,2183.528533,1,0,0,1,29,Jonas Svensson
1995,102119,2183.503071,3,1,0,2,10,Chih Jung Chen
1992,100865,2183.496315,3,1,0,2,32,Marcelo Ingaramo
2015,106026,2183.49118,5,2,0,3,11,Yuki Bhambri
1991,100782,2183.490903,19,9,0,10,12,Pablo Arraya
2007,105041,2183.47164,4,1,0,3,9,Lukas Lacko
2006,104225,2183.470155,6,2,0,4,3,Jan Hajek
2002,102558,2183.461755,1,0,0,1,10,Eric Taino
2000,103185,2183.461654,3,1,0,2,16,Mike Bryan
2007,105189,2183.459878,1,0,0,1,3,Pavel Chekhov
2000,102381,2183.451057,3,1,0,2,24,Werner Eschauer
1997,102132,2183.446792,1,0,0,1,27,Ivan Baron
2006,103657,2183.438347,3,1,0,2,27,Ivo Klec
2001,102023,2183.43523,1,0,0,1,10,Petr Luxa
1990,100701,2183.435224,1,0,0,1,16,Marko Ostoja
1999,103306,2183.423682,1,0,0,1,22,Florian Allgauer
1998,101711,2183.411071,23,8,0,15,11,Alex Obrien
1996,108869,2183.407318,1,0,0,1,34,Malcolm Birch
2007,104569,2183.405305,3,1,0,2,35,Lado Chikhladze
1995,101022,2183.398067,1,0,0,1,6,Kelly Jones
1988,101387,2183.390577,29,12,0,17,13,Claudio Pistolesi
2001,103908,2183.367229,2,0,0,2,6,Paul Henri Mathieu
2006,104816,2183.357981,1,0,0,1,7,Karan Rastogi
2010,104007,2183.357067,1,0,0,1,34,Andre Ghem
1988,101114,2183.351473,3,1,0,2,20,Charles Beckman
1991,101888,2183.349594,4,1,0,3,22,Daniel Vacek
2013,104873,2183.3441,5,2,0,3,1,Aleksandr Nedovyesov
2011,104851,2183.329652,3,1,0,2,11,Gianluca Naso
2003,104004,2183.322203,1,0,0,1,18,Filip Prpic
1995,101662,2183.322053,3,1,0,2,8,Selvam Veerasingam
1990,101925,2183.318439,1,0,0,1,10,Massimo Boscatto
2006,103837,2183.316366,1,0,0,1,26,Didac Perez
1990,101452,2183.307936,1,0,0,1,11,Greg Failla
2014,106290,2183.305627,3,1,0,2,14,Filip Peliwo
1987,101237,2183.294838,4,1,0,3,2,Danilo Marcelino
1995,101800,2183.271974,1,0,0,1,17,Daniele Balducci
1995,100676,2183.259564,4,1,0,3,6,Yannick Noah
2014,106045,2183.255591,8,3,0,5,19,Denis Kudla
2013,104548,2183.242349,8,3,0,5,13,Brian Baker
1985,100649,2183.241595,1,0,0,1,21,David Dowlen
1985,100821,2183.239432,4,1,0,3,22,Hans Simonsson
1986,100619,2183.237738,5,2,0,3,25,George Kalovelonis
1999,103225,2183.219428,5,2,0,3,15,Simon Larose
1999,102394,2183.182972,7,3,0,4,29,Johan Van Herck
2007,103248,2183.179587,1,0,0,1,8,Harel Levy
1988,107245,2183.174032,1,0,0,1,20,Ivano Cappelloni
2014,106207,2183.171142,3,1,0,2,21,Mate Pavic
2013,105074,2183.161656,10,4,0,6,6,Ruben Bemelmans
2006,104519,2183.15842,1,0,0,1,18,Roman Vogeli
1985,100928,2183.157865,6,2,0,4,11,Barry Moir
1988,100853,2183.157369,4,1,0,3,14,Dong Wook Song
1993,102226,2183.150363,12,5,0,7,3,David Witt
1992,100800,2183.136377,24,11,0,13,3,Diego Perez
2006,104753,2183.133464,5,2,0,3,8,Woong Sun Jun
1995,101573,2183.130211,1,0,0,1,6,Carl Chang
1993,102234,2183.12153,1,0,0,1,4,Oliver Gross
2009,105906,2183.119295,1,0,0,1,19,Kevin Krawietz
2009,105373,2183.095285,1,0,0,1,17,Martin Klizan
2006,104327,2183.089475,1,0,0,1,17,Steve Darcis
2010,103163,2183.088015,7,3,0,4,41,Tommy Haas
1987,101435,2183.073974,1,0,0,1,11,Brian Gyetko
2007,104330,2183.068884,1,0,0,1,18,Rajeev Ram
1990,101383,2183.067723,1,0,0,1,13,Stephane Sansoni
2013,111456,2183.06668,1,0,0,1,15,Mackenzie Mcdonald
1991,102304,2183.041677,1,0,0,1,8,Grant Doyle
2000,110781,2183.040059,1,0,0,1,20,Vasilly Kazhera
1987,100536,2183.025179,10,4,0,6,15,Fernando Luna
2015,111192,2183.025157,1,0,0,1,6,Lucas Miedler
1999,103958,2183.022117,1,0,0,1,15,Philip Gubenco
2015,106005,2183.021816,1,0,0,1,30,Constant Lestienne
2015,110754,2183.021816,1,0,0,1,30,David Vega Hernandez
1992,100962,2183.020809,13,5,0,8,5,Thomas Hogstedt
2000,102520,2183.019015,1,0,0,1,19,Olivier Malcor
2002,102836,2182.997172,1,0,0,1,18,Rogier Wassen
2002,102143,2182.978558,6,2,0,4,3,Nicolas Thomann
2002,103250,2182.971058,1,0,0,1,20,Rodolphe Cadart
1997,103420,2182.946851,2,0,0,2,5,Michal Tabara
2005,103373,2182.924307,1,0,0,1,16,Sergio Roitman
1985,101511,2182.912801,3,1,0,2,6,Horst Skoff
2015,105643,2182.910888,37,17,0,20,6,Federico Delbonis
1997,102036,2182.909102,1,0,0,1,4,Marco Osorio
1990,101589,2182.901714,6,2,0,4,8,Arnaud Boetsch
2010,104897,2182.876808,3,1,0,2,5,Matthias Bachinger
1999,101746,2182.870236,8,3,0,5,19,Renzo Furlan
2006,103204,2182.854265,4,1,0,3,14,Hugo Armando
2010,103523,2182.846025,6,2,0,4,11,Rohan Bopanna
1999,103894,2182.840928,2,0,0,2,11,Phillip King
1992,100944,2182.833835,4,1,0,3,12,Mikael Pernfors
1997,101311,2182.828991,1,0,0,1,14,Kent Kinnear
2015,105401,2182.827914,1,0,0,1,18,Matteo Trevisan
2009,103598,2182.82203,9,4,0,5,11,Xavier Malisse
1988,106978,2182.81937,1,0,0,1,13,Fabio Di Mauro
2013,104856,2182.805798,3,1,0,2,34,Min Hyoek Cho
1997,101191,2182.77256,38,18,0,20,2,Richey Reneberg
2012,104693,2182.729908,1,0,0,1,9,Dominic Inglot
2005,103454,2182.725111,40,19,0,21,2,Nicolas Massu
1997,102210,2182.701849,1,0,0,1,5,Rene Hanak
1996,102001,2182.699605,1,0,0,1,18,German Lopez
2009,104869,2182.688887,1,0,0,1,11,Sergei Bubka
1988,100736,2182.680918,3,1,0,2,19,Hugo Nunez
2008,103103,2182.677269,14,5,0,9,3,Dominik Hrbaty
2005,104851,2182.656332,1,0,0,1,7,Gianluca Naso
2003,103350,2182.655482,2,0,0,2,6,Denis Golovanov
2006,104898,2182.630629,4,1,0,3,8,Robin Haase
2004,103401,2182.620908,21,9,0,12,3,Jan Hernych
2002,102863,2182.619237,10,4,0,6,6,Takao Suzuki
2002,103118,2182.6102,1,0,0,1,9,Ion Moldovan
2000,103709,2182.601144,8,3,0,5,6,Kristian Pless
2006,103997,2182.600493,13,5,0,8,3,Lukasz Kubot
1994,101190,2182.595286,14,5,0,9,22,Darren Cahill
1992,106493,2182.579089,1,0,0,1,18,Alexander Windisch
1989,101421,2182.575386,15,7,0,8,26,Veli Paloheimo
1994,101871,2182.56621,2,0,0,2,21,Alexander Reichel
2005,102856,2182.563928,16,6,0,10,8,Gustavo Kuerten
1996,101945,2182.55683,6,2,0,4,6,Thierry Guardiola
1986,100932,2182.545576,2,0,0,2,3,Denys Maasdorp
1989,101224,2182.526349,4,1,0,3,14,Kenny Thorne
2010,103999,2182.516702,10,4,0,6,19,Thiago Alves
2001,103451,2182.49294,6,2,0,4,12,Bjorn Phau
2012,106233,2182.473365,3,1,0,2,6,Dominic Thiem
2003,104269,2182.460224,19,7,0,12,4,Fernando Verdasco
1987,108227,2182.448012,1,0,0,1,19,Sebastian Soresini
1988,101890,2182.447463,1,0,0,1,21,Jonathan Stark
1985,101117,2182.428958,5,2,0,3,1,Eric Jelen
1989,101031,2182.425247,14,6,0,8,13,Massimo Cierro
1996,102243,2182.417209,8,3,0,5,3,Marcelo Charpentier
1998,102347,2182.409063,2,0,0,2,9,Dmitri Tomashevich
1985,101389,2182.402589,1,0,0,1,10,Oren Motevassel
1992,101430,2182.39068,1,0,0,1,3,Sergio Cortes
1992,106527,2182.390171,5,2,0,3,8,Andreas Fikas
1990,100819,2182.382677,1,0,0,1,10,Daniel Montes De Oca
2007,104478,2182.36501,1,0,0,1,7,Hyun Woo Nam
2000,101735,2182.358947,38,18,0,20,13,Richard Fromberg
2010,102783,2182.358692,30,13,0,17,5,Rainer Schuettler
1990,100619,2182.346915,1,0,0,1,6,George Kalovelonis
1991,108277,2182.338972,2,0,0,2,10,Srdan Muskatirovic
2003,103711,2182.319761,1,0,0,1,16,Jaroslav Levinsky
1995,101234,2182.310429,11,4,0,7,5,Patrik Kuhnen
2001,103333,2182.3086,1,0,0,1,11,Ivo Karlovic
1988,101278,2182.306891,3,1,0,2,17,Scott Melville
2005,102567,2182.298842,12,5,0,7,3,George Bastl
1996,102881,2182.298255,4,1,0,3,11,David Skoch
1998,101992,2182.282572,1,0,0,1,14,Pietro Angelini
2009,105668,2182.249325,6,2,0,4,11,Jerzy Janowicz
2012,105155,2182.248554,1,0,0,1,31,Pedro Sousa
2004,104372,2182.238373,4,1,0,3,11,Alex Bogdanovic
2011,104453,2182.238275,6,2,0,4,7,Michael Ryderstedt
2005,102538,2182.225907,5,2,0,3,17,Tuomas Ketola
2000,101792,2182.222236,41,17,0,24,7,Slava Dosedel
2002,102655,2182.21754,6,2,0,4,8,Jimy Szymanski
1998,101924,2182.215991,9,3,0,6,10,Stefano Pescosolido
1997,101230,2182.210492,8,3,0,5,38,Andrei Chesnokov
1988,100619,2182.209117,9,4,0,5,14,George Kalovelonis
1989,101503,2182.207411,2,0,0,2,16,Donni Leaycraft
1987,100426,2182.182064,1,0,0,1,20,Hans Peter Kandler
1993,101865,2182.17534,2,0,0,2,10,Albert Chang
2012,104639,2182.16631,10,4,0,6,15,Wayne Odesnik
2003,103498,2182.158319,25,12,0,13,3,Marat Safin
2012,103997,2182.123934,50,23,0,27,4,Lukasz Kubot
1989,101059,2182.123754,2,0,0,2,20,Richard Vogel
1999,101681,2182.116679,4,1,0,3,20,Chris Wilkinson
2008,102860,2182.098,45,22,0,23,3,Agustin Calleri
2006,103737,2182.093588,12,5,0,7,6,Edgardo Massa
2001,103564,2182.06489,1,0,0,1,19,Jakub Herm Zahlava
1985,100988,2182.052357,1,0,0,1,5,Peter Thrupp
1997,101820,2182.050108,66,34,0,32,2,Marc Rosset
2015,106415,2182.034504,8,3,0,5,8,Yoshihito Nishioka
1991,101393,2182.021672,6,2,0,4,8,Jens Woehrmann
1998,103118,2182.017525,4,1,0,3,8,Ion Moldovan
2001,103225,2182.009991,4,1,0,3,16,Simon Larose
2009,105041,2181.994231,8,3,0,5,11,Lukas Lacko
2000,101711,2181.99187,8,3,0,5,3,Alex Obrien
1989,100713,2181.976879,33,15,0,18,3,John Fitzgerald
2015,104233,2181.964099,4,1,0,3,11,Frederik Nielsen
2006,103333,2181.93119,35,17,0,18,9,Ivo Karlovic
1987,106829,2181.927722,1,0,0,1,24,David Betous
2001,103185,2181.90884,4,1,0,3,12,Mike Bryan
1995,102563,2181.862501,4,1,0,3,3,Thomas Johansson
2001,102494,2181.860081,13,5,0,8,7,Tomas Behrend
1989,100894,2181.831074,33,16,0,17,3,Francesco Cancellotti
2008,103999,2181.814446,4,1,0,3,8,Thiago Alves
1991,102026,2181.790767,1,0,0,1,16,Jan Kodes Jr
1989,101746,2181.775451,8,3,0,5,15,Renzo Furlan
2011,104247,2181.773155,2,0,0,2,12,Sebo Kiss
1999,102743,2181.762269,1,0,0,1,13,Ben Ellwood
1994,102184,2181.761597,21,8,0,13,21,David Prinosil
1986,100597,2181.751029,12,5,0,7,3,Jay Lapidus
1987,100905,2181.71274,35,15,0,20,4,Sammy Giammalva Jr
1987,100644,2181.704697,2,0,0,2,12,Alexander Zverev
2002,102730,2181.695795,25,10,0,15,3,Ivo Heuberger
1998,101230,2181.685394,5,2,0,3,22,Andrei Chesnokov
1991,101327,2181.683013,2,0,0,2,12,Cyril Suk
1993,102154,2181.662845,61,31,0,30,3,Marcos Ondruska
1992,100747,2181.64769,6,2,0,4,21,Glenn Layendecker
2009,105166,2181.63774,6,2,0,4,12,Peter Polansky
1993,101490,2181.635642,15,6,0,9,3,Daniel Orsanic
2012,105643,2181.620463,15,6,0,9,6,Federico Delbonis
1998,102227,2181.611266,43,18,0,25,3,Sargis Sargsian
2015,103843,2181.591998,4,1,0,3,5,Marco Chiudinelli
1994,101685,2181.570443,4,1,0,3,29,Markus Naewie
1989,100652,2181.566005,31,14,0,17,2,Cassio Motta
2011,104227,2181.550015,2,0,0,2,13,Augustin Gensse
1994,101780,2181.53465,4,1,0,3,5,Alejo Mancisidor
2007,103835,2181.53296,45,20,0,25,2,Filippo Volandri
1998,102087,2181.529307,8,3,0,5,9,Oleg Ogorodov
2005,102950,2181.503459,8,3,0,5,15,Fernando Vicente
1999,102642,2181.497554,4,1,0,3,2,Cyril Saulnier
2006,103373,2181.491097,10,4,0,6,5,Sergio Roitman
2005,102965,2181.490841,4,1,0,3,14,Jamie Delgado
2006,104468,2181.480314,48,24,0,24,2,Gilles Simon
1986,100651,2181.477252,8,3,0,5,4,Alejandro Ganzabal
2014,105438,2181.471426,5,2,0,3,16,Inigo Cervantes Huegun
2002,102796,2181.451267,31,12,0,19,3,Magnus Norman
1994,101991,2181.448668,26,11,0,15,3,Mauricio Hadad
2008,103454,2181.446312,21,9,0,12,8,Nicolas Massu
1986,101149,2181.425587,2,0,0,2,44,Morten Christensen
1994,101386,2181.422915,1,0,0,1,7,Glenn Wilson
2003,103176,2181.399045,50,23,0,27,3,David Sanchez
2001,101086,2181.363548,4,1,0,3,16,Ronald Agenor
2004,104273,2181.354198,3,1,0,2,7,Edouard Roger Vasselin
1988,101076,2181.350177,5,2,0,3,2,Cesar Kist
1985,108007,2181.348756,6,2,0,4,21,Phillip Tuckniss
1992,102375,2181.348293,5,2,0,3,8,Dinu Pescariu
1989,101131,2181.341879,31,13,0,18,5,Jimmy Brown
2012,105842,2181.336075,6,2,0,4,7,Di Wu
2014,104547,2181.333983,16,7,0,9,16,Horacio Zeballos
1998,102190,2181.325554,2,0,0,2,18,Philippe Moggio
2010,105917,2181.319805,2,0,0,2,27,Gianni Mina
2004,103063,2181.3182,8,3,0,5,10,Sebastien De Chaunac
1991,101851,2181.313383,2,0,0,2,6,Alexis Hombrecher
2011,104665,2181.30977,53,25,0,28,4,Pablo Andujar
2003,102286,2181.308607,9,3,0,6,6,Wayne Black
2004,103581,2181.308378,34,15,0,19,6,Flavio Saretta
1985,100759,2181.29,33,13,0,20,1,Danie Visser
1987,100793,2181.28663,7,3,0,4,19,Stephane Bonneau
2003,102644,2181.283052,35,16,0,19,7,Franco Squillari
1998,102831,2181.247304,16,7,0,9,10,Jacobo Diaz
2004,103821,2181.245888,6,2,0,4,7,Danai Udomchoke
2015,104460,2181.236823,26,10,0,16,10,Dustin Brown
1990,101642,2181.231711,8,3,0,5,1,Bart Wuyts
2007,103339,2181.208864,3,1,0,2,17,Wesley Whitehouse
1986,100620,2181.17986,2,0,0,2,13,Eduardo Osta
1985,100956,2181.154059,4,1,0,3,27,Simone Colombo
2009,103812,2181.153868,60,27,0,33,2,Victor Hanescu
1987,100744,2181.146464,25,11,0,14,4,Peter Doohan
1997,101866,2181.131566,9,3,0,6,7,David Rikl
2011,103582,2181.101715,39,17,0,22,6,Michael Berrer
2011,104068,2181.094849,6,2,0,4,13,Robby Ginepri
1986,101387,2181.090802,19,7,0,12,4,Claudio Pistolesi
1987,101071,2181.076293,20,8,0,12,7,Tom Nijssen
1992,101482,2181.067905,42,17,0,25,3,Markus Zoecke
2005,103821,2181.018553,10,4,0,6,6,Danai Udomchoke
1991,101820,2181.014359,53,21,0,32,3,Marc Rosset
1994,101833,2180.979095,20,9,0,11,3,Michael Tebbutt
2011,104724,2180.97075,10,4,0,6,38,Eduardo Schwank
1994,101810,2180.959493,2,0,0,2,10,Asif Ismail
2008,104999,2180.948802,37,15,0,22,3,Mischa Zverev
2010,105173,2180.939672,6,2,0,4,5,Adrian Mannarino
2014,105147,2180.931173,9,3,0,6,6,Tatsuma Ito
1994,101097,2180.930138,3,1,0,2,6,Rick Leach
2010,105936,2180.916753,8,3,0,5,28,Filip Krajinovic
1992,101932,2180.901452,6,2,0,4,12,Jared Palmer
2001,102538,2180.893264,4,1,0,3,11,Tuomas Ketola
1998,102002,2180.877127,6,2,0,4,14,Davide Scala
2000,101609,2180.87402,4,1,0,3,16,David Wheaton
2013,103835,2180.870119,21,9,0,12,1,Filippo Volandri
1987,100606,2180.864273,4,1,0,3,25,Mike Bauer
1985,100887,2180.845446,4,1,0,3,18,Eric Korita
1987,100598,2180.833143,18,8,0,10,7,Wolfgang Popp
2007,104678,2180.82258,12,5,0,7,5,Viktor Troicki
1994,101680,2180.818413,2,0,0,2,36,Zeeshan Ali
1997,102233,2180.81609,35,15,0,20,7,Leander Paes
1999,102821,2180.805155,34,16,0,18,6,Cecil Mamiit
1994,101515,2180.80212,4,1,0,3,9,Donald Johnson
1989,101172,2180.79999,3,1,0,2,3,Royce Deppe
1986,101106,2180.792705,37,15,0,22,4,Peter Lundgren
2005,103581,2180.789144,10,4,0,6,8,Flavio Saretta
1999,103294,2180.78264,4,1,0,3,9,Christophe Rochus
1996,102571,2180.77685,4,1,0,3,13,Gregory Carraz
1988,101462,2180.770615,8,3,0,5,2,Francisco Roig
2003,103238,2180.769376,2,0,0,2,3,Jean Claude Scherrer
2001,102524,2180.765178,15,7,0,8,7,Neville Godwin
2009,104672,2180.759816,2,0,0,2,2,Vincent Millot
2008,102512,2180.758152,14,6,0,8,6,Joseph Sirianni
1997,103193,2180.757311,2,0,0,2,12,Peter Wessels
2007,105095,2180.752225,44,20,0,24,3,Evgeny Korolev
1986,100570,2180.739415,46,21,0,25,3,Marty Davis
1990,102001,2180.709691,7,3,0,4,3,German Lopez
2006,105229,2180.70355,4,1,0,3,13,Philip Bester
1998,102306,2180.692432,10,4,0,6,2,Michael Kohlmann
1999,102201,2180.690623,6,2,0,4,7,Lionel Roux
2004,104056,2180.68035,2,0,0,2,17,Roko Karanusic
2003,103672,2180.67244,13,5,0,8,9,Ricardo Mello
1994,101142,2180.648585,43,17,0,26,3,Emilio Sanchez
2003,103948,2180.643866,6,2,0,4,10,Maximilian Abel
1997,102023,2180.598191,2,0,0,2,2,Petr Luxa
1986,101119,2180.588657,39,17,0,22,2,Marian Vajda
1994,102368,2180.580942,4,1,0,3,16,Brian Dunn
2008,103580,2180.552711,10,4,0,6,5,Alexander Peya
1987,101412,2180.550647,6,2,0,4,8,Shuzo Matsuoka
1994,102437,2180.545361,6,2,0,4,4,Adrian Voinea
1996,102614,2180.527065,3,1,0,2,27,Victor Sendin
2005,104349,2180.526066,6,2,0,4,8,Rui Machado
2002,102227,2180.521003,32,13,0,19,3,Sargis Sargsian
2004,102227,2180.51672,44,17,0,27,2,Sargis Sargsian
1996,102776,2180.513111,4,1,0,3,21,Andrew Ilie
2005,102780,2180.485376,4,1,0,3,5,Frederic Niemeyer
1996,102018,2180.478456,10,4,0,6,10,Tamer El Sawy
1993,101748,2180.450438,4,1,0,3,21,Ivan Keskinov
1995,101063,2180.43149,36,16,0,20,3,Jordi Arrese
2011,103857,2180.426202,37,16,0,21,3,Igor Kunitsyn
1995,102286,2180.424286,12,5,0,7,3,Wayne Black
2010,104070,2180.420574,2,0,0,2,24,Jesse Witten
1988,101589,2180.4123,4,1,0,3,2,Arnaud Boetsch
2007,108976,2180.398319,2,0,0,2,35,George Chantouria
1992,102010,2180.378864,2,0,0,2,13,Clinton Marsh
2005,102548,2180.377913,8,3,0,5,14,Juan Antonio Marin
1994,100837,2180.373074,36,17,0,19,3,Jeremy Bates
1994,102031,2180.283636,11,4,0,7,8,Sandor Noszaly
1992,101126,2180.279282,30,14,0,16,6,Chris Pridham
1985,101650,2180.258773,3,1,0,2,1,Shane Barr
1992,101321,2180.255035,2,0,0,2,7,Juan Carlos Baguena
2000,103198,2180.223427,4,1,0,3,9,Justin Bower
2002,103184,2180.218783,4,1,0,3,12,Bob Bryan
1985,100411,2180.21622,44,18,0,26,6,Pavel Slozil
1997,102477,2180.203256,17,8,0,9,3,Gaston Etlis
1992,101866,2180.195066,12,5,0,7,7,David Rikl
1994,101892,2180.193542,4,1,0,3,32,Axel Finnberg
1997,102472,2180.183378,18,8,0,10,2,Marcello Craca
1992,101504,2180.154806,4,1,0,3,11,Laurent Prades
1996,102252,2180.145135,10,4,0,6,6,Ignacio Truyol
2003,103530,2180.138132,5,2,0,3,14,Zack Fleishman
2012,104770,2180.111772,4,1,0,3,19,Martin Fischer
1993,106987,2180.081063,6,2,0,4,11,Fadel Berthe
1993,108875,2180.081063,4,1,0,3,11,Abou Berthe
1993,101477,2180.05755,9,3,0,6,10,Chris Bailey
1986,101391,2180.040059,6,2,0,4,4,Carl Uwe Steeb
1996,108585,2180.020838,4,1,0,3,10,Americo Venero Montes
1994,101869,2180.00826,4,1,0,3,6,Juan Luis Tati Rascon
1989,102148,2180.000123,9,3,0,6,6,Fabrice Santoro
2014,104660,2179.994488,38,18,0,20,4,Sergiy Stakhovsky
1990,100747,2179.990178,26,12,0,14,1,Glenn Layendecker
1989,101097,2179.990067,12,4,0,8,8,Rick Leach
1998,102776,2179.983781,28,14,0,14,5,Andrew Ilie
2005,103174,2179.960068,15,6,0,9,8,Noam Okun
1993,102556,2179.934724,4,1,0,3,21,Claude Ngoran
1988,101250,2179.931772,4,1,0,3,5,Jose Daher
2012,105449,2179.904001,8,3,0,5,12,Steve Johnson
1994,101270,2179.90126,4,1,0,3,16,Thomas Gollwitzer
1993,102053,2179.891664,8,3,0,5,16,Brian Macphie
1992,101717,2179.864835,41,19,0,22,6,Diego Nargiso
1997,101358,2179.846729,23,10,0,13,9,Olivier Delaitre
2006,102300,2179.836129,7,3,0,4,6,Gouichi Motomura
2015,111460,2179.823594,2,0,0,2,26,Quentin Halys
1996,101761,2179.81552,4,1,0,3,12,Jaime Oncins
2003,104166,2179.794013,13,5,0,8,6,Alex Bogomolov Jr
1995,101864,2179.791006,4,1,0,3,7,Fernon Wibier
1987,100857,2179.785647,52,23,0,29,2,Sergio Casal
1996,102152,2179.77059,6,2,0,4,3,Pablo Campana
2014,105583,2179.720752,35,16,0,19,3,Dusan Lajovic
2000,102243,2179.718697,4,1,0,3,11,Marcelo Charpentier
1989,101281,2179.708849,4,1,0,3,18,Shelby Cannon
2010,102905,2179.696215,8,3,0,5,24,Stefan Koubek
2001,103102,2179.690113,2,0,0,2,8,John Hui
1987,101589,2179.677843,4,1,0,3,30,Arnaud Boetsch
1993,100713,2179.641018,9,4,0,5,7,John Fitzgerald
2002,103181,2179.640966,6,2,0,4,7,Jiri Vanek
1995,102250,2179.638114,11,5,0,6,10,Emanuel Couto
1996,102770,2179.616111,2,0,0,2,16,John Van Lottum
1997,102910,2179.582644,3,1,0,2,11,Salvador Navarro
1987,100431,2179.567766,12,5,0,7,6,Mansour Bahrami
1995,102437,2179.559204,36,16,0,20,3,Adrian Voinea
1994,102106,2179.544201,2,0,0,2,24,Davide Sanguinetti
1988,101561,2179.54262,2,0,0,2,6,Nicklas Utgren
2015,104547,2179.539791,6,2,0,4,17,Horacio Zeballos
1993,101844,2179.523091,4,1,0,3,9,Heath Denman
2000,101675,2179.521914,12,5,0,7,27,Martin Rodriguez
1992,101061,2179.515397,12,4,0,8,13,Jimmy Arias
1986,101003,2179.491146,2,0,0,2,2,Ricardo Acioly
2002,101964,2179.483841,13,6,0,7,32,Goran Ivanisevic
1994,101865,2179.47788,8,3,0,5,6,Albert Chang
1996,102410,2179.461385,2,0,0,2,12,David Caldwell
1987,101451,2179.459004,2,0,0,2,15,Gustavo Giussani
2003,103047,2179.452445,8,3,0,5,23,Julien Varlet
1993,102062,2179.434275,2,0,0,2,22,Guillaume Marx
1990,101532,2179.412235,26,11,0,15,1,Francisco Clavet
1987,100884,2179.406967,13,5,0,8,11,Steve Shaw
2004,102821,2179.360368,4,1,0,3,34,Cecil Mamiit
1988,101112,2179.346108,2,0,0,2,20,Michele Fioroni
1996,102103,2179.335429,2,0,0,2,27,Michael Sell
2013,104970,2179.317547,11,4,0,7,9,Matteo Viola
1985,100474,2179.315512,22,11,0,11,5,Chris Lewis NZL
2005,103153,2179.314873,4,1,0,3,10,Gilles Elseneer
1995,102133,2179.298267,6,2,0,4,12,Laurence Tieleman
1988,101355,2179.295806,2,0,0,2,23,Richard Whichello
2008,104209,2179.292795,2,0,0,2,25,Rainer Eitzinger
2000,102629,2179.284402,4,1,0,3,23,Oscar Burrieza
1990,101110,2179.272686,2,0,0,2,24,David De Miguel
1994,101711,2179.257008,41,17,0,24,6,Alex Obrien
2015,105147,2179.243876,20,8,0,12,6,Tatsuma Ito
2011,105583,2179.239983,8,3,0,5,6,Dusan Lajovic
2003,104126,2179.228183,2,0,0,2,14,Adam Kennedy
2013,105032,2179.207448,4,1,0,3,10,Samuel Groth
1989,101668,2179.202647,4,1,0,3,5,Peter Nyborg
1994,102113,2179.160705,2,0,0,2,12,Daniele Musa
1993,102110,2179.160332,7,2,0,5,5,Daniel Nestor
1988,101279,2179.148853,6,2,0,4,28,Philippe Pech
2012,103999,2179.120643,3,1,0,2,0,Thiago Alves
2000,103216,2179.112999,2,0,0,2,11,Clemens Trimmel
1992,101416,2179.098146,15,7,0,8,3,Joao Cunha Silva
1995,101890,2179.091229,42,18,0,24,3,Jonathan Stark
2013,105585,2179.077935,6,2,0,4,7,Ze Zhang
2002,101746,2179.07384,4,1,0,3,15,Renzo Furlan
2007,103936,2179.073711,2,0,0,2,19,Todor Enev
1989,101149,2179.069331,4,1,0,3,22,Morten Christensen
1987,100934,2179.059778,38,16,0,22,3,Matt Anger
2013,106432,2179.05767,2,0,0,2,11,Borna Coric
1998,101265,2179.053878,3,1,0,2,13,Patrick Mcenroe
1985,100342,2179.028777,27,12,0,15,9,Vitas Gerulaitis
2008,103823,2179.024024,35,15,0,20,3,Denis Gremelmayr
1999,102652,2179.018382,6,2,0,4,19,Christian Vinck
2014,106000,2179.016776,12,5,0,7,9,Damir Dzumhur
2003,104259,2179.006058,4,1,0,3,10,Philipp Kohlschreiber
1994,102536,2179.001668,4,1,0,3,10,James Greenhalgh
1995,102650,2178.998134,10,4,0,6,14,Roberto Carretero
2003,103228,2178.992746,4,1,0,3,9,Marcos Daniel
2004,103171,2178.971112,42,19,0,23,3,Raemon Sluiter
1989,100848,2178.964379,4,1,0,3,31,Alberto Tous
2010,104010,2178.957197,2,0,0,2,27,Dieter Kindlmann
1989,101358,2178.953722,24,10,0,14,11,Olivier Delaitre
1995,101819,2178.936922,2,0,0,2,25,Frederic Vitoux
2003,102800,2178.917385,4,1,0,3,15,Nenad Zimonjic
2006,102563,2178.915497,29,11,0,18,2,Thomas Johansson
2009,103181,2178.9081,2,0,0,2,26,Jiri Vanek
1987,107918,2178.897566,2,0,0,2,22,Panomkorn Pladchunil
1990,100744,2178.871798,2,0,0,2,7,Peter Doohan
1986,100517,2178.870173,4,1,0,3,17,Matt Doyle
1991,101440,2178.860587,45,20,0,25,3,Mark Koevermans
1993,101902,2178.841823,4,1,0,3,13,Stephane Huet
2010,104620,2178.837286,19,7,0,12,11,Simone Bolelli
2011,104660,2178.837187,52,25,0,27,3,Sergiy Stakhovsky
1986,101264,2178.833216,6,2,0,4,8,Michael Tauson
2006,102202,2178.819939,33,15,0,18,6,Kenneth Carlsen
2008,104330,2178.817579,6,2,0,4,15,Rajeev Ram
1991,101659,2178.809137,4,1,0,3,7,Jan Apell
1999,103319,2178.790638,2,0,0,2,11,Jeff Morrison
1988,101145,2178.782597,6,2,0,4,35,Jonathan Canter
2013,104997,2178.776082,45,20,0,25,3,Igor Sijsling
2014,105733,2178.748645,6,2,0,4,31,Rhyne Williams
1985,100913,2178.717914,10,4,0,6,1,Peter Carlsson
2006,103516,2178.717162,6,2,0,4,9,Nathan Healey
1991,100990,2178.715158,5,2,0,3,35,Milan Srejber
1993,102344,2178.682683,4,1,0,3,26,Karol Kucera
1999,102473,2178.681701,2,0,0,2,8,Thomas Schiessling
2013,106378,2178.670997,4,1,0,3,22,Kyle Edmund
2015,105655,2178.662654,4,1,0,3,9,Hiroki Moriya
1994,101567,2178.651616,4,1,0,3,17,Hendrik Jan Davids
1991,101126,2178.649238,8,3,0,5,7,Chris Pridham
2011,103602,2178.617297,8,3,0,5,12,Fernando Gonzalez
2008,103808,2178.612253,44,19,0,25,3,Potito Starace
2008,102780,2178.589179,6,2,0,4,12,Frederic Niemeyer
1996,101937,2178.586083,4,1,0,3,20,Robbie Koenig
1996,108686,2178.582196,2,0,0,2,10,Alejandro Aramburu Acuna
2001,102730,2178.579389,15,6,0,9,7,Ivo Heuberger
2009,104926,2178.572377,46,20,0,26,5,Fabio Fognini
2015,106291,2178.552552,2,0,0,2,22,Luke Saville
1992,102187,2178.551033,2,0,0,2,22,John Laffnie De Jager
1996,101826,2178.541673,2,0,0,2,3,Alex Lopez Moron
1999,103171,2178.536174,2,0,0,2,15,Raemon Sluiter
1993,100962,2178.525722,2,0,0,2,3,Thomas Hogstedt
2015,103997,2178.5058,4,1,0,3,7,Lukasz Kubot
1988,100908,2178.498145,17,7,0,10,3,Tobias Svantesson
1988,100982,2178.497027,2,0,0,2,30,Charlton Eagle
1987,100852,2178.466911,4,1,0,3,18,Howard Herr
1996,103017,2178.4364,13,5,0,8,5,Nicolas Kiefer
2013,104571,2178.383786,37,15,0,22,5,Marcos Baghdatis
2011,103163,2178.376529,19,7,0,12,4,Tommy Haas
2010,103694,2178.370319,39,16,0,23,5,Olivier Rochus
2011,105449,2178.369895,2,0,0,2,13,Steve Johnson
2003,103153,2178.369123,6,2,0,4,3,Gilles Elseneer
1987,108189,2178.366285,2,0,0,2,22,Ruslon Rainov
2009,103693,2178.343763,4,1,0,3,2,Thierry Ascione
2006,103864,2178.325516,2,0,0,2,16,Mohamed Mamoun
1985,100273,2178.311765,4,1,0,3,4,Kim Warwick
2012,104978,2178.309359,13,5,0,8,6,Daniel Brands
1987,101285,2178.308999,17,6,0,11,6,Thierry Champion
1987,100871,2178.293988,8,3,0,5,21,Laurie Warder
1988,100985,2178.290517,6,2,0,4,8,Tim Pawsat
2012,105077,2178.274541,56,26,0,30,3,Albert Ramos
1997,101389,2178.265475,2,0,0,2,11,Oren Motevassel
1995,102169,2178.25151,29,13,0,16,3,Michael Joyce
1990,101792,2178.248092,4,1,0,3,6,Slava Dosedel
1997,101334,2178.246343,22,10,0,12,2,Alexander Volkov
2006,103110,2178.225758,42,18,0,24,2,Daniele Bracciali
2006,104864,2178.222637,2,0,0,2,10,Alex Kuznetsov
2000,102269,2178.218347,4,1,0,3,8,Jeff Salzenstein
1999,102167,2178.212773,4,1,0,3,7,Juan Albert Viloca Puig
1995,101311,2178.209854,4,1,0,3,15,Kent Kinnear
2013,104499,2178.195835,4,1,0,3,20,Jimmy Wang
2010,104594,2178.194619,4,1,0,3,38,Marinko Matosevic
2005,103663,2178.185037,2,0,0,2,29,Matias Boeker
1993,107382,2178.16659,2,0,0,2,11,John Farrington
1998,101969,2178.145033,6,2,0,4,10,Orlin Stanoytchev
1987,101793,2178.125515,2,0,0,2,3,Jim Courier
2000,102029,2178.124591,8,3,0,5,20,Filip Dewulf
2003,104019,2178.121836,15,6,0,9,3,Kristof Vliegen
2011,105173,2178.114824,40,17,0,23,3,Adrian Mannarino
2008,103520,2178.107806,2,0,0,2,5,Pavel Snobel
1992,101327,2178.107545,2,0,0,2,15,Cyril Suk
2009,104025,2178.10298,8,3,0,5,22,Amer Delic
2015,105077,2178.0936,39,16,0,23,6,Albert Ramos
2002,103157,2178.070254,6,2,0,4,8,Arvind Parmar
1986,101378,2178.066916,13,5,0,8,14,Tore Meinecke
1998,102184,2178.055494,46,21,0,25,2,David Prinosil
2009,105147,2178.055198,4,1,0,3,8,Tatsuma Ito
1990,101613,2178.04028,29,13,0,16,4,Malivai Washington
2010,104311,2178.021817,4,1,0,3,31,Leonardo Tavares
1987,100998,2178.018358,2,0,0,2,4,Stuart Bale
2000,103990,2178.018133,2,0,0,2,6,Tommy Robredo
1994,102024,2178.013354,6,2,0,4,3,Hernan Gumy
1998,101833,2178.004207,27,12,0,15,7,Michael Tebbutt
2015,104890,2178.002347,48,22,0,26,6,Andreas Haider Maurer
2010,105668,2177.998191,4,1,0,3,11,Jerzy Janowicz
2001,102869,2177.996657,43,20,0,23,3,Galo Blanco
2011,104589,2177.984846,4,1,0,3,17,Chris Guccione
2005,103487,2177.980566,8,3,0,5,31,Federico Luzzi
1999,103285,2177.979977,6,2,0,4,24,Radek Stepanek
2014,106353,2177.975669,2,0,0,2,4,Pedja Krstin
2006,102630,2177.960892,6,2,0,4,16,Slimane Saoudi
1997,102135,2177.94339,34,15,0,19,2,Emilio Benfele Alvarez
1986,100797,2177.934214,19,8,0,11,3,Ben Testerman
2003,102538,2177.925718,4,1,0,3,6,Tuomas Ketola
2003,101924,2177.908814,2,0,0,2,5,Stefano Pescosolido
1993,102005,2177.906871,2,0,0,2,3,Johan De Beer
1992,101242,2177.902606,4,1,0,3,18,Brad Pearce
2000,102756,2177.875947,4,1,0,3,9,Eduardo Rincon
1989,101150,2177.847732,18,7,0,11,9,Gianluca Pozzi
2013,104768,2177.841892,2,0,0,2,11,Juho Paukku
2014,106299,2177.81565,2,0,0,2,9,Bar Tzuf Botzer
2003,104117,2177.810856,8,3,0,5,8,Giovanni Lapentti
1988,100544,2177.80949,10,4,0,6,14,Tony Mmoh
2004,102854,2177.780529,39,19,0,20,4,Sjeng Schalken
1989,101725,2177.772722,4,1,0,3,15,Gabriel Markus
1994,101864,2177.723489,6,2,0,4,11,Fernon Wibier
2014,104494,2177.720618,6,2,0,4,9,Adrian Ungur
1994,101332,2177.720006,9,3,0,6,7,Gilad Bloom
1993,101233,2177.716543,35,16,0,19,3,Alex Antonitsch
1991,100935,2177.713956,2,0,0,2,28,Michael Robertson
1998,103145,2177.713452,4,1,0,3,9,Amir Hadad
1993,101086,2177.700708,44,19,0,25,7,Ronald Agenor
1994,102450,2177.699149,8,3,0,5,14,Tim Henman
2010,103451,2177.682395,22,9,0,13,5,Bjorn Phau
2009,104868,2177.672392,4,1,0,3,23,James Ward
1992,101341,2177.670284,4,1,0,3,4,Pablo Albano
2006,102035,2177.659174,32,13,0,19,2,Jonas Bjorkman
1985,100286,2177.640528,10,4,0,6,10,Harold Solomon
2011,104810,2177.615837,2,0,0,2,8,Zhe Li
1986,107845,2177.607508,4,1,0,3,26,Necvet Demir
1997,101214,2177.606512,10,4,0,6,18,Bryan Shelton
1997,101924,2177.59801,2,0,0,2,26,Stefano Pescosolido
1997,102234,2177.589597,17,7,0,10,2,Oliver Gross
2013,104332,2177.584428,8,3,0,5,13,Philipp Petzschner
2002,102703,2177.564195,27,12,0,15,7,Hyung Taik Lee
2007,105023,2177.553024,41,19,0,22,2,Sam Querrey
1988,100282,2177.552395,26,11,0,15,20,Guillermo Vilas
1988,100609,2177.529959,2,0,0,2,11,Zoltan Kuharszky
1986,100930,2177.515171,2,0,0,2,12,Paul Vojtischek
1988,100759,2177.508261,22,9,0,13,3,Danie Visser
2002,102571,2177.496935,7,2,0,5,5,Gregory Carraz
1998,103176,2177.496425,2,0,0,2,22,David Sanchez
1988,100928,2177.48687,23,10,0,13,3,Barry Moir
1998,102903,2177.464958,4,1,0,3,11,Eyal Erlich
1985,100364,2177.461477,2,0,0,2,6,Jonathan Smith
2000,103758,2177.452015,10,3,0,7,8,Taylor Dent
1988,100587,2177.43359,11,4,0,7,9,Steve Guy
1989,101282,2177.431295,6,2,0,4,19,Martin Barba
2013,104655,2177.428675,6,2,0,4,8,Pablo Cuevas
2003,103523,2177.42675,6,2,0,4,8,Rohan Bopanna
1995,101893,2177.413707,2,0,0,2,21,Patrick Mohr
1989,101108,2177.383784,2,0,0,2,16,Richard Schmidt
2014,103566,2177.356265,10,4,0,6,10,Michael Llodra
2009,104797,2177.355258,34,16,0,18,5,Denis Istomin
1998,102139,2177.338838,4,1,0,3,10,Eyal Ran
2002,103637,2177.296105,2,0,0,2,17,Marcelo Amador
1995,101004,2177.290503,2,0,0,2,15,Jim Pugh
1988,100837,2177.278011,35,15,0,20,3,Jeremy Bates
1991,101783,2177.258052,6,2,0,4,10,Mark Petchey
1986,101076,2177.254903,8,3,0,5,2,Cesar Kist
2013,105614,2177.245309,4,1,0,3,13,Bradley Klahn
1992,101354,2177.24121,4,1,0,3,12,Andrew Sznajder
2008,105095,2177.232107,30,13,0,17,3,Evgeny Korolev
2009,103451,2177.219881,29,12,0,17,5,Bjorn Phau
2005,104035,2177.209372,13,5,0,8,10,Bobby Reynolds
1999,101750,2177.195216,4,1,0,3,11,Cristiano Caratti
1995,102685,2177.184711,2,0,0,2,20,Sebastien Graeff
2012,103714,2177.180766,2,0,0,2,11,Andreas Vinciguerra
1994,101150,2177.176324,29,11,0,18,7,Gianluca Pozzi
2009,105453,2177.166934,10,4,0,6,37,Kei Nishikori
2011,105147,2177.164826,8,3,0,5,9,Tatsuma Ito
1998,102966,2177.157402,2,0,0,2,2,Fredrik Jonsson
1993,101124,2177.152912,11,4,0,7,7,Paolo Cane
1985,100964,2177.13629,2,0,0,2,23,Jon Levine
2005,103632,2177.129193,41,17,0,24,5,Luis Horna
1988,101392,2177.113282,6,2,0,4,3,Dan Goldberg
2006,103752,2177.113077,27,11,0,16,3,Simon Greul
2005,103716,2177.112027,6,2,0,4,7,Uros Vico
2014,111577,2177.086182,2,0,0,2,10,Jared Donaldson
1993,100284,2177.070328,8,3,0,5,28,Jimmy Connors
2000,103162,2177.058293,6,2,0,4,23,Dejan Petrovic
2002,103694,2177.056713,42,20,0,22,2,Olivier Rochus
1988,101242,2177.055489,2,0,0,2,12,Brad Pearce
1997,102629,2177.037093,2,0,0,2,21,Oscar Burrieza
1988,101085,2177.035427,2,0,0,2,32,Corrado Aprili
1985,100764,2177.028893,14,5,0,9,6,Gabriel Urpi
1985,100705,2177.026929,2,0,0,2,6,Erik Vant Hof
1986,101320,2177.023012,2,0,0,2,5,Magnus Gustafsson
1997,102722,2177.021618,4,1,0,3,10,Attila Savolt
1988,101008,2177.0184,4,1,0,3,9,Peter Palandjian
2003,102855,2177.016829,2,0,0,2,28,Jack Brasington
1994,108816,2177.015522,4,1,0,3,10,Isaac Donkor
1992,101552,2177.005547,10,4,0,6,6,Xavier Daufresne
1988,108844,2177.003986,2,0,0,2,23,Hamed Ul Haq
1996,103031,2176.997664,2,0,0,2,23,Julian Alonso
2006,103817,2176.995226,6,2,0,4,8,Yu Jr Wang
2013,104864,2176.990802,6,2,0,4,17,Alex Kuznetsov
2013,106234,2176.982262,2,0,0,2,6,Aslan Karatsev
1986,100713,2176.966414,20,8,0,12,6,John Fitzgerald
1992,101374,2176.965017,28,11,0,17,12,Leonardo Lavalle
2000,102694,2176.960812,7,2,0,5,6,Lars Burgsmuller
2015,105497,2176.955697,4,1,0,3,11,Jose Hernandez
2001,101750,2176.953519,4,1,0,3,12,Cristiano Caratti
2010,105077,2176.948586,6,2,0,4,4,Albert Ramos
1998,103188,2176.940349,2,0,0,2,11,Michael Russell
2003,104508,2176.932199,2,0,0,2,10,Robert Yim
2001,102669,2176.929461,10,4,0,6,7,Noam Behr
1988,101035,2176.928446,24,11,0,13,2,Menno Oosting
1988,101368,2176.923741,22,9,0,13,5,Christian Miniussi
2009,103521,2176.908675,2,0,0,2,41,Andrea Stoppini
2006,105238,2176.90779,2,0,0,2,8,Alexandr Dolgopolov
1997,101459,2176.907657,18,7,0,11,4,Tomas Nydahl
1997,102863,2176.90115,4,1,0,3,31,Takao Suzuki
1988,106695,2176.881559,6,2,0,4,23,Carlos Claverie
1992,100713,2176.878621,21,10,0,11,6,John Fitzgerald
2002,103898,2176.873217,2,0,0,2,5,Julien Benneteau
2014,104460,2176.87138,29,13,0,16,4,Dustin Brown
2008,104433,2176.850613,17,6,0,11,10,Frank Dancevic
2013,103694,2176.809635,7,2,0,5,22,Olivier Rochus
2003,104056,2176.809605,2,0,0,2,10,Roko Karanusic
1986,100556,2176.804855,4,1,0,3,8,Brian Levine
2002,102192,2176.80269,4,1,0,3,17,Luis Adrian Morejon
1996,102753,2176.775702,2,0,0,2,25,Wolfgang Schranz
1994,101265,2176.767166,41,19,0,22,8,Patrick Mcenroe
1997,102743,2176.762958,6,2,0,4,18,Ben Ellwood
2014,104424,2176.753328,6,2,0,4,6,Go Soeda
2003,102776,2176.748468,2,0,0,2,14,Andrew Ilie
2010,105011,2176.733542,40,18,0,22,2,Illya Marchenko
2003,103820,2176.732343,2,0,0,2,19,Alan Mackin
1987,100982,2176.726953,4,1,0,3,11,Charlton Eagle
2015,104665,2176.72606,40,17,0,23,12,Pablo Andujar
2000,101532,2176.72435,59,29,0,30,5,Francisco Clavet
2009,106071,2176.712837,4,1,0,3,26,Bernard Tomic
2009,104305,2176.705218,2,0,0,2,11,Luka Gregorc
1989,101180,2176.690061,6,2,0,4,13,Jose Clavet
1987,100917,2176.68667,2,0,0,2,35,Nelson Aerts
1995,102113,2176.683699,6,2,0,4,12,Daniele Musa
2002,103350,2176.680261,2,0,0,2,6,Denis Golovanov
1989,101392,2176.679872,2,0,0,2,20,Dan Goldberg
1987,101281,2176.675525,2,0,0,2,16,Shelby Cannon
1987,100452,2176.672104,32,16,0,16,16,Bill Scanlon
1990,101179,2176.662112,52,23,0,29,1,Jean Philippe Fleurian
2004,102539,2176.645475,30,11,0,19,3,Bohdan Ulihrach
2014,103908,2176.644893,28,11,0,17,4,Paul Henri Mathieu
1996,103029,2176.633628,2,0,0,2,10,Mehdi Tahiri
1989,108182,2176.609155,2,0,0,2,22,Ruben Alvarenga
2007,104179,2176.593844,2,0,0,2,12,Bruno Echagaray
1986,100790,2176.588865,11,4,0,7,8,Bruce Derlin
2011,103835,2176.58686,32,13,0,19,11,Filippo Volandri
2015,107098,2176.578693,2,0,0,2,19,Gilles Kremer
1988,101440,2176.562174,2,0,0,2,15,Mark Koevermans
2014,105065,2176.559275,19,7,0,12,10,Tim Smyczek
2012,105707,2176.556497,2,0,0,2,11,Nicolaas Scholtz
1999,102585,2176.52989,2,0,0,2,29,Sebastian Prieto
1992,101490,2176.509966,2,0,0,2,25,Daniel Orsanic
2015,104534,2176.508977,18,8,0,10,12,Dudi Sela
2005,103823,2176.506939,4,1,0,3,6,Denis Gremelmayr
1996,102271,2176.494769,31,14,0,17,6,Hicham Arazi
2009,103535,2176.482068,2,0,0,2,37,Olivier Patience
2008,103594,2176.469242,2,0,0,2,25,Oliver Marach
2007,103672,2176.464156,10,4,0,6,9,Ricardo Mello
1988,101074,2176.463772,4,1,0,3,32,Carlos Di Laura
2010,104559,2176.444372,27,10,0,17,4,Teymuraz Gabashvili
2015,105357,2176.441664,14,5,0,9,6,John Millman
1995,100870,2176.441643,2,0,0,2,34,Christo Van Rensburg
1989,102001,2176.437496,4,1,0,3,13,German Lopez
1991,102235,2176.43099,6,2,0,4,12,Tommy Ho
2012,104332,2176.421345,28,11,0,17,7,Philipp Petzschner
1990,101953,2176.418862,2,0,0,2,5,Kentaro Masuda
2013,104735,2176.414492,39,17,0,22,5,Tobias Kamke
1996,101120,2176.413654,4,1,0,3,32,Karel Novacek
1989,100785,2176.408938,2,0,0,2,20,Jesus Colas
1998,101191,2176.400552,26,11,0,15,5,Richey Reneberg
2012,105733,2176.395581,2,0,0,2,12,Rhyne Williams
1995,101600,2176.392022,2,0,0,2,4,Daniel Courcol
1990,100944,2176.372492,10,4,0,6,3,Mikael Pernfors
2009,105216,2176.37114,2,0,0,2,16,Yuichi Sugita
1993,101802,2176.368134,6,2,0,4,10,Ramayah Ramachandran
1996,102214,2176.362231,4,1,0,3,17,Oscar Ortiz
1989,101342,2176.35392,2,0,0,2,13,Patrick Galbraith
2002,103817,2176.343479,6,2,0,4,8,Yu Jr Wang
1989,101901,2176.336965,2,0,0,2,16,Chuck Adams
2002,101843,2176.329941,4,1,0,3,28,Sergi Bruguera
1988,101147,2176.329283,33,15,0,18,3,Claudio Mezzadri
1995,101594,2176.32722,20,9,0,11,8,Carsten Arriens
1987,111108,2176.321689,2,0,0,2,28,Kaya Saydas
1995,102205,2176.317997,35,15,0,20,6,Sebastien Lareau
1986,100954,2176.306791,16,7,0,9,2,Luiz Mattar
2013,104676,2176.306443,2,0,0,2,21,Andreas Beck
1997,102323,2176.304287,2,0,0,2,7,Regis Lavergne
2003,102306,2176.283736,2,0,0,2,27,Michael Kohlmann
1988,101613,2176.279304,4,1,0,3,3,Malivai Washington
1992,101214,2176.2558,43,19,0,24,6,Bryan Shelton
1985,100489,2176.252194,26,11,0,15,6,Larry Stefanki
1986,101242,2176.242136,15,6,0,9,2,Brad Pearce
1995,102694,2176.241244,4,1,0,3,22,Lars Burgsmuller
1998,101826,2176.234326,6,2,0,4,10,Alex Lopez Moron
2015,105063,2176.224515,4,1,0,3,18,Andrea Arnaboldi
2013,104779,2176.19804,2,0,0,2,25,Jamie Baker
2010,104043,2176.191257,2,0,0,2,9,Marc Lopez
2014,105554,2176.185979,10,4,0,6,19,Daniel Evans
2004,103429,2176.177628,8,3,0,5,10,Peter Luczak
2003,102965,2176.177022,2,0,0,2,19,Jamie Delgado
1992,102053,2176.175786,6,2,0,4,20,Brian Macphie
1993,101382,2176.144026,44,17,0,27,3,Marcelo Filippini
2008,103543,2176.129526,6,2,0,4,18,David Marrero
1997,102377,2176.1292,2,0,0,2,10,Reza Nakhai
1998,102135,2176.124862,19,7,0,12,10,Emilio Benfele Alvarez
1996,102348,2176.102664,6,2,0,4,32,Hideki Kaneko
1985,107097,2176.100644,6,2,0,4,20,Gilles Ganancia
1995,101027,2176.094629,2,0,0,2,7,Jaroslav Bulant
2001,103182,2176.083972,34,16,0,18,3,Markus Hipfl
2000,102538,2176.083073,10,4,0,6,4,Tuomas Ketola
1990,100728,2176.079234,2,0,0,2,6,Todd Nelson
2010,103908,2176.070857,29,10,0,19,3,Paul Henri Mathieu
1992,102198,2176.065077,2,0,0,2,9,Paul Kilderry
1991,101093,2176.051007,4,1,0,3,6,Steve Devries
1994,102375,2176.047171,4,1,0,3,23,Dinu Pescariu
1999,103298,2176.044345,2,0,0,2,9,Piotr Szczepanik
2008,103188,2176.041288,8,3,0,5,35,Michael Russell
2011,105585,2176.032559,5,1,0,4,8,Ze Zhang
1989,108500,2175.999204,2,0,0,2,4,Warren Green
2011,104122,2175.998759,38,15,0,23,6,Carlos Berlocq
1998,103714,2175.971417,2,0,0,2,2,Andreas Vinciguerra
1988,107894,2175.971324,2,0,0,2,20,Omar Urbinati
2010,105790,2175.966198,6,2,0,4,11,Yong Kyu Lim
1996,102284,2175.962909,4,1,0,3,15,Filippo Messori
1995,102135,2175.961471,9,3,0,6,8,Emilio Benfele Alvarez
2007,102456,2175.96064,4,1,0,3,18,Felix Mantilla
2007,103487,2175.960112,6,2,0,4,18,Federico Luzzi
2015,105554,2175.953961,2,0,0,2,11,Daniel Evans
1988,101053,2175.947205,10,4,0,6,3,Michael Kures
2000,101463,2175.943984,2,0,0,2,21,Bernd Karbacher
2015,109739,2175.943747,2,0,0,2,6,Maximilian Marterer
1990,100772,2175.943022,38,15,0,23,5,Kelly Evernden
2006,103029,2175.934322,6,2,0,4,8,Mehdi Tahiri
2002,104372,2175.930816,2,0,0,2,19,Alex Bogdanovic
2006,102227,2175.927528,2,0,0,2,33,Sargis Sargsian
1988,101427,2175.911937,2,0,0,2,13,Ruben Gajardo
1985,107478,2175.907592,2,0,0,2,43,Kaoru Maruyama
2014,104198,2175.90585,51,25,0,26,2,Guillermo Garcia Lopez
1991,107310,2175.903309,6,2,0,4,11,Jean Nabi
1995,101362,2175.896894,2,0,0,2,22,Stephane Simian
1985,100536,2175.896575,24,10,0,14,13,Fernando Luna
2006,104593,2175.886249,6,2,0,4,14,Daniel Gimeno Traver
2001,102904,2175.879905,2,0,0,2,3,Leos Friedl
1985,101179,2175.872681,2,0,0,2,14,Jean Philippe Fleurian
2005,104559,2175.869197,6,2,0,4,3,Teymuraz Gabashvili
2000,101382,2175.867159,2,0,0,2,19,Marcelo Filippini
2008,103748,2175.862985,2,0,0,2,10,Jan Minar
1986,108431,2175.855163,2,0,0,2,32,Tony Jonsson
1986,111008,2175.855163,2,0,0,2,32,John Erik Rustad
2009,105454,2175.852014,6,2,0,4,24,Brydan Klein
2002,103505,2175.844776,2,0,0,2,16,Vasilis Mazarakis
1987,101606,2175.82825,7,2,0,5,3,Alberto Mancini
1993,100870,2175.828151,29,12,0,17,3,Christo Van Rensburg
1992,100946,2175.822479,2,0,0,2,40,Slobodan Zivojinovic
2008,104445,2175.820534,2,0,0,2,26,Jose Antonio Sanchez De Luna
2002,103420,2175.817439,11,4,0,7,22,Michal Tabara
1993,101026,2175.810719,15,6,0,9,34,Jim Grabb
1988,101742,2175.809278,2,0,0,2,6,Johan Sandberg
2011,102905,2175.805457,2,0,0,2,38,Stefan Koubek
1986,101077,2175.801622,2,0,0,2,33,Bobby Blair
1987,100728,2175.792534,21,9,0,12,6,Todd Nelson
1997,102730,2175.779851,7,2,0,5,7,Ivo Heuberger
2003,102358,2175.774159,39,13,0,26,3,Thomas Enqvist
2007,104219,2175.768093,2,0,0,2,41,Stephane Bohli
2014,105703,2175.762902,2,0,0,2,9,Jesus Bandres
2015,106423,2175.760162,32,13,0,19,6,Thanasi Kokkinakis
2013,106426,2175.744229,6,2,0,4,11,Christian Garin
1991,101701,2175.683333,2,0,0,2,34,Bing Pan
1989,101550,2175.674382,2,0,0,2,19,Al Parker
1996,101901,2175.656896,12,5,0,7,12,Chuck Adams
2007,103592,2175.633225,2,0,0,2,3,Jerome Haehnel
2014,104471,2175.629539,38,15,0,23,3,Ivan Dodig
2013,104035,2175.624907,6,2,0,4,14,Bobby Reynolds
1987,101318,2175.624016,16,6,0,10,3,Javier Frana
1987,101093,2175.602602,2,0,0,2,7,Steve Devries
1993,101701,2175.598494,2,0,0,2,6,Bing Pan
1985,100426,2175.597951,4,1,0,3,6,Hans Peter Kandler
1995,102050,2175.588985,2,0,0,2,9,Marco Meneschincheri
1998,102905,2175.588567,9,3,0,6,9,Stefan Koubek
1994,101459,2175.585856,22,10,0,12,6,Tomas Nydahl
1995,102368,2175.585771,4,1,0,3,39,Brian Dunn
2002,102880,2175.584394,17,8,0,9,10,Alexander Popp
1986,100998,2175.581925,2,0,0,2,24,Stuart Bale
1994,102162,2175.568704,2,0,0,2,33,Chris Woodruff
2006,104070,2175.568087,2,0,0,2,10,Jesse Witten
1989,101242,2175.56805,9,3,0,6,18,Brad Pearce
1986,101112,2175.567053,2,0,0,2,12,Michele Fioroni
1995,101862,2175.555556,6,2,0,4,10,Maurice Ruah
1987,100691,2175.551639,6,2,0,4,20,Ivo Werner
1991,101080,2175.54639,2,0,0,2,35,Lawson Duncan
1994,102652,2175.531457,2,0,0,2,23,Christian Vinck
1995,101138,2175.519074,12,5,0,7,22,Pat Cash
1985,100900,2175.501734,2,0,0,2,32,Josef Cihak
1986,100611,2175.494319,28,12,0,16,3,Mel Purcell
1987,100855,2175.492224,38,18,0,20,3,Scott Davis
2010,104550,2175.490361,4,1,0,3,34,Ricardo Hocevar
1987,101265,2175.483967,2,0,0,2,13,Patrick Mcenroe
1996,102650,2175.483908,25,11,0,14,8,Roberto Carretero
2001,101855,2175.482675,4,1,0,3,18,Emmanuel Heussner
1996,101630,2175.474227,4,1,0,3,19,Clement Ngoran
2002,102538,2175.456798,7,2,0,5,3,Tuomas Ketola
2004,104025,2175.442166,7,2,0,5,10,Amer Delic
1996,101224,2175.421932,2,0,0,2,20,Kenny Thorne
1986,100866,2175.420264,17,6,0,11,3,Shahar Perkiss
1999,102205,2175.403751,31,13,0,18,6,Sebastien Lareau
2009,104349,2175.396424,8,3,0,5,12,Rui Machado
2006,104372,2175.393636,9,3,0,6,7,Alex Bogdanovic
2006,104182,2175.386846,2,0,0,2,22,Sasa Tuksar
2005,103401,2175.385851,41,18,0,23,3,Jan Hernych
1989,108332,2175.371011,2,0,0,2,22,Suharyadi Suharyadi
2012,103722,2175.35803,13,5,0,8,10,Florent Serra
1989,101178,2175.353949,32,13,0,19,3,Pieter Aldrich
1989,100792,2175.352304,2,0,0,2,37,Adrian Marcu
2004,102780,2175.348855,6,2,0,4,13,Frederic Niemeyer
2004,108637,2175.348703,2,0,0,2,38,Nomi Qamar
1987,101250,2175.348219,4,1,0,3,2,Jose Daher
1990,101048,2175.344137,2,0,0,2,13,Francisco Maciel
1989,101329,2175.341958,10,4,0,6,17,Christer Allgardh
1993,100876,2175.332204,2,0,0,2,7,Bong Soo Kim
1995,102434,2175.319462,49,21,0,28,3,Vincent Spadea
1994,101354,2175.311566,2,0,0,2,40,Andrew Sznajder
1990,102026,2175.31105,4,1,0,3,5,Jan Kodes Jr
2001,101889,2175.31048,10,4,0,6,8,Todd Woodbridge
1998,101730,2175.302356,2,0,0,2,9,Piet Norval
1985,100802,2175.299879,2,0,0,2,21,Charles Honey
2011,104919,2175.293124,11,4,0,7,26,Leonardo Mayer
2001,103420,2175.284972,40,20,0,20,3,Michal Tabara
1992,100943,2175.282684,7,2,0,5,3,Girts Dzelde
2000,101897,2175.281704,40,16,0,24,11,Fernando Meligeni
1986,100686,2175.280281,2,0,0,2,8,Karl Richter
2005,103967,2175.274723,4,1,0,3,3,Michael Lammer
1995,101681,2175.272183,12,5,0,7,7,Chris Wilkinson
2012,105585,2175.269229,9,3,0,6,7,Ze Zhang
2009,103747,2175.265843,2,0,0,2,20,Dominik Meffert
1989,101325,2175.249076,2,0,0,2,27,Jason Goodall
1989,101344,2175.245465,25,11,0,14,5,Bruno Oresar
2015,108779,2175.214845,2,0,0,2,19,Jacob Rasolondrazana
2011,105554,2175.209791,2,0,0,2,24,Daniel Evans
2011,103188,2175.209345,30,12,0,18,13,Michael Russell
1999,103857,2175.206464,2,0,0,2,2,Igor Kunitsyn
1997,101788,2175.175127,25,11,0,14,14,Doug Flach
1990,101965,2175.165233,7,2,0,5,5,Wayne Ferreira
1986,100390,2175.154245,2,0,0,2,23,Trevor Allan
2007,103516,2175.151812,6,2,0,4,17,Nathan Healey
1995,102362,2175.14998,6,2,0,4,10,Amro Ghoneim
2008,104056,2175.149577,20,8,0,12,5,Roko Karanusic
1996,101932,2175.133895,11,4,0,7,12,Jared Palmer
1988,100669,2175.131557,4,1,0,3,49,Charles Bud Cox
2009,104673,2175.129643,2,0,0,2,11,Julio Cesar Campozano
1991,101312,2175.123446,13,5,0,8,7,Robbie Weiss
1986,106531,2175.120817,4,1,0,3,22,Andrei Dirzu
2004,103560,2175.116885,4,1,0,3,11,KJ Hippensteel
1987,107366,2175.103828,2,0,0,2,28,Johan De Preter
1993,101584,2175.098631,4,1,0,3,19,Keith Evans
2001,102615,2175.096161,2,0,0,2,19,Dennis Van Scheppingen
1986,106442,2175.094017,2,0,0,2,38,Abdul Khalek Nadini
1987,108179,2175.094017,2,0,0,2,46,Rotimi Akinloye
1988,107485,2175.094017,2,0,0,2,39,Ke Qin Ma
1988,110828,2175.094017,4,1,0,3,34,Wai Yaw Liu
1988,110980,2175.094017,2,0,0,2,34,Melvin Pereira
1991,109480,2175.094017,4,1,0,3,25,Alex Roman
1992,110814,2175.094017,4,1,0,3,35,Gavaskar Williams
1993,107826,2175.094017,4,1,0,3,36,Mohammed Khalid
1994,101554,2175.094017,4,1,0,3,19,Mark Markov
1995,108836,2175.094017,4,1,0,3,35,Jayendra Wijeyesekera
1997,102362,2175.094017,4,1,0,3,19,Amro Ghoneim
1998,102362,2175.094017,4,1,0,3,18,Amro Ghoneim
2002,103155,2175.094017,2,0,0,2,17,Ivo Bratanov
2003,104421,2175.094017,4,1,0,3,31,Martin Vilarrubi
2004,102496,2175.094017,4,1,0,3,31,Scott Willinsky
2011,105009,2175.094017,2,0,0,2,21,Elbert Sie
2014,108749,2175.094017,4,1,0,3,32,Sergis Kyratzis
2015,134886,2175.094017,4,1,0,3,19,Sharmal Dissanayake
2005,103709,2175.093511,2,0,0,2,7,Kristian Pless
2002,102652,2175.092658,2,0,0,2,24,Christian Vinck
2008,108618,2175.090878,4,1,0,3,31,Karim Alayli
2001,102623,2175.089592,2,0,0,2,9,Thomas Larsen
2002,104557,2175.081497,4,1,0,3,17,Andis Juska
2004,104557,2175.081497,4,1,0,3,18,Andis Juska
1989,100282,2175.070251,6,2,0,4,31,Guillermo Vilas
2015,105888,2175.063031,2,0,0,2,18,Toni Androic
2004,108920,2175.059428,2,0,0,2,8,Federico Rodriguez
2002,104379,2175.058836,2,0,0,2,20,Todd Reid
1989,100853,2175.047967,4,1,0,3,22,Dong Wook Song
1996,101485,2175.046592,6,2,0,4,8,Tanakorn Srichaphan
1994,100284,2175.043819,4,1,0,3,31,Jimmy Connors
2009,104067,2175.042603,4,1,0,3,21,Goran Tosic
1990,101283,2175.042536,2,0,0,2,22,Dirk Leppen
1989,106442,2175.041763,2,0,0,2,22,Abdul Khalek Nadini
1991,107382,2175.041763,6,2,0,4,20,John Farrington
1989,101155,2175.03794,2,0,0,2,26,James Turner
1996,102301,2175.032841,2,0,0,2,13,Sebastien Leblanc
2013,104620,2175.016539,14,6,0,8,22,Simone Bolelli
1998,101783,2175.01073,2,0,0,2,20,Mark Petchey
1994,101590,2175.008668,4,1,0,3,28,Eui Jong Chang
2007,105453,2175.008226,8,3,0,5,7,Kei Nishikori
1992,102192,2175.002255,2,0,0,2,44,Luis Adrian Morejon
1996,101062,2174.995362,18,7,0,11,7,Mats Wilander
1991,101866,2174.983815,4,1,0,3,7,David Rikl
2003,104842,2174.981263,4,1,0,3,17,Salifu Mohammed
1996,101510,2174.974473,6,2,0,4,36,Henrik Holm
1998,102862,2174.974047,4,1,0,3,31,Allen Belobrajdic
1999,103441,2174.969943,2,0,0,2,28,Nikola Gnjatovic
1992,101740,2174.963596,2,0,0,2,4,Sascha Nensel
2014,104656,2174.958049,4,1,0,3,9,Haydn Lewis
2006,103505,2174.955722,2,0,0,2,32,Vasilis Mazarakis
1995,101086,2174.951731,24,10,0,14,6,Ronald Agenor
2008,104095,2174.942817,2,0,0,2,3,David Guez
2006,104272,2174.938018,2,0,0,2,17,Torsten Popp
1994,102076,2174.93484,2,0,0,2,12,Mark Merklein
1989,101436,2174.93199,4,1,0,3,37,George Cosac
2014,105030,2174.925171,2,0,0,2,16,Michael Venus
1992,100857,2174.922147,2,0,0,2,13,Sergio Casal
2009,103926,2174.917417,2,0,0,2,20,Daniel Munoz De La Nava
2000,102165,2174.917204,2,0,0,2,20,Srinath Prahlad
2000,103468,2174.917204,2,0,0,2,20,Harsh Mankad
1988,100896,2174.914963,2,0,0,2,17,Miguel Nido
2010,104789,2174.908063,4,1,0,3,22,Sherif Sabry
1997,101833,2174.897954,17,6,0,11,2,Michael Tebbutt
1988,101429,2174.894481,2,0,0,2,22,Stephane Grenier
2001,102558,2174.886205,2,0,0,2,7,Eric Taino
2013,103594,2174.882326,2,0,0,2,11,Oliver Marach
2004,103252,2174.875067,49,23,0,26,3,Alberto Martin
2007,104095,2174.870328,2,0,0,2,7,David Guez
2002,103506,2174.867639,2,0,0,2,18,Martin Vassallo Arguello
1988,101249,2174.867364,14,6,0,8,8,Andrei Olhovskiy
2015,104897,2174.865103,6,2,0,4,25,Matthias Bachinger
1990,101341,2174.856765,2,0,0,2,8,Pablo Albano
1991,102029,2174.854756,2,0,0,2,50,Filip Dewulf
1987,107560,2174.851509,4,1,0,3,28,Leeh Bienkowski
1999,102457,2174.849207,2,0,0,2,10,Miles Maclagan
2004,104914,2174.829617,2,0,0,2,3,Ervin Eleskovic
2011,104505,2174.826796,2,0,0,2,7,Konstantin Kravchuk
2012,104864,2174.803826,2,0,0,2,20,Alex Kuznetsov
1985,100486,2174.799525,2,0,0,2,28,Christophe Roger Vasselin
2014,105853,2174.789069,4,1,0,3,9,Tigre Hank
1992,102167,2174.785637,4,1,0,3,17,Juan Albert Viloca Puig
2001,102201,2174.781239,2,0,0,2,39,Lionel Roux
2005,104951,2174.775816,2,0,0,2,7,Aljoscha Thron
2013,104919,2174.771489,32,13,0,19,10,Leonardo Mayer
2014,103893,2174.769692,25,11,0,14,4,Paolo Lorenzi
1986,100899,2174.763045,15,6,0,9,5,Jorgen Windahl
1986,107228,2174.762692,2,0,0,2,9,Igor Flego
1986,101416,2174.760028,4,1,0,3,26,Joao Cunha Silva
1992,100282,2174.753377,2,0,0,2,11,Guillermo Vilas
1986,107895,2174.739855,2,0,0,2,44,Orlando Agudelo
1992,101937,2174.731464,6,2,0,4,6,Robbie Koenig
1999,103240,2174.721349,2,0,0,2,11,Kevin Kim
1991,100939,2174.718069,2,0,0,2,22,Joey Rive
1992,101901,2174.710992,24,9,0,15,3,Chuck Adams
2002,102234,2174.710449,6,2,0,4,7,Oliver Gross
2010,104586,2174.708934,2,0,0,2,13,Lukas Rosol
1996,102790,2174.701975,2,0,0,2,43,Yu Zheng
1985,101105,2174.700006,2,0,0,2,12,Jose Antonio Fernandez
1990,101238,2174.691748,2,0,0,2,30,Andres Vysand
1998,102405,2174.663323,7,2,0,5,6,Mahesh Bhupathi
1991,100714,2174.661533,2,0,0,2,23,Broderick Dyke
2008,104166,2174.62957,2,0,0,2,11,Alex Bogomolov Jr
2010,104076,2174.629016,4,1,0,3,44,Jose Acasuso
1991,101641,2174.62668,2,0,0,2,50,Jose Luis Noriega
2010,102821,2174.626249,6,2,0,4,11,Cecil Mamiit
1991,100865,2174.625001,2,0,0,2,17,Marcelo Ingaramo
2005,103761,2174.623314,4,1,0,3,5,Tomas Cakl
1989,108836,2174.606704,2,0,0,2,28,Jayendra Wijeyesekera
1990,101601,2174.604262,4,1,0,3,7,Brett Steven
2004,104593,2174.597615,2,0,0,2,7,Daniel Gimeno Traver
2013,103529,2174.593221,4,1,0,3,34,Aisam Ul Haq Qureshi
1992,101671,2174.590453,2,0,0,2,29,Dede Suhendar Dinata
1996,102215,2174.590288,2,0,0,2,7,Joshua Eagle
2000,102689,2174.578287,2,0,0,2,43,Martin Spottl
1985,100535,2174.573071,2,0,0,2,24,Tony Giammalva
2008,104717,2174.572101,6,2,0,4,6,Brendan Evans
1989,101581,2174.57183,8,3,0,5,5,Jose Luis Aparisi
1989,110141,2174.571302,2,0,0,2,43,Chang Rung Wu
2003,103125,2174.571302,4,1,0,3,17,Joan Jimenez Guerra
2007,108927,2174.571302,4,1,0,3,35,Edgar Hernandez Perez
2013,104863,2174.571302,4,1,0,3,34,Olivier Sajous
2013,105541,2174.571302,4,1,0,3,34,Alex Llompart
2013,108747,2174.571302,4,1,0,3,34,Dineshkanthan Thangarajah
2015,104763,2174.571302,2,0,0,2,19,Rafael Arevalo
1989,107960,2174.568657,2,0,0,2,37,Pedro Cordeiro
1985,107629,2174.566883,4,1,0,3,31,Manuel Tolentino
1999,103875,2174.566584,2,0,0,2,31,Anoosha Shahgholi
2005,108927,2174.566584,2,0,0,2,17,Edgar Hernandez Perez
2009,103860,2174.566584,2,0,0,2,21,Timo Nieminen
2009,104336,2174.566584,2,0,0,2,21,Gvidas Sabeckis
2010,105334,2174.566584,2,0,0,2,11,Luis David Martinez
2015,105606,2174.566584,2,0,0,2,19,Mohsen Hossein Zade
1990,101407,2174.559035,23,10,0,13,3,David Engel
1987,100899,2174.554995,11,4,0,7,6,Jorgen Windahl
1989,101761,2174.553977,2,0,0,2,41,Jaime Oncins
2006,105016,2174.552606,2,0,0,2,30,Serguei Tarasevitch
2001,103162,2174.550148,2,0,0,2,22,Dejan Petrovic
1989,106441,2174.543081,2,0,0,2,53,Abdul Kahar Mim
2002,103077,2174.541554,2,0,0,2,19,Konstantinos Economidis
2000,103082,2174.540516,40,19,0,21,2,Markus Hantschk
1999,101955,2174.539371,2,0,0,2,9,Luis Herrera
2002,103015,2174.53866,2,0,0,2,9,Daniel Melo
1989,101103,2174.536331,4,1,0,3,37,Miguel Dungo
2011,101404,2174.529559,2,0,0,2,6,Thomas Muster
2008,105070,2174.528923,2,0,0,2,31,Hans Podlipnik Castillo
1995,108214,2174.526374,2,0,0,2,35,Scott Clark
2006,104914,2174.52608,2,0,0,2,5,Ervin Eleskovic
2005,102785,2174.514237,6,2,0,4,10,Glenn Weiner
2003,103699,2174.502762,2,0,0,2,16,Fred Hemmes
1989,100620,2174.496655,2,0,0,2,38,Eduardo Osta
1987,100624,2174.491021,6,2,0,4,21,Derek Tarr
2010,104035,2174.489671,2,0,0,2,38,Bobby Reynolds
2002,108641,2174.486259,2,0,0,2,8,Fredrik Aarum
2005,103385,2174.486198,2,0,0,2,39,Paul Baccanello
2000,102234,2174.483076,2,0,0,2,32,Oliver Gross
1991,100944,2174.478928,11,4,0,7,13,Mikael Pernfors
2012,104268,2174.478458,39,14,0,25,3,Alejandro Falla
2013,105077,2174.472552,43,20,0,23,6,Albert Ramos
1999,101613,2174.468362,2,0,0,2,14,Malivai Washington
2010,105099,2174.454206,6,2,0,4,18,Antonio Veic
2005,104251,2174.451842,2,0,0,2,7,Ti Chen
2002,102466,2174.45077,2,0,0,2,14,Jan Kroslak
2000,101703,2174.44567,2,0,0,2,27,Guillaume Raoux
2001,102250,2174.44183,4,1,0,3,32,Emanuel Couto
1991,102055,2174.434654,4,1,0,3,12,Bertrand Madsen
1996,101311,2174.424635,2,0,0,2,14,Kent Kinnear
1997,101719,2174.41754,8,3,0,5,4,Frederic Fontang
2010,105111,2174.414445,2,0,0,2,11,Ivan Endara
1997,102013,2174.408627,2,0,0,2,19,Blaz Trupej
1988,101556,2174.396592,2,0,0,2,10,Carl Turich
2009,103976,2174.394813,2,0,0,2,12,Juan Pablo Brzezicki
2005,103470,2174.392231,2,0,0,2,36,Robert Kendrick
1990,101783,2174.391905,4,1,0,3,17,Mark Petchey
2008,104173,2174.390039,9,3,0,6,10,Sam Warburg
2012,104004,2174.387863,2,0,0,2,42,Filip Prpic
2001,103789,2174.384481,11,4,0,7,3,Irakli Labadze
1987,100592,2174.381579,2,0,0,2,38,Robert Vant Hof
1997,102300,2174.376006,4,1,0,3,19,Gouichi Motomura
2013,105095,2174.372075,6,2,0,4,20,Evgeny Korolev
1985,100526,2174.37047,2,0,0,2,20,Ricardo Ycaza
1986,100660,2174.366197,30,14,0,16,8,Bob Green
2006,102143,2174.357769,2,0,0,2,3,Nicolas Thomann
2003,102243,2174.351395,2,0,0,2,36,Marcelo Charpentier
2001,103393,2174.341074,2,0,0,2,17,Yuri Schukin
2013,105137,2174.338533,2,0,0,2,26,Pere Riba
1996,101468,2174.334626,5,1,0,4,3,Gerard Solves
2008,105575,2174.330352,2,0,0,2,18,Ricardas Berankis
2008,104140,2174.327632,4,1,0,3,20,Dawid Olejniczak
1995,102208,2174.29971,2,0,0,2,15,Rob Givone
1994,101563,2174.28913,2,0,0,2,36,Joseph Lizardo
1994,101781,2174.28913,2,0,0,2,36,Robert Angelo
2015,104619,2174.286354,3,0,0,3,11,Jesse Huta Galung
1991,101703,2174.283148,39,14,0,25,3,Guillaume Raoux
1986,101481,2174.276016,2,0,0,2,12,Omar Camporese
2002,102076,2174.274848,4,1,0,3,8,Mark Merklein
2008,104043,2174.271852,4,1,0,3,19,Marc Lopez
2005,101965,2174.266748,2,0,0,2,34,Wayne Ferreira
2006,104154,2174.265223,19,8,0,11,14,Paul Capdeville
1991,101890,2174.264063,4,1,0,3,15,Jonathan Stark
1988,100719,2174.26361,7,2,0,5,13,Juan Avendano
1989,101384,2174.256373,2,0,0,2,17,Marco Filippeschi
2003,104025,2174.252535,4,1,0,3,10,Amer Delic
2007,104233,2174.251758,4,1,0,3,19,Frederik Nielsen
1993,102378,2174.248812,9,3,0,6,9,Juan Gisbert Jr
2012,104291,2174.244019,17,6,0,11,6,Malek Jaziri
1998,102251,2174.241057,4,1,0,3,2,Mariano Hood
2015,105137,2174.231761,2,0,0,2,6,Pere Riba
2007,103976,2174.22559,6,2,0,4,16,Juan Pablo Brzezicki
1986,101377,2174.220825,11,4,0,7,5,Christian Bergstrom
2011,104620,2174.220028,14,5,0,9,10,Simone Bolelli
2007,104515,2174.212212,6,2,0,4,7,Mathieu Montcourt
1988,110833,2174.20921,4,1,0,3,34,Huang Jung Hsu
2002,103053,2174.207702,2,0,0,2,31,Nikos Rovas
2011,105283,2174.203114,2,0,0,2,33,Gerard Granollers
2008,104268,2174.19838,19,8,0,11,13,Alejandro Falla
1994,101327,2174.184197,2,0,0,2,23,Cyril Suk
1986,101150,2174.183747,2,0,0,2,17,Gianluca Pozzi
1986,101014,2174.181352,2,0,0,2,19,John Ross
2003,103499,2174.176734,4,1,0,3,8,Aqeel Khan
1998,107481,2174.174357,2,0,0,2,18,Karl Hale
1988,101050,2174.170583,21,8,0,13,6,Martin Laurendeau
1992,106941,2174.163302,4,1,0,3,29,Eno Polo
1990,101165,2174.162622,4,1,0,3,20,Mario Tabares
1997,102881,2174.14853,4,1,0,3,31,David Skoch
2009,105331,2174.148092,2,0,0,2,5,Petru Alexandru Luncanu
2006,104025,2174.146847,4,1,0,3,17,Amer Delic
1989,100945,2174.144226,2,0,0,2,16,Craig Campbell
1998,102743,2174.141192,4,1,0,3,13,Ben Ellwood
1999,101939,2174.138682,4,1,0,3,18,Erhan Oral
1999,102918,2174.138682,4,1,0,3,18,Efe Ustundag
1988,101448,2174.13697,4,1,0,3,23,Tasos Bavelas
2007,103228,2174.117984,2,0,0,2,26,Marcos Daniel
1997,102444,2174.110605,4,1,0,3,19,Scott Barron
1986,100524,2174.107964,2,0,0,2,9,Shozo Shiraishi
2014,104557,2174.104366,2,0,0,2,9,Andis Juska
2007,102998,2174.096167,2,0,0,2,34,Jan Michael Gambill
2015,106034,2174.090509,2,0,0,2,8,Yasutaka Uchiyama
2015,106362,2174.088476,2,0,0,2,40,Laurent Lokoli
1998,108373,2174.081947,2,0,0,2,18,Thierno Ly
2006,103395,2174.081398,2,0,0,2,22,Julio Silva
2001,101733,2174.076461,33,16,0,17,9,Jan Siemerink
2002,104311,2174.073637,2,0,0,2,8,Leonardo Tavares
2003,102768,2174.067334,13,5,0,8,6,Federico Browne
1987,100931,2174.058778,2,0,0,2,16,Andrew Burrow
2000,100943,2174.056379,2,0,0,2,20,Girts Dzelde
1987,100530,2174.050386,30,12,0,18,6,Andreas Maurer
1994,101940,2174.048588,4,1,0,3,19,Rene Busch
1996,108836,2174.048588,4,1,0,3,34,Jayendra Wijeyesekera
1997,108751,2174.048588,4,1,0,3,33,Bader Mohammed Almuqail
1998,102055,2174.048588,4,1,0,3,18,Bertrand Madsen
2001,102537,2174.048588,2,0,0,2,33,Melvin Tong
2004,108603,2174.048588,2,0,0,2,18,Helge Koll Frafjord
2006,103413,2174.048588,4,1,0,3,16,Genius Chidzikwe
2012,108982,2174.048588,2,0,0,2,35,Yasir Khan
1985,110930,2174.047008,4,1,0,3,26,Ferenc Zentai
1986,108332,2174.047008,2,0,0,2,32,Suharyadi Suharyadi
1986,108373,2174.047008,2,0,0,2,44,Thierno Ly
1987,110783,2174.047008,2,0,0,2,44,Yassine Amier
1988,110786,2174.047008,4,1,0,3,34,Antoine Beugre
1988,110945,2174.047008,2,0,0,2,34,Jacques Vincileoni
1989,100648,2174.047008,2,0,0,2,37,Sadiq Abdullahi
1989,101577,2174.047008,2,0,0,2,43,Jia Ping Xia
1989,110890,2174.047008,2,0,0,2,28,Lionel Kemajou
1991,107537,2174.047008,2,0,0,2,42,Kyrian Nwokedi
1991,108827,2174.047008,2,0,0,2,25,Mike Amoah
1991,110817,2174.047008,4,1,0,3,25,Ifthekar Sardar
1991,110818,2174.047008,4,1,0,3,25,Shovon Jamaly
1992,100711,2174.047008,2,0,0,2,35,Pedro Rebolledo
1992,101074,2174.047008,2,0,0,2,35,Carlos Di Laura
1992,102362,2174.047008,4,1,0,3,19,Amro Ghoneim
1992,106506,2174.047008,2,0,0,2,19,Alkis Papamichael
1992,108872,2174.047008,4,1,0,3,35,Yang Tat Lim
1992,110831,2174.047008,4,1,0,3,35,Dishan Herath
1993,108811,2174.047008,2,0,0,2,21,Christophe Boggetti
1994,102668,2174.047008,2,0,0,2,19,Tapio Nurminen
1995,102068,2174.047008,4,1,0,3,35,Omer Rashid
1995,108800,2174.047008,2,0,0,2,35,Alexander Lehnhoff
1997,108812,2174.047008,4,1,0,3,33,Jose Baires
1997,108872,2174.047008,2,0,0,2,33,Yang Tat Lim
2000,103499,2174.047008,2,0,0,2,37,Aqeel Khan
2000,108588,2174.047008,2,0,0,2,37,Asim Shafik
2003,103722,2174.047008,2,0,0,2,14,Florent Serra
2005,105208,2174.047008,2,0,0,2,17,Ernests Gulbis
2006,104996,2174.047008,2,0,0,2,30,Alexander Blom
2006,108939,2174.047008,2,0,0,2,30,Rasid Winklaar
2012,105579,2174.047008,4,1,0,3,35,Kittipong Wachiramanowong
2012,106000,2174.047008,2,0,0,2,35,Damir Dzumhur
2013,104887,2174.047008,2,0,0,2,34,Piero Luisi
2014,118053,2174.047008,4,1,0,3,28,Ognian Kolev
2014,126223,2174.047008,2,0,0,2,32,Abdulhameed Alshatti
2014,144776,2174.047008,2,0,0,2,32,Christophe Tholl
2015,104656,2174.047008,2,0,0,2,11,Haydn Lewis
2015,145016,2174.047008,2,0,0,2,19,Julian Saborio
1987,101407,2174.041725,2,0,0,2,10,David Engel
1989,101256,2174.036876,25,11,0,14,10,Mark Kratzmann
1998,102286,2174.031681,45,18,0,27,2,Wayne Black
2001,102405,2174.029105,2,0,0,2,33,Mahesh Bhupathi
1994,108864,2174.028326,2,0,0,2,19,Sergei Baranov
2012,105030,2174.028245,2,0,0,2,42,Michael Venus
2002,101888,2174.026757,2,0,0,2,40,Daniel Vacek
2000,103225,2174.026696,4,1,0,3,18,Simon Larose
2008,108945,2174.026636,4,1,0,3,31,Juan Sebastian Langton
1987,106509,2174.013108,2,0,0,2,46,Alvaro Garron
1987,110841,2174.013108,2,0,0,2,46,Hervoje Eterovic
2004,108612,2174.009846,2,0,0,2,31,Sergei Cuptov
1999,102154,2174.005004,2,0,0,2,35,Marcos Ondruska
2012,108786,2174.000723,2,0,0,2,35,Seanon Williams
1999,101507,2173.977064,2,0,0,2,24,Tomas Carbonell
2001,102434,2173.975574,4,1,0,3,14,Vincent Spadea
2014,104768,2173.970363,2,0,0,2,32,Juho Paukku
1996,103103,2173.959769,2,0,0,2,10,Dominik Hrbaty
1994,102018,2173.955441,2,0,0,2,12,Tamer El Sawy
1986,101318,2173.942178,4,1,0,3,2,Javier Frana
1986,101507,2173.940546,4,1,0,3,13,Tomas Carbonell
1993,101234,2173.938937,35,13,0,22,3,Patrik Kuhnen
1990,100595,2173.931546,2,0,0,2,16,Ronnie Bathman
2008,105101,2173.931219,2,0,0,2,38,Blazej Koniusz
1991,101145,2173.924066,2,0,0,2,36,Jonathan Canter
1995,108469,2173.921148,2,0,0,2,35,Victor Caldarelli
2005,103393,2173.916861,2,0,0,2,6,Yuri Schukin
1999,103318,2173.916696,2,0,0,2,9,Zeljko Krajan
2011,103566,2173.912716,39,17,0,22,3,Michael Llodra
2011,105487,2173.909991,2,0,0,2,41,Facundo Bagnis
2001,103256,2173.909167,2,0,0,2,9,Ivan Vajda
1998,103715,2173.905648,2,0,0,2,9,Kirill Ivanov Smolensky
1990,100790,2173.904116,8,3,0,5,14,Bruce Derlin
2008,103166,2173.896852,2,0,0,2,17,Vladimir Voltchkov
1990,101543,2173.89346,28,11,0,17,4,Jeff Tarango
2009,105217,2173.892469,9,3,0,6,11,Thiemo De Bakker
1989,101920,2173.887436,2,0,0,2,12,Jamie Morgan
1997,101711,2173.884653,50,22,0,28,2,Alex Obrien
1986,100596,2173.880954,2,0,0,2,8,Bill Cowan
1994,101937,2173.880311,2,0,0,2,18,Robbie Koenig
1986,108814,2173.879721,2,0,0,2,26,Konstantinos Effraimoglou
1999,102756,2173.878583,2,0,0,2,34,Eduardo Rincon
2008,104179,2173.868866,2,0,0,2,35,Bruno Echagaray
1990,100876,2173.864928,2,0,0,2,25,Bong Soo Kim
1995,101459,2173.860481,2,0,0,2,33,Tomas Nydahl
2012,104471,2173.855502,42,16,0,26,5,Ivan Dodig
2010,108735,2173.833366,2,0,0,2,22,Rares Cuzdriorean
1994,101775,2173.831769,5,1,0,4,10,Frederik Fetterlein
1988,100993,2173.830807,2,0,0,2,22,Loic Courteau
2000,102023,2173.828567,2,0,0,2,43,Petr Luxa
1991,101321,2173.825824,2,0,0,2,8,Juan Carlos Baguena
1994,108809,2173.814024,2,0,0,2,30,Karim Zaher
1994,108810,2173.814024,2,0,0,2,30,Khaled El Salawy
1986,100871,2173.810551,2,0,0,2,3,Laurie Warder
1989,101504,2173.809361,2,0,0,2,25,Laurent Prades
2002,102851,2173.80739,4,1,0,3,22,Giorgio Galimberti
1989,101924,2173.801515,7,2,0,5,13,Stefano Pescosolido
2000,103151,2173.79443,48,19,0,29,4,Mariano Zabaleta
2011,105539,2173.781479,2,0,0,2,7,Evgeny Donskoy
2004,102382,2173.765083,9,3,0,6,5,Julian Knowle
1994,102882,2173.764839,4,1,0,3,8,Mark Philippoussis
1987,101506,2173.752768,2,0,0,2,28,Eoin Collins
1998,102668,2173.751659,2,0,0,2,28,Tapio Nurminen
1998,102623,2173.74916,4,1,0,3,9,Thomas Larsen
1996,102536,2173.739305,2,0,0,2,10,James Greenhalgh
2001,103229,2173.73385,2,0,0,2,18,Kornel Bardoczky
1994,101722,2173.731294,4,1,0,3,28,Han Cheol Shin
2004,103700,2173.710991,4,1,0,3,17,Juan Pablo Guzman
1991,101479,2173.710791,2,0,0,2,8,TJ Middleton
1989,101632,2173.705126,2,0,0,2,9,Per Henricsson
1999,102422,2173.699969,4,1,0,3,19,Michael Hill
2012,104068,2173.696127,6,2,0,4,12,Robby Ginepri
1998,102180,2173.679281,4,1,0,3,10,Charles Auffray
2009,103582,2173.676834,13,5,0,8,4,Michael Berrer
2003,103535,2173.662154,2,0,0,2,27,Olivier Patience
1995,108603,2173.661817,4,1,0,3,10,Helge Koll Frafjord
2011,104932,2173.661539,2,0,0,2,11,Kenny De Schepper
2003,103506,2173.658447,2,0,0,2,6,Martin Vassallo Arguello
2006,103188,2173.654347,2,0,0,2,10,Michael Russell
1993,101597,2173.640001,2,0,0,2,22,Louis Gloria
2006,103921,2173.639604,2,0,0,2,30,Sonchat Ratiwatana
2014,106218,2173.637126,2,0,0,2,10,Marcos Giron
1988,101013,2173.63477,2,0,0,2,25,Henrik Sundstrom
1994,101280,2173.631169,2,0,0,2,24,Mikael Stadling
1987,100864,2173.626975,13,6,0,7,10,Martin Wostenholme
1989,101690,2173.619317,2,0,0,2,53,Juan Carlos Bianchi
1989,110816,2173.619317,2,0,0,2,53,Valerio Boccito
1989,101792,2173.614136,2,0,0,2,19,Slava Dosedel
1986,100342,2173.611028,2,0,0,2,42,Vitas Gerulaitis
1998,102165,2173.607116,2,0,0,2,34,Srinath Prahlad
2012,105967,2173.606793,2,0,0,2,4,Henri Laaksonen
1989,108043,2173.604341,2,0,0,2,21,Ralph Kok
2014,105638,2173.598591,2,0,0,2,19,Daniel Cox
1988,100848,2173.5917,22,10,0,12,2,Alberto Tous
2006,103510,2173.591566,2,0,0,2,16,Rob Steckley
1995,102687,2173.589174,2,0,0,2,17,Herbert Wiltschnig
1996,108754,2173.584784,4,1,0,3,34,Esam Abdulaal
2013,103857,2173.584361,2,0,0,2,37,Igor Kunitsyn
2012,105177,2173.58367,2,0,0,2,35,Aditya Hari Sasongko
1998,102220,2173.582979,2,0,0,2,29,Patrik Fredriksson
2014,103967,2173.576812,2,0,0,2,9,Michael Lammer
2015,105759,2173.567907,2,0,0,2,19,Henrik Sillanpaa
1993,111002,2173.563402,4,1,0,3,36,Hani Al Ali
2008,108692,2173.563334,4,1,0,3,31,Mohammed Al Nabhani
2006,104251,2173.562243,4,1,0,3,6,Ti Chen
1994,102198,2173.553816,9,3,0,6,7,Paul Kilderry
2006,103909,2173.552448,25,11,0,14,10,Guillermo Coria
2000,101957,2173.552221,2,0,0,2,20,Milen Velev
2015,106293,2173.550077,4,1,0,3,17,Kimmer Coppejans
2007,105094,2173.544666,2,0,0,2,19,Paris Gemouchidis
2014,105299,2173.544634,4,1,0,3,32,Dzmitry Zhyrmont
2015,104907,2173.543021,4,1,0,3,19,Jose Rubin Statham
2010,103535,2173.539102,2,0,0,2,18,Olivier Patience
2008,103684,2173.536499,2,0,0,2,36,Benedikt Dorsch
2012,105270,2173.531266,2,0,0,2,6,Maxime Teixeira
2002,103837,2173.53121,4,1,0,3,9,Didac Perez
1996,102190,2173.527504,2,0,0,2,11,Philippe Moggio
2009,105394,2173.526653,2,0,0,2,21,Ilija Martinoski
1985,100703,2173.524294,2,0,0,2,10,Randy Nixon
1985,111102,2173.524294,2,0,0,2,43,Chareonchai Tritilinant
1986,100664,2173.524294,2,0,0,2,8,Stephan Medem
1986,100703,2173.524294,2,0,0,2,8,Randy Nixon
1986,100761,2173.524294,2,0,0,2,47,Danny Saltz
1987,100221,2173.524294,2,0,0,2,47,Carlos Kirmayr
1988,101601,2173.524294,2,0,0,2,51,Brett Steven
1989,101057,2173.524294,2,0,0,2,54,Peter Carter
1991,110897,2173.524294,2,0,0,2,39,Greig Rodger
1992,102536,2173.524294,2,0,0,2,46,James Greenhalgh
1992,109440,2173.524294,2,0,0,2,35,Jin Yen Chiang
1994,101138,2173.524294,2,0,0,2,46,Pat Cash
1996,102198,2173.524294,2,0,0,2,45,Paul Kilderry
1997,106620,2173.524294,2,0,0,2,33,Bertrand Lacombe
1998,108859,2173.524294,2,0,0,2,18,Jesse Smatt
1999,108373,2173.524294,2,0,0,2,18,Thierno Ly
1999,108599,2173.524294,2,0,0,2,18,Ivo Lagzdins
2000,102100,2173.524294,4,1,0,3,20,Bartlomiej Dabrowski
2000,103544,2173.524294,2,0,0,2,33,Andy Ram
2000,108597,2173.524294,2,0,0,2,40,Adelo Abadia
2000,108598,2173.524294,2,0,0,2,40,Rolando Ruel
2000,108599,2173.524294,2,0,0,2,20,Ivo Lagzdins
2001,101939,2173.524294,2,0,0,2,18,Erhan Oral
2001,103553,2173.524294,2,0,0,2,43,Alun Jones
2001,104213,2173.524294,2,0,0,2,18,Tigran Martirosyan
2001,108614,2173.524294,2,0,0,2,33,Raoul Behr
2002,101790,2173.524294,2,0,0,2,31,Elmar Gerth
2002,102448,2173.524294,2,0,0,2,31,Ali Hamadeh
2002,102557,2173.524294,2,0,0,2,38,Daniel Willman
2002,103659,2173.524294,4,1,0,3,31,Wei Jen Cheng
2002,108591,2173.524294,2,0,0,2,31,Adam Jaya
2002,108653,2173.524294,2,0,0,2,31,Troy Stone
2003,103851,2173.524294,2,0,0,2,17,Conor Niland
2003,103891,2173.524294,2,0,0,2,8,Alexandros Jakupovic
2004,104349,2173.524294,2,0,0,2,18,Rui Machado
2004,108591,2173.524294,2,0,0,2,31,Adam Jaya
2004,108678,2173.524294,2,0,0,2,31,Eddy Gonzalez Gonzalez
2004,108921,2173.524294,2,0,0,2,31,Mohammed Noor Noordin
2005,102556,2173.524294,2,0,0,2,17,Claude Ngoran
2005,104115,2173.524294,2,0,0,2,39,Marc Kimmich
2006,104028,2173.524294,2,0,0,2,8,Goncalo Nicau
2006,105122,2173.524294,2,0,0,2,16,Karlis Lejnieks
2006,108949,2173.524294,2,0,0,2,8,Jose Zunino
2007,105273,2173.524294,2,0,0,2,35,Mauricio Echazu
2007,108945,2173.524294,2,0,0,2,35,Juan Sebastian Langton
2008,104291,2173.524294,2,0,0,2,17,Malek Jaziri
2008,108690,2173.524294,2,0,0,2,31,Ayrton Wibowo
2010,105156,2173.524294,2,0,0,2,22,Federico Zeballos
2010,105601,2173.524294,2,0,0,2,22,Cristobal Saavedra Corvalan
2010,108736,2173.524294,2,0,0,2,22,Sebastian Moreno
2011,106024,2173.524294,2,0,0,2,21,Dovydas Sakinis
2012,104299,2173.524294,2,0,0,2,35,Hiu Tung Yu
2012,104479,2173.524294,2,0,0,2,35,Sarvar Ikramov
2012,108747,2173.524294,4,1,0,3,35,Dineshkanthan Thangarajah
2013,104600,2173.524294,2,0,0,2,11,Treat Conrad Huey
2014,105431,2173.524294,2,0,0,2,9,Ariel Behar
2014,105738,2173.524294,2,0,0,2,40,Tsung Hua Yang
2014,108747,2173.524294,2,0,0,2,32,Dineshkanthan Thangarajah
2014,108782,2173.524294,2,0,0,2,9,Mahammad Abid
2014,144772,2173.524294,2,0,0,2,32,Salvador Andres Bolanos
2015,103875,2173.524294,2,0,0,2,19,Anoosha Shahgholi
2015,105467,2173.524294,2,0,0,2,11,Jordi Munoz Abreu
2015,111781,2173.524294,2,0,0,2,19,Janis Podzus
2015,121331,2173.524294,2,0,0,2,19,Pablo Nunez
2012,108785,2173.523332,2,0,0,2,35,Anthony Marshall
2005,103905,2173.522715,4,1,0,3,17,Ricardo Chile Fonte
2012,105273,2173.520463,2,0,0,2,11,Mauricio Echazu
2011,105060,2173.516712,4,1,0,3,12,Aldin Setkic
1989,101217,2173.506465,2,0,0,2,25,Andreas Lesch
2001,101790,2173.506232,2,0,0,2,33,Elmar Gerth
2009,104550,2173.505562,2,0,0,2,31,Ricardo Hocevar
1991,100984,2173.504712,2,0,0,2,34,Peter Wright
1999,108803,2173.503951,2,0,0,2,18,Jean Max Mangones
2015,111578,2173.503951,2,0,0,2,38,Stefan Kozlov
2000,102979,2173.496039,2,0,0,2,37,Jeff Coetzee
2002,103281,2173.488194,2,0,0,2,14,Ladislav Svarc
1996,108796,2173.485726,4,1,0,3,28,Rafael Jordan
2001,108632,2173.485285,2,0,0,2,33,Federico Camacho
2002,108657,2173.48355,2,0,0,2,17,Alexander Skrypko
1991,101477,2173.482571,2,0,0,2,3,Chris Bailey
2009,105159,2173.481343,2,0,0,2,11,Vaja Uzakov
1992,101668,2173.481044,2,0,0,2,24,Peter Nyborg
2005,104021,2173.473191,2,0,0,2,23,Marco Mirnegg
1994,101284,2173.469765,8,3,0,5,12,Lars Anders Wahlgren
1993,102019,2173.458178,6,2,0,4,20,Dirk Dier
1987,101133,2173.445411,2,0,0,2,10,Patrick Baur
1991,101567,2173.441127,2,0,0,2,3,Hendrik Jan Davids
2000,106536,2173.436567,2,0,0,2,20,Andres Filimonov
1995,102060,2173.435962,2,0,0,2,17,Ignacio Martinez
2002,102494,2173.43066,2,0,0,2,22,Tomas Behrend
1999,102454,2173.426587,2,0,0,2,34,Hyeong Keun Song
2010,103835,2173.425566,10,4,0,6,5,Filippo Volandri
1989,101506,2173.424254,2,0,0,2,53,Eoin Collins
2011,106233,2173.422773,4,1,0,3,6,Dominic Thiem
1992,101876,2173.418584,2,0,0,2,13,Massimo Ardinghi
1987,101144,2173.417098,4,1,0,3,11,Anthony Lane
1999,108804,2173.416011,2,0,0,2,28,Diadji Ka
1992,101576,2173.415118,2,0,0,2,7,Ryuso Tsujino
2010,103472,2173.413755,4,1,0,3,22,Karim Maamoun
2015,108972,2173.413531,2,0,0,2,36,Ibrahim Abou Chahine
1995,101205,2173.408371,4,1,0,3,18,Grant Connell
2013,103999,2173.40427,2,0,0,2,41,Thiago Alves
2015,104813,2173.397645,2,0,0,2,19,Grega Zemlja
2007,104500,2173.384928,2,0,0,2,8,Somdev Devvarman
2014,105967,2173.377936,4,1,0,3,16,Henri Laaksonen
1987,100446,2173.374154,19,8,0,11,25,John Sadri
1989,101881,2173.371353,2,0,0,2,17,Oliver Fuchs
1998,101775,2173.35628,4,1,0,3,9,Frederik Fetterlein
1993,101573,2173.354606,2,0,0,2,6,Carl Chang
2012,106244,2173.353214,2,0,0,2,22,Oliver Golding
1988,107662,2173.348896,2,0,0,2,29,Marco Seruca
1995,102457,2173.343449,4,1,0,3,22,Miles Maclagan
1990,100570,2173.339544,2,0,0,2,7,Marty Davis
2005,108896,2173.337453,2,0,0,2,8,Shahzad Khan
2010,103174,2173.327592,2,0,0,2,26,Noam Okun
1991,101717,2173.318366,23,9,0,14,3,Diego Nargiso
2009,102512,2173.316232,2,0,0,2,25,Joseph Sirianni
2008,103967,2173.303525,2,0,0,2,19,Michael Lammer
2007,105238,2173.301098,2,0,0,2,27,Alexandr Dolgopolov
1995,102375,2173.299124,6,2,0,4,10,Dinu Pescariu
2006,104534,2173.296093,2,0,0,2,36,Dudi Sela
2014,104505,2173.289687,2,0,0,2,9,Konstantin Kravchuk
1993,102235,2173.286131,21,7,0,14,6,Tommy Ho
2002,103003,2173.268684,6,2,0,4,19,Jean Francois Bachelot
2011,105349,2173.264229,2,0,0,2,12,Harri Heliovaara
2000,102984,2173.261381,2,0,0,2,9,Martin Garcia
1989,100530,2173.257269,2,0,0,2,35,Andreas Maurer
2004,104182,2173.257012,2,0,0,2,8,Sasa Tuksar
2003,103746,2173.249316,4,1,0,3,31,Miguel Gallardo Valles
2001,101532,2173.249205,50,23,0,27,2,Francisco Clavet
1996,101265,2173.246196,10,4,0,6,36,Patrick Mcenroe
1995,102339,2173.239973,16,6,0,10,8,Kris Goossens
2015,105590,2173.230145,2,0,0,2,11,Uladzimir Ignatik
2000,103240,2173.229978,7,2,0,5,8,Kevin Kim
1994,101829,2173.20936,8,3,0,5,13,Federico Sanchez
2009,102845,2173.204383,6,2,0,4,39,Carlos Moya
1986,100785,2173.201296,2,0,0,2,18,Jesus Colas
2000,102093,2173.189704,31,14,0,17,6,Martin Damm
1996,102254,2173.179094,2,0,0,2,29,Ouassel Hared
2010,104600,2173.178264,4,1,0,3,11,Treat Conrad Huey
2006,103248,2173.168852,2,0,0,2,17,Harel Levy
1998,101609,2173.165183,16,6,0,10,11,David Wheaton
2007,104469,2173.164992,2,0,0,2,19,Erling Tveit
2004,102667,2173.164383,2,0,0,2,6,Satoshi Iwabuchi
2004,102548,2173.162917,2,0,0,2,28,Juan Antonio Marin
2006,104783,2173.161317,4,1,0,3,7,Mikhail Ledovskikh
2014,105874,2173.160346,6,2,0,4,22,Albano Olivetti
1985,100368,2173.158439,4,1,0,3,26,Haroon Ismail
2012,103794,2173.155005,24,10,0,14,4,Benjamin Becker
2002,103325,2173.152775,4,1,0,3,14,Wesley Moodie
2001,107098,2173.148517,2,0,0,2,9,Gilles Kremer
2011,103891,2173.14318,2,0,0,2,21,Alexandros Jakupovic
1999,102076,2173.140934,4,1,0,3,9,Mark Merklein
1988,101113,2173.136288,15,6,0,9,2,Michael Westphal
2000,103204,2173.132703,2,0,0,2,19,Hugo Armando
2010,104226,2173.128223,2,0,0,2,21,Bastian Knittel
1991,101585,2173.1267,2,0,0,2,3,Fabio Silberberg
2001,102306,2173.124529,2,0,0,2,19,Michael Kohlmann
1985,100972,2173.121955,2,0,0,2,21,Todd Witsken
2001,104179,2173.117229,2,0,0,2,9,Bruno Echagaray
2006,103487,2173.106213,4,1,0,3,7,Federico Luzzi
2013,104251,2173.100526,6,2,0,4,11,Ti Chen
2007,105148,2173.099751,2,0,0,2,41,Hsin Han Lee
1994,102694,2173.098724,2,0,0,2,18,Lars Burgsmuller
1989,101076,2173.097617,2,0,0,2,41,Cesar Kist
2003,104059,2173.097234,2,0,0,2,31,Rasmus Norby
2013,104920,2173.093564,2,0,0,2,11,Denys Molchanov
1988,101384,2173.080236,2,0,0,2,13,Marco Filippeschi
2001,102243,2173.072125,2,0,0,2,30,Marcelo Charpentier
2014,105655,2173.071767,2,0,0,2,6,Hiroki Moriya
2015,105111,2173.062508,2,0,0,2,11,Ivan Endara
2002,108644,2173.057925,4,1,0,3,8,Patrick Chucri
2010,108734,2173.046397,2,0,0,2,22,Fredrik Ask
1993,102364,2173.044963,2,0,0,2,36,Hiram Silfa
2010,104297,2173.042914,2,0,0,2,34,Rogerio Dutra Silva
1996,102246,2173.040927,4,1,0,3,28,Fernando Samayoa
1988,102018,2173.040683,2,0,0,2,23,Tamer El Sawy
2005,104736,2173.040678,4,1,0,3,26,Farrukh Dustov
2004,104260,2173.039893,2,0,0,2,18,Johny De Leon
2011,106100,2173.039893,2,0,0,2,12,Micke Kontinen
1988,100819,2173.037557,2,0,0,2,24,Daniel Montes De Oca
1994,103029,2173.035929,2,0,0,2,10,Mehdi Tahiri
1988,101731,2173.028226,7,2,0,5,6,Nuno Marques
1989,101083,2173.026293,2,0,0,2,25,Tom Mercer
2005,104639,2173.023481,2,0,0,2,33,Wayne Odesnik
2004,104569,2173.021098,2,0,0,2,18,Lado Chikhladze
2013,106093,2173.020372,2,0,0,2,42,Benjamin Mitchell
2005,104294,2173.02034,2,0,0,2,17,Hao Lu
2010,104469,2173.02034,2,0,0,2,22,Erling Tveit
2008,108925,2173.020338,2,0,0,2,31,Ahmad Rabeea Muhammad
1993,101263,2173.016876,2,0,0,2,22,Luke Jensen
1993,101751,2173.015795,4,1,0,3,23,Ross Matheson
2004,104807,2173.01391,2,0,0,2,8,Mehdi Ziadi
2000,103205,2173.013307,2,0,0,2,37,Emilio Daniel Baez Britez
2009,105259,2173.010552,2,0,0,2,29,Andrei Karatchenia
1999,101468,2173.006427,2,0,0,2,29,Gerard Solves
2013,105434,2173.00264,2,0,0,2,11,Ruan Roelofse
2001,103377,2173.000789,2,0,0,2,33,Seung Hoon Lee
1985,100599,2173,2,0,0,2,26,Bernard Boileau
1985,100991,2173,2,0,0,2,31,Johnny Goudenbour
1985,101349,2173,2,0,0,2,49,Adam Malik
1985,101382,2173,2,0,0,2,43,Marcelo Filippini
1985,106580,2173,2,0,0,2,49,Arjun Fernando
1985,106782,2173,2,0,0,2,43,Colin Grant
1985,107829,2173,2,0,0,2,31,Morten Ronneberg
1985,108332,2173,2,0,0,2,49,Suharyadi Suharyadi
1985,108552,2173,2,0,0,2,31,Yannos Hadjigeorgiou
1985,108823,2173,2,0,0,2,49,Tintus Arianto Wibowo
1985,110895,2173,2,0,0,2,31,Abdel Majid Soudani
1985,110978,2173,2,0,0,2,49,Albert Teo
1985,111065,2173,2,0,0,2,31,Mike Van Kauvenbergh
1985,111114,2173,2,0,0,2,49,Niranjan Casie Chitty
1986,100401,2173,2,0,0,2,32,Sean Sorensen
1986,101630,2173,2,0,0,2,44,Clement Ngoran
1986,103993,2173,2,0,0,2,44,Chris Lewis
1986,106506,2173,2,0,0,2,32,Alkis Papamichael
1986,106695,2173,2,0,0,2,49,Carlos Claverie
1986,106941,2173,2,0,0,2,44,Eno Polo
1986,108867,2173,2,0,0,2,32,Serge Brueck
1986,110785,2173,2,0,0,2,44,Philippe Koffi
1986,110817,2173,2,0,0,2,44,Ifthekar Sardar
1986,110818,2173,2,0,0,2,44,Shovon Jamaly
1986,110855,2173,2,0,0,2,32,Dawood Dawoodian
1986,110887,2173,2,0,0,2,44,Arjun Perera
1986,110966,2173,2,0,0,2,32,Shoukry Srourian
1986,110972,2173,2,0,0,2,44,Kian Wah Yeo
1986,111050,2173,2,0,0,2,44,Abdel Monem Bornaz
1986,111051,2173,2,0,0,2,44,Saad El Ragig
1986,111084,2173,2,0,0,2,49,Jilani Bouhafa
1987,100898,2173,2,0,0,2,46,Robinson Ureta
1987,101165,2173,2,0,0,2,51,Mario Tabares
1987,101417,2173,2,0,0,2,51,Mario Rincon
1987,101664,2173,2,0,0,2,28,Andras Lanyi
1987,101728,2173,2,0,0,2,28,Laszlo Markovits
1987,106580,2173,2,0,0,2,46,Arjun Fernando
1987,106615,2173,2,0,0,2,33,Bernard Balleret
1987,106941,2173,2,0,0,2,46,Eno Polo
1987,107689,2173,2,0,0,2,33,Mark Gurr
1987,108823,2173,2,0,0,2,46,Tintus Arianto Wibowo
1987,108824,2173,2,0,0,2,34,Daryl Delicata
1987,108867,2173,2,0,0,2,33,Serge Brueck
1987,110817,2173,2,0,0,2,46,Ifthekar Sardar
1987,110855,2173,2,0,0,2,33,Dawood Dawoodian
1987,110940,2173,2,0,0,2,41,Miloud Doumbia
1987,110972,2173,2,0,0,2,46,Kian Wah Yeo
1987,110973,2173,2,0,0,2,46,Khairuddin Baharom
1987,110979,2173,2,0,0,2,46,Mahader Hassan
1987,111112,2173,2,0,0,2,46,Tan Ah Peng
1987,111116,2173,2,0,0,2,33,Hrage Magarian
1988,100991,2173,2,0,0,2,34,Johnny Goudenbour
1988,101287,2173,2,0,0,2,34,Denis Langaskens
1988,101417,2173,2,0,0,2,47,Mario Rincon
1988,101485,2173,2,0,0,2,47,Tanakorn Srichaphan
1988,101662,2173,2,0,0,2,47,Selvam Veerasingam
1988,106506,2173,2,0,0,2,34,Alkis Papamichael
1988,106593,2173,2,0,0,2,39,Asif Karim
1988,106620,2173,2,0,0,2,47,Bertrand Lacombe
1988,107117,2173,2,0,0,2,39,Gordon Asciak
1988,107534,2173,2,0,0,2,39,Kush Bhardwaj
1988,108552,2173,2,0,0,2,34,Yannos Hadjigeorgiou
1988,108815,2173,2,0,0,2,47,Kojo Atiso
1988,108824,2173,2,0,0,2,39,Daryl Delicata
1988,109480,2173,2,0,0,2,34,Alex Roman
1988,110782,2173,2,0,0,2,39,Djamel Boudjemline
1988,110797,2173,2,0,0,2,39,Adel Brahim
1988,110817,2173,2,0,0,2,39,Ifthekar Sardar
1988,110903,2173,2,0,0,2,39,Zacharie Moungnol
1988,110907,2173,2,0,0,2,39,Pierre Moudourou
1988,110970,2173,2,0,0,2,39,Ali Al Zubaidi
1988,110971,2173,2,0,0,2,39,Youssef Hassan
1988,111065,2173,2,0,0,2,34,Mike Van Kauvenbergh
1988,111075,2173,2,0,0,2,47,Chin Chuan Chow
1988,111109,2173,2,0,0,2,39,Mounged Bouhassoun
1989,101048,2173,2,0,0,2,53,Francisco Maciel
1989,101121,2173,2,0,0,2,37,Alaaddin Karagoz
1989,101167,2173,2,0,0,2,53,Jaime Cortes
1989,101495,2173,2,0,0,2,53,Miguel Tobon
1989,101651,2173,2,0,0,2,53,Owen Casey
1989,102018,2173,2,0,0,2,43,Tamer El Sawy
1989,106506,2173,2,0,0,2,43,Alkis Papamichael
1989,106782,2173,2,0,0,2,53,Colin Grant
1989,107117,2173,2,0,0,2,43,Gordon Asciak
1989,107680,2173,2,0,0,2,53,Mark Bailey
1989,108875,2173,2,0,0,2,37,Abou Berthe
1989,109480,2173,2,0,0,2,37,Alex Roman
1989,110797,2173,2,0,0,2,53,Adel Brahim
1989,110798,2173,2,0,0,2,53,Elias Bramly
1989,110856,2173,4,1,0,3,43,Abdul Rahman Shehab
1989,110857,2173,2,0,0,2,53,Samer Mourad
1989,110897,2173,2,0,0,2,53,Greig Rodger
1989,110902,2173,2,0,0,2,43,Khaled Ezankouli
1989,110904,2173,2,0,0,2,43,Abdul Hakim Jteli
1989,110963,2173,2,0,0,2,37,Ioannis Kabakoglou
1989,110985,2173,2,0,0,2,53,Rudy Foo
1989,111022,2173,4,1,0,3,43,Khaled Al Foudari
1991,101236,2173,2,0,0,2,34,Krassimir Lazarov
1991,101825,2173,2,0,0,2,50,Manuel Tejada
1991,101962,2173,2,0,0,2,50,Younes El Aynaoui
1991,101969,2173,2,0,0,2,34,Orlin Stanoytchev
1991,101979,2173,2,0,0,2,42,Ricardo Mena
1991,102097,2173,2,0,0,2,48,Naratorn Srichaphan
1991,106506,2173,2,0,0,2,34,Alkis Papamichael
1991,106620,2173,2,0,0,2,50,Bertrand Lacombe
1991,107117,2173,2,0,0,2,34,Gordon Asciak
1991,108182,2173,2,0,0,2,42,Ruben Alvarenga
1991,108532,2173,2,0,0,2,48,Worapol Thongkamcho
1991,108552,2173,2,0,0,2,34,Yannos Hadjigeorgiou
1991,108752,2173,2,0,0,2,34,Shehab Shehab
1991,108875,2173,2,0,0,2,34,Abou Berthe
1991,108883,2173,2,0,0,2,25,Kuen Yiep Ho
1991,110794,2173,2,0,0,2,34,Jerome Seguin
1991,110811,2173,2,0,0,2,50,Carlos Roberto Paez
1991,110857,2173,2,0,0,2,34,Samer Mourad
1991,110874,2173,2,0,0,2,50,Crepin Ossombi
1991,110875,2173,2,0,0,2,50,Christian Bemba
1991,110878,2173,2,0,0,2,50,Noel Rutherford
1991,110906,2173,2,0,0,2,50,Luc Ondobo
1991,110925,2173,2,0,0,2,50,Orville Adams
1991,110926,2173,2,0,0,2,50,Mark Webster
1991,111001,2173,2,0,0,2,26,Emad Abou Hamdeh
1991,111022,2173,2,0,0,2,34,Khaled Al Foudari
1991,111023,2173,2,0,0,2,34,Aymen Ibrahim Al Ashwak
1991,111113,2173,2,0,0,2,34,Jehad Sheet
1992,101563,2173,2,0,0,2,35,Joseph Lizardo
1992,101755,2173,2,0,0,2,29,Derek Farren
1992,102100,2173,4,1,0,3,29,Bartlomiej Dabrowski
1992,107586,2173,2,0,0,2,43,Lui Pang
1992,108182,2173,2,0,0,2,44,Ruben Alvarenga
1992,110824,2173,2,0,0,2,35,Shibu Lal
1992,110832,2173,2,0,0,2,44,Faisal Syed Haq
1992,110837,2173,2,0,0,2,44,Craig Smith
1992,110905,2173,2,0,0,2,29,Fred Kangwa
1992,111001,2173,4,1,0,3,35,Emad Abou Hamdeh
1993,100714,2173,2,0,0,2,46,Broderick Dyke
1993,101794,2173,2,0,0,2,30,Darek Nowicki
1993,102655,2173,2,0,0,2,44,Jimy Szymanski
1993,106620,2173,2,0,0,2,44,Bertrand Lacombe
1993,106941,2173,2,0,0,2,36,Eno Polo
1993,107929,2173,2,0,0,2,44,Patrice Baker
1993,108670,2173,2,0,0,2,8,Noujeim Hakimi
1993,108820,2173,2,0,0,2,30,Ganiyu Adenekan
1993,110795,2173,2,0,0,2,30,Sadri Gueche
1993,110813,2173,2,0,0,2,44,Rafael Moreno
1993,110942,2173,2,0,0,2,21,Hichem Bramly
1993,110961,2173,2,0,0,2,30,Emmanuel Paddi
1993,110968,2173,2,0,0,2,30,Selim Ben Hadjali
1994,100939,2173,4,1,0,3,36,Joey Rive
1994,101156,2173,2,0,0,2,43,Juan Pino
1994,101203,2173,2,0,0,2,43,Adrian Graimprey
1994,101748,2173,2,0,0,2,19,Ivan Keskinov
1994,101802,2173,2,0,0,2,43,Ramayah Ramachandran
1994,101946,2173,2,0,0,2,30,Milko Petkov
1994,108182,2173,2,0,0,2,43,Ruben Alvarenga
1994,108795,2173,2,0,0,2,19,Jean Noel Said
1994,108827,2173,2,0,0,2,30,Mike Amoah
1994,108872,2173,2,0,0,2,36,Yang Tat Lim
1994,108875,2173,2,0,0,2,30,Abou Berthe
1994,108876,2173,2,0,0,2,30,El Hadj Diedhiou
1994,108881,2173,2,0,0,2,43,Ju Min Lam
1994,108882,2173,2,0,0,2,43,Mark Choy
1995,101576,2173,2,0,0,2,43,Ryuso Tsujino
1995,102971,2173,2,0,0,2,30,Christophe Bosio
1995,107310,2173,2,0,0,2,20,Jean Nabi
1995,108596,2173,2,0,0,2,43,Ramin Raziyani
1995,108733,2173,4,1,0,3,35,Jose Medrano
1995,108865,2173,2,0,0,2,30,Gitanas Mazonas
1996,108820,2173,2,0,0,2,28,Ganiyu Adenekan
1996,108824,2173,2,0,0,2,28,Daryl Delicata
1996,108835,2173,2,0,0,2,43,Manjule Weerakoon
1997,101333,2173,2,0,0,2,42,Mark Ferreira
1997,101976,2173,6,2,0,4,10,Federico Dondo
1997,102077,2173,4,1,0,3,19,Alexander Shvec
1997,102802,2173,2,0,0,2,19,Gunther Darkey
1997,102843,2173,4,1,0,3,33,Suwandi Suwandi
1997,103807,2173,2,0,0,2,28,Raimonds Sproga
1997,107185,2173,2,0,0,2,33,Hector Nevares
1997,108821,2173,2,0,0,2,28,Vladimir Margalitadze
1997,108834,2173,2,0,0,2,33,Tawfiq Moafa
1997,108870,2173,2,0,0,2,39,Chee Yen Chen
1998,101171,2173,2,0,0,2,34,Armando Perez
1998,101671,2173,2,0,0,2,41,Dede Suhendar Dinata
1998,102536,2173,2,0,0,2,41,James Greenhalgh
1998,108597,2173,2,0,0,2,34,Adelo Abadia
1998,108605,2173,2,0,0,2,27,Sacha Thoma
1998,108839,2173,2,0,0,2,34,Christopher Lai
1998,108841,2173,2,0,0,2,30,Mubarak Al Tobaishi
1998,108848,2173,2,0,0,2,30,Khaled Al Haji
1999,101860,2173,2,0,0,2,46,Mark Draper
1999,101970,2173,2,0,0,2,28,Iztok Bozic
2000,101416,2173,2,0,0,2,47,Joao Cunha Silva
2000,102283,2173,2,0,0,2,37,Yari Bernardo
2000,102362,2173,2,0,0,2,33,Amro Ghoneim
2000,102938,2173,2,0,0,2,47,Alejandro Olivera
2000,103877,2173,2,0,0,2,33,Mike Scheidweiler
2000,108621,2173,2,0,0,2,47,Seyed Akbar Taheri Rahaghi
2000,108797,2173,2,0,0,2,47,Luis Diego Nunez
2001,103899,2173,2,0,0,2,18,Stian Boretti
2001,104051,2173,2,0,0,2,40,Andrej Kracman
2002,102263,2173,2,0,0,2,38,Yong Il Yoon
2002,103130,2173,2,0,0,2,26,Louis Vosloo
2002,104000,2173,4,1,0,3,17,Andrey Dernovskiy
2002,108624,2173,2,0,0,2,31,Hazuan Hizan
2002,108646,2173,2,0,0,2,38,Joseph Victorino
2002,108655,2173,2,0,0,2,31,Ivor Grazette
2003,101790,2173,2,0,0,2,31,Elmar Gerth
2003,102812,2173,2,0,0,2,39,Jicham Zaatini
2003,104113,2173,2,0,0,2,39,Carlos Salamanca
2003,108674,2173,2,0,0,2,39,Jerry Joseph
2003,108677,2173,2,0,0,2,39,Daniel Isaza
2003,108683,2173,2,0,0,2,17,Kenneth Tuilier Curco
2004,103402,2173,2,0,0,2,31,Peter Clarke
2004,108675,2173,2,0,0,2,38,Iphton Louis
2004,108910,2173,2,0,0,2,31,Matthew Prentice
2005,104565,2173,2,0,0,2,34,Hyun Joon Suk
2005,104689,2173,2,0,0,2,17,Terence Nugent
2005,108929,2173,2,0,0,2,34,Sergio Rojas
2006,102267,2173,2,0,0,2,16,Gwinyai Tongoona
2006,102496,2173,2,0,0,2,36,Scott Willinsky
2006,103851,2173,2,0,0,2,16,Conor Niland
2006,104323,2173,2,0,0,2,30,Photos Kallias
2006,104768,2173,2,0,0,2,30,Juho Paukku
2006,108955,2173,2,0,0,2,36,Elvis Henry
2007,103050,2173,2,0,0,2,41,Shahab Hassani Nafez
2007,103875,2173,2,0,0,2,35,Anoosha Shahgholi
2007,104988,2173,2,0,0,2,41,Vivek Shokeen
2007,105132,2173,2,0,0,2,35,Jurgen Zopp
2007,108918,2173,2,0,0,2,41,Favel Antonio Freyre Perdomo
2008,102812,2173,2,0,0,2,31,Jicham Zaatini
2008,103007,2173,2,0,0,2,31,Mounir El Aarej
2008,103891,2173,2,0,0,2,31,Alexandros Jakupovic
2008,108695,2173,2,0,0,2,31,Roman Margoulis
2008,108952,2173,2,0,0,2,31,Jose Roberto Velasco
2008,108978,2173,2,0,0,2,31,Nick Van Rosberg
2009,108692,2173,4,1,0,3,21,Mohammed Al Nabhani
2009,108977,2173,2,0,0,2,21,George Khrikadze
2010,104800,2173,2,0,0,2,22,Mauricio Estivariz
2011,103109,2173,2,0,0,2,38,Talal Ouahabi
2011,105738,2173,2,0,0,2,38,Tsung Hua Yang
2011,108688,2173,2,0,0,2,38,Martin Sayer
2011,108765,2173,2,0,0,2,38,Jean Marc Bazanne
2011,108940,2173,2,0,0,2,38,David Josepa
2012,103760,2173,2,0,0,2,35,Haluk Akkoyun
2012,106093,2173,2,0,0,2,44,Benjamin Mitchell
2012,108768,2173,2,0,0,2,42,Gabriel Flores Ruiz
2012,108780,2173,2,0,0,2,35,Lofo Ramiaramanana
2012,108781,2173,2,0,0,2,35,Ando Rasolomalala
2012,108916,2173,2,0,0,2,35,Ricardo Gonzalez Diaz
2013,104615,2173,2,0,0,2,41,Ranjeet Virali Murugesan
2013,105482,2173,2,0,0,2,41,Vijayant Malik
2013,105586,2173,2,0,0,2,41,Alexander Lazov
2014,105961,2173,2,0,0,2,40,David Souto
2014,111444,2173,2,0,0,2,40,Karim Hossam
2014,122047,2173,2,0,0,2,40,Luciano Ramazzini
2015,103821,2173,2,0,0,2,36,Danai Udomchoke
2015,105239,2173,2,0,0,2,36,Daniel Glancy
1986,100997,2172.999208,2,0,0,2,44,Roger Smith
2012,103709,2172.999208,2,0,0,2,42,Kristian Pless
1995,108866,2172.997093,2,0,0,2,20,Denis Ivancovas
1997,102113,2172.988242,2,0,0,2,26,Daniele Musa
2004,108898,2172.9843,2,0,0,2,31,Christopher Eldon
1998,108604,2172.980561,2,0,0,2,18,Pascal Schaul
1999,102055,2172.979628,2,0,0,2,18,Bertrand Madsen
2004,103468,2172.979628,2,0,0,2,38,Harsh Mankad
2008,102630,2172.979628,4,1,0,3,17,Slimane Saoudi
1989,100939,2172.979194,25,10,0,15,2,Joey Rive
1994,102019,2172.974273,3,0,0,3,9,Dirk Dier
1995,101940,2172.971612,2,0,0,2,20,Rene Busch
1995,103216,2172.970854,2,0,0,2,6,Clemens Trimmel
2011,106342,2172.965703,2,0,0,2,21,Martins Podzus
1988,101550,2172.965553,2,0,0,2,21,Al Parker
2005,104270,2172.96443,2,0,0,2,17,Marvin Rolle
1996,108751,2172.961063,4,1,0,3,34,Bader Mohammed Almuqail
2010,104454,2172.959671,2,0,0,2,22,Murad Inoyatov
2002,101820,2172.956545,20,8,0,12,3,Marc Rosset
1990,101274,2172.949987,38,15,0,23,1,Udo Riglewski
2004,108663,2172.946997,2,0,0,2,31,Bjorn Munroe
2010,105216,2172.945355,2,0,0,2,30,Yuichi Sugita
2007,104349,2172.940652,2,0,0,2,9,Rui Machado
1999,102600,2172.940195,2,0,0,2,8,David Miketa
1997,102667,2172.936534,2,0,0,2,31,Satoshi Iwabuchi
1988,101406,2172.926862,8,3,0,5,14,Wojtek Kowalski
2012,104979,2172.922931,9,3,0,6,32,Andrey Golubev
1989,101018,2172.920935,2,0,0,2,30,Edoardo Mazza
1998,102444,2172.918756,2,0,0,2,27,Scott Barron
2006,104719,2172.916292,2,0,0,2,19,Marcel Granollers
1991,100926,2172.916114,2,0,0,2,40,Ken Flach
1986,101731,2172.913606,2,0,0,2,26,Nuno Marques
1986,101321,2172.907776,2,0,0,2,19,Juan Carlos Baguena
1987,101809,2172.90073,2,0,0,2,51,Nicolas Pereira
2004,103009,2172.897898,2,0,0,2,10,Razvan Sabau
1999,101997,2172.896361,2,0,0,2,22,Marzio Martelli
1994,108443,2172.894172,2,0,0,2,7,Toshitsugu Mori
1997,102339,2172.892696,2,0,0,2,29,Kris Goossens
2003,102106,2172.892053,41,18,0,23,3,Davide Sanguinetti
1998,100997,2172.880706,2,0,0,2,18,Roger Smith
1991,101513,2172.8749,4,1,0,3,12,John Stimpson
2005,104909,2172.871297,2,0,0,2,8,Sunu Wahyu Trijati
2015,105587,2172.868239,2,0,0,2,36,Tom Kocevar Desman
1990,101534,2172.860374,2,0,0,2,14,Libor Nemecek
2010,104233,2172.843837,4,1,0,3,9,Frederik Nielsen
1997,101864,2172.841913,16,6,0,10,5,Fernon Wibier
1993,108182,2172.841773,4,1,0,3,36,Ruben Alvarenga
2000,103250,2172.832472,2,0,0,2,21,Rodolphe Cadart
1996,103668,2172.830777,2,0,0,2,28,Lazar Magdincev
1998,102574,2172.829747,2,0,0,2,10,Gabriel Trifu
1990,101374,2172.828823,14,5,0,9,3,Leonardo Lavalle
2007,103566,2172.824018,31,13,0,18,3,Michael Llodra
2012,105065,2172.812268,9,3,0,6,12,Tim Smyczek
1990,100924,2172.800772,6,2,0,4,13,Jorge Lozano
2009,103393,2172.795451,2,0,0,2,5,Yuri Schukin
1994,101119,2172.791583,2,0,0,2,16,Marian Vajda
1990,101180,2172.791143,2,0,0,2,22,Jose Clavet
1996,101459,2172.787804,4,1,0,3,20,Tomas Nydahl
1992,101721,2172.785625,5,1,0,4,13,Markus Zillner
1997,101871,2172.780515,2,0,0,2,7,Alexander Reichel
1991,101329,2172.776484,2,0,0,2,40,Christer Allgardh
1994,102215,2172.756847,5,1,0,4,7,Joshua Eagle
1996,101682,2172.756565,2,0,0,2,11,David Adams
2015,106368,2172.751078,2,0,0,2,9,Ramkumar Ramanathan
2010,103240,2172.747451,4,1,0,3,17,Kevin Kim
1995,101979,2172.745951,4,1,0,3,35,Ricardo Mena
2008,103063,2172.733569,2,0,0,2,35,Sebastien De Chaunac
1992,102318,2172.726071,2,0,0,2,17,Andrei Pavel
2004,104559,2172.726045,2,0,0,2,5,Teymuraz Gabashvili
1985,109480,2172.718739,2,0,0,2,26,Alex Roman
1991,101499,2172.716509,2,0,0,2,38,Eduardo Furusho
1987,101243,2172.712849,2,0,0,2,19,Roberto Azar
2015,104952,2172.709187,2,0,0,2,36,Martin Pedersen
1996,101400,2172.708625,4,1,0,3,34,Sofronio Palahang
2003,104527,2172.705848,6,2,0,4,3,Stanislas Wawrinka
2013,105589,2172.705297,2,0,0,2,6,Gerald Melzer
1986,100825,2172.702117,4,1,0,3,4,Hugo Chapacu
2015,104471,2172.701034,19,8,0,11,16,Ivan Dodig
1987,101174,2172.700064,2,0,0,2,5,Fernando Roese
1996,102133,2172.696007,4,1,0,3,14,Laurence Tieleman
1987,101295,2172.688362,2,0,0,2,8,Toshihisa Tsuchihashi
2000,104026,2172.674448,2,0,0,2,2,Joachim Johansson
2001,104014,2172.664566,4,1,0,3,21,Lee Childs
1991,101437,2172.661482,4,1,0,3,34,Seung Ho Ji
2000,103917,2172.657647,2,0,0,2,7,Nicolas Mahut
1988,100892,2172.656559,2,0,0,2,6,Alexandre Hocevar
2011,105064,2172.652679,54,27,0,27,2,Thomaz Bellucci
1985,100240,2172.648551,10,4,0,6,30,Joao Soares
2010,104003,2172.647836,8,3,0,5,6,Victor Crivoi
1985,101251,2172.647778,2,0,0,2,28,Eric Winogradsky
2008,105471,2172.635833,2,0,0,2,35,Cesar Ramirez
1995,101400,2172.631849,2,0,0,2,35,Sofronio Palahang
2001,104026,2172.627492,2,0,0,2,3,Joachim Johansson
2005,104624,2172.625888,2,0,0,2,19,Joshua Goodall
1998,101659,2172.620141,4,1,0,3,10,Jan Apell
1988,106535,2172.614872,4,1,0,3,39,Andres Battad
1995,102359,2172.607879,2,0,0,2,6,Andrew Richardson
1996,102250,2172.60459,4,1,0,3,19,Emanuel Couto
1986,100779,2172.594388,2,0,0,2,24,Kevin Moir
1988,101247,2172.578551,4,1,0,3,27,Stephen Botfield
2015,106299,2172.577811,2,0,0,2,36,Bar Tzuf Botzer
1988,101067,2172.563172,9,3,0,6,17,Philip Johnson
1997,102192,2172.560995,4,1,0,3,15,Luis Adrian Morejon
2011,104850,2172.560802,4,1,0,3,11,Jonathan Dasnieres De Veigy
1998,103877,2172.560245,2,0,0,2,18,Mike Scheidweiler
2005,104261,2172.555547,6,2,0,4,9,Peng Sun
2002,104503,2172.552518,2,0,0,2,31,Guillermo Hormazabal
2015,106100,2172.552474,2,0,0,2,19,Micke Kontinen
1985,100259,2172.53725,2,0,0,2,19,Peter Feigl
1986,100716,2172.537231,2,0,0,2,20,Norm Schellenger
2010,103682,2172.531374,2,0,0,2,40,Kyu Tae Im
2015,104628,2172.51703,2,0,0,2,40,Alexander Kudryavtsev
1985,101236,2172.516332,2,0,0,2,31,Krassimir Lazarov
2002,101735,2172.516332,2,0,0,2,40,Richard Fromberg
1990,101302,2172.51487,2,0,0,2,13,Ola Jonsson J092
1990,101416,2172.514515,10,3,0,7,1,Joao Cunha Silva
2000,101651,2172.510412,2,0,0,2,22,Owen Casey
2000,103157,2172.505542,11,4,0,7,16,Arvind Parmar
2010,103676,2172.505166,2,0,0,2,27,Michael Yani
2011,105827,2172.50315,2,0,0,2,18,Laurynas Grigelis
1989,101659,2172.496049,2,0,0,2,54,Jan Apell
1995,102743,2172.496049,2,0,0,2,44,Ben Ellwood
2010,103395,2172.495822,2,0,0,2,13,Julio Silva
1999,103789,2172.492935,2,0,0,2,13,Irakli Labadze
2004,102851,2172.492931,2,0,0,2,31,Giorgio Galimberti
2005,103937,2172.485693,2,0,0,2,17,Irakli Ushangishvili
1997,101636,2172.483035,2,0,0,2,16,Wade Mcguire
1992,101365,2172.482751,4,1,0,3,17,Paul Wekesa
1992,101973,2172.48205,2,0,0,2,29,Viktor Nagy
1993,106782,2172.47805,2,0,0,2,36,Colin Grant
1993,108831,2172.47805,2,0,0,2,36,Michael Walker
2012,107098,2172.476528,2,0,0,2,35,Gilles Kremer
1985,101038,2172.475706,2,0,0,2,43,Alfonso Mora
1988,106997,2172.475706,2,0,0,2,29,Ferenc Csepai
1991,108615,2172.475706,4,1,0,3,42,Genaro Deleon
1991,108857,2172.475706,2,0,0,2,34,Stewart Doyle
1993,111023,2172.475706,2,0,0,2,36,Aymen Ibrahim Al Ashwak
1994,108753,2172.475706,2,0,0,2,36,Othman Al Anazi
1994,108853,2172.475706,2,0,0,2,19,Allan Cooper
1996,108596,2172.475706,2,0,0,2,34,Ramin Raziyani
1996,108849,2172.475706,2,0,0,2,34,Rohan De Silva
1997,108883,2172.475706,2,0,0,2,33,Kuen Yiep Ho
1999,108634,2172.475706,2,0,0,2,18,Rodrigo Vallejo
2000,100754,2172.475706,4,1,0,3,37,Rafael Avalos Brenes
2001,104063,2172.475706,2,0,0,2,18,Mait Kunnap
2003,101855,2172.475706,4,1,0,3,17,Emmanuel Heussner
2005,108594,2172.475706,4,1,0,3,17,Johnny Arcilla
2006,104162,2172.475706,2,0,0,2,16,Deniss Pavlovs
2006,105094,2172.475706,2,0,0,2,16,Paris Gemouchidis
2007,105656,2172.475706,2,0,0,2,35,Marcelo Arevalo
2009,108699,2172.475706,2,0,0,2,21,Nodar Itonishvili
2013,105442,2172.475706,2,0,0,2,34,Sebastien Vidal
2013,108735,2172.475706,2,0,0,2,34,Rares Cuzdriorean
2013,108786,2172.475706,2,0,0,2,34,Seanon Williams
2015,145023,2172.475706,2,0,0,2,19,Maxim Bulat
1992,101661,2172.474916,2,0,0,2,34,Nicolas Becerra
2010,105122,2172.474408,2,0,0,2,11,Karlis Lejnieks
1994,102050,2172.470462,2,0,0,2,26,Marco Meneschincheri
2002,102437,2172.467423,40,19,0,21,3,Adrian Voinea
1998,101823,2172.466027,4,1,0,3,16,Gerald Mandl
1996,108604,2172.464916,2,0,0,2,28,Pascal Schaul
1989,101419,2172.460435,2,0,0,2,31,Frank Dennhardt
1996,108603,2172.45931,2,0,0,2,43,Helge Koll Frafjord
2003,102831,2172.456247,2,0,0,2,38,Jacobo Diaz
2015,111181,2172.456154,2,0,0,2,11,Pruchya Isarow
1987,106506,2172.456066,2,0,0,2,33,Alkis Papamichael
1987,108552,2172.456066,2,0,0,2,33,Yannos Hadjigeorgiou
1992,102372,2172.455366,2,0,0,2,29,Sule Ladipo
1992,108548,2172.455366,2,0,0,2,29,Yakubu Suleiman
1993,108552,2172.455366,2,0,0,2,30,Yannos Hadjigeorgiou
2013,125573,2172.455366,2,0,0,2,41,Michael Massih
2010,108743,2172.455334,2,0,0,2,40,Rajeev Rajapakse
2000,103974,2172.454518,4,1,0,3,20,Aivaras Balzekas
2000,101939,2172.453847,2,0,0,2,33,Erhan Oral
1993,100652,2172.451045,2,0,0,2,4,Cassio Motta
1988,101552,2172.447923,4,1,0,3,2,Xavier Daufresne
1985,100680,2172.442425,2,0,0,2,25,Peter Johnston
2013,104629,2172.43914,2,0,0,2,40,Adrian Menendez Maceiras
2010,105349,2172.43755,2,0,0,2,30,Harri Heliovaara
2002,103581,2172.436596,29,13,0,16,9,Flavio Saretta
1997,102469,2172.436135,2,0,0,2,19,Solon Peppas
1985,111080,2172.436089,2,0,0,2,31,Nagy Kabaz
1985,106695,2172.435925,2,0,0,2,43,Carlos Claverie
1992,101735,2172.435681,41,16,0,25,6,Richard Fromberg
2015,105992,2172.4309,13,5,0,8,12,Ryan Harrison
2005,107552,2172.430277,2,0,0,2,17,Laurent Bram
2015,105376,2172.428483,4,1,0,3,25,Peter Gojowczyk
2008,104004,2172.427728,2,0,0,2,18,Filip Prpic
2008,104812,2172.422234,2,0,0,2,10,Scoville Jenkins
2009,105790,2172.421364,2,0,0,2,21,Yong Kyu Lim
1991,106576,2172.418725,2,0,0,2,34,Arafat Chekrouni
1985,100924,2172.416329,2,0,0,2,43,Jorge Lozano
2012,104807,2172.406845,2,0,0,2,34,Mehdi Ziadi
2010,105029,2172.40108,2,0,0,2,11,Sergey Betov
2008,104035,2172.395721,32,13,0,19,3,Bobby Reynolds
2006,103761,2172.395209,2,0,0,2,17,Tomas Cakl
1997,102818,2172.392639,2,0,0,2,17,Sergi Duran
1989,100990,2172.391007,41,17,0,24,5,Milan Srejber
2015,105441,2172.380881,8,3,0,5,12,John Patrick Smith
2002,103860,2172.377587,2,0,0,2,8,Timo Nieminen
1994,102029,2172.376087,16,6,0,10,7,Filip Dewulf
2002,103154,2172.374948,2,0,0,2,6,Jaymon Crabb
1998,102997,2172.372894,2,0,0,2,34,Hermes Gamonal
1987,100974,2172.365073,2,0,0,2,17,Jeff Klaparda
2007,102783,2172.36189,20,7,0,13,7,Rainer Schuettler
2003,102548,2172.358226,4,1,0,3,15,Juan Antonio Marin
1998,108821,2172.357012,2,0,0,2,27,Vladimir Margalitadze
2012,105723,2172.338959,7,2,0,5,4,Andrey Kuznetsov
1985,100747,2172.336322,22,10,0,12,5,Glenn Layendecker
1995,102537,2172.330894,2,0,0,2,35,Melvin Tong
2013,103573,2172.328194,4,1,0,3,11,Rik De Voest
2005,104368,2172.319832,2,0,0,2,8,Daniel King Turner
2009,105720,2172.318552,2,0,0,2,5,Stanislav Vovk
2003,103544,2172.307751,4,1,0,3,3,Andy Ram
2002,103715,2172.303075,2,0,0,2,9,Kirill Ivanov Smolensky
1996,102023,2172.302259,2,0,0,2,6,Petr Luxa
2015,103908,2172.295565,19,7,0,12,6,Paul Henri Mathieu
1988,101236,2172.288879,4,1,0,3,29,Krassimir Lazarov
1987,101074,2172.282151,7,2,0,5,3,Carlos Di Laura
2010,104589,2172.273888,2,0,0,2,23,Chris Guccione
2005,104453,2172.273743,2,0,0,2,16,Michael Ryderstedt
1995,103019,2172.269406,2,0,0,2,30,Evgeni Mikheev
2001,103007,2172.269106,2,0,0,2,32,Mounir El Aarej
2005,102730,2172.268713,6,2,0,4,9,Ivo Heuberger
2005,103559,2172.263268,4,1,0,3,8,David Sherwood
2007,102839,2172.262929,24,10,0,14,3,Nicolas Lapentti
2008,108594,2172.261715,2,0,0,2,8,Johnny Arcilla
2010,103573,2172.257882,7,2,0,5,11,Rik De Voest
1988,100910,2172.248934,4,1,0,3,25,Magnus Tideman
1987,100460,2172.235513,6,2,0,4,21,Jose Lopez Maeso
2007,105394,2172.233726,2,0,0,2,9,Ilija Martinoski
2013,105812,2172.232115,2,0,0,2,11,David Agung Susanto
1998,102226,2172.228562,2,0,0,2,29,David Witt
2012,105331,2172.227681,2,0,0,2,35,Petru Alexandru Luncanu
1994,101124,2172.227388,16,6,0,10,8,Paolo Cane
1985,100779,2172.227343,2,0,0,2,10,Kevin Moir
2014,106362,2172.22404,2,0,0,2,8,Laurent Lokoli
1993,101593,2172.222282,8,3,0,5,20,Chris Garner
1985,100833,2172.220061,35,15,0,20,3,Marc Flur
1991,101906,2172.215952,2,0,0,2,7,Yasufumi Yamamoto
2004,102143,2172.215714,5,1,0,4,6,Nicolas Thomann
1996,101783,2172.213304,13,5,0,8,14,Mark Petchey
2005,104864,2172.207441,2,0,0,2,33,Alex Kuznetsov
1991,101154,2172.198144,14,5,0,9,7,Simon Youl
2013,104721,2172.195883,2,0,0,2,33,Josselin Ouanna
2014,105441,2172.190169,2,0,0,2,16,John Patrick Smith
1995,102354,2172.180248,2,0,0,2,6,Jerome Hanquez
1996,102204,2172.162781,2,0,0,2,28,Nebojsa Djordjevic
1996,102403,2172.162781,2,0,0,2,28,Bojan Vujic
2004,103843,2172.162253,11,4,0,7,3,Marco Chiudinelli
1985,107213,2172.16053,2,0,0,2,31,Houcine Saber
2015,105132,2172.160227,2,0,0,2,31,Jurgen Zopp
2005,103060,2172.153369,2,0,0,2,34,Alejandro Hernandez
1989,101809,2172.151002,33,12,0,21,2,Nicolas Pereira
1999,102925,2172.148208,43,17,0,26,2,Justin Gimelstob
2011,104871,2172.136802,28,10,0,18,3,Jeremy Chardy
2000,103900,2172.136462,2,0,0,2,36,David Nalbandian
2007,104001,2172.133198,2,0,0,2,40,Brian Wilson
1992,100431,2172.13188,2,0,0,2,9,Mansour Bahrami
2005,103035,2172.130657,9,3,0,6,14,Alessio Di Mauro
1993,101783,2172.121639,4,1,0,3,23,Mark Petchey
1987,101033,2172.116995,4,1,0,3,23,John Letts
1994,100923,2172.116103,32,12,0,20,6,Wally Masur
1989,100991,2172.115193,6,2,0,4,28,Johnny Goudenbour
1995,101549,2172.107065,19,7,0,12,7,Rodolphe Gilbert
1992,101106,2172.105715,13,5,0,8,9,Peter Lundgren
2014,105154,2172.104318,4,1,0,3,15,Joao Souza
1990,101725,2172.100518,4,1,0,3,25,Gabriel Markus
2004,102722,2172.098033,2,0,0,2,7,Attila Savolt
2012,108779,2172.097528,2,0,0,2,35,Jacob Rasolondrazana
2012,104768,2172.091242,2,0,0,2,42,Juho Paukku
1995,101561,2172.089379,2,0,0,2,9,Nicklas Utgren
2009,108724,2172.087218,2,0,0,2,21,Valentin Rahmine
1992,102226,2172.086083,2,0,0,2,14,David Witt
1994,102563,2172.082333,2,0,0,2,21,Thomas Johansson
2001,102814,2172.079734,2,0,0,2,18,Iurie Gorban
2001,102466,2172.078486,4,1,0,3,9,Jan Kroslak
2009,103188,2172.074589,6,2,0,4,16,Michael Russell
2005,104372,2172.072331,2,0,0,2,19,Alex Bogdanovic
1995,101956,2172.069368,11,4,0,7,13,Mark Knowles
1997,103182,2172.063785,2,0,0,2,17,Markus Hipfl
1989,101055,2172.035626,6,2,0,4,45,Heiner Moraing
2012,104233,2172.032716,2,0,0,2,42,Frederik Nielsen
1988,101024,2172.03259,2,0,0,2,22,Christian Geyer
2005,103865,2172.030725,6,2,0,4,8,Prima Simpatiaji
2002,102310,2172.026096,2,0,0,2,31,Seung Bok Baek
1999,101601,2172.025758,12,5,0,7,9,Brett Steven
1990,101477,2172.02452,2,0,0,2,17,Chris Bailey
2015,111506,2172.024227,2,0,0,2,26,Maxime Hamou
1986,100635,2172.017662,19,8,0,11,2,Mark Dickson
1997,102872,2172.0158,2,0,0,2,11,James Sekulov
1994,101593,2172.010928,2,0,0,2,27,Chris Garner
1998,102107,2172.004583,4,1,0,3,9,Jan Frode Andersen
2014,104251,2171.999323,2,0,0,2,9,Ti Chen
2014,104095,2171.995734,2,0,0,2,36,David Guez
1985,100997,2171.994116,2,0,0,2,43,Roger Smith
1985,107481,2171.994116,2,0,0,2,43,Karl Hale
2011,104071,2171.993466,2,0,0,2,12,Raven Klaasen
1987,100595,2171.991607,4,1,0,3,10,Ronnie Bathman
1996,108873,2171.988003,2,0,0,2,19,Maurizio Capello
2007,108977,2171.98741,2,0,0,2,35,George Khrikadze
1988,102235,2171.986598,5,1,0,4,12,Tommy Ho
2012,105633,2171.973243,2,0,0,2,42,Mohamed Safwat
2008,103151,2171.972549,2,0,0,2,39,Mariano Zabaleta
2014,104890,2171.956271,13,5,0,8,10,Andreas Haider Maurer
1989,100943,2171.954948,2,0,0,2,10,Girts Dzelde
1986,101382,2171.953777,2,0,0,2,44,Marcelo Filippini
1991,107524,2171.952992,2,0,0,2,25,Kodzo Apeti
1992,106870,2171.952992,4,1,0,3,19,Dermot Sweeney
1992,109940,2171.952992,2,0,0,2,35,Ernesto Lingen
1992,111083,2171.952992,2,0,0,2,19,Teza Simunyola
1993,110913,2171.952992,2,0,0,2,21,Marinos Baghdatis
1997,103632,2171.952992,2,0,0,2,33,Luis Horna
1997,108808,2171.952992,4,1,0,3,19,Eugenius Cariovas
2003,104027,2171.952992,2,0,0,2,31,Pablo Gonzalez
2008,105463,2171.952992,2,0,0,2,17,Charalampos Kapogiannis
2008,108704,2171.952992,2,0,0,2,17,Konstantinos Mikos
2011,104236,2171.952992,2,0,0,2,21,Rouzbeh Kamran
2012,108945,2171.952992,2,0,0,2,35,Juan Sebastian Langton
2006,101662,2171.951412,2,0,0,2,30,Selvam Veerasingam
2006,108618,2171.951412,2,0,0,2,36,Karim Alayli
2009,104875,2171.951412,2,0,0,2,21,Denes Lukacs
2011,103630,2171.951412,2,0,0,2,21,Martijn Van Haasteren
2011,108705,2171.947967,2,0,0,2,21,Anis Ghorbel
1993,102538,2171.940314,2,0,0,2,30,Tuomas Ketola
1986,109309,2171.938325,2,0,0,2,32,Steven Schranz
1986,110932,2171.938325,2,0,0,2,32,Denis Galea
2008,104868,2171.932333,2,0,0,2,21,James Ward
2013,105357,2171.929771,6,2,0,4,30,John Millman
1994,101681,2171.927573,7,2,0,5,22,Chris Wilkinson
1993,101066,2171.92708,14,5,0,9,3,Richard Matuszewski
1989,100989,2171.926881,5,1,0,4,18,Ned Caswell
1993,101030,2171.926534,30,13,0,17,11,Goran Prpic
2013,126116,2171.920833,2,0,0,2,4,Jacob Coenraad De Klerk
2006,104673,2171.91832,2,0,0,2,8,Julio Cesar Campozano
1995,103133,2171.916187,2,0,0,2,12,Olivier Mutis
2005,103198,2171.913151,2,0,0,2,8,Justin Bower
2005,103573,2171.913151,2,0,0,2,8,Rik De Voest
2003,108896,2171.912313,2,0,0,2,31,Shahzad Khan
2001,101956,2171.910679,4,1,0,3,33,Mark Knowles
1999,102501,2171.900767,2,0,0,2,16,Johan Landsberg
1996,103114,2171.896886,2,0,0,2,11,Martin Lee
1991,100894,2171.895261,4,1,0,3,24,Francesco Cancellotti
1993,100770,2171.873134,5,1,0,4,7,Peter Moraing
1995,101719,2171.854221,2,0,0,2,5,Frederic Fontang
1994,102469,2171.833991,4,1,0,3,8,Solon Peppas
1994,102147,2171.828079,6,2,0,4,18,Oliver Fernandez
1991,101420,2171.818678,2,0,0,2,7,Vaclav Roubicek
1998,103202,2171.802776,8,3,0,5,7,Oscar Serrano
1998,102397,2171.797364,6,2,0,4,22,Jose Imaz Ruiz
1988,100894,2171.792234,31,13,0,18,3,Francesco Cancellotti
2015,105217,2171.786031,10,3,0,7,11,Thiemo De Bakker
1990,101659,2171.784374,2,0,0,2,16,Jan Apell
2003,104026,2171.782996,7,2,0,5,3,Joachim Johansson
2006,102925,2171.763287,34,14,0,20,10,Justin Gimelstob
2006,104676,2171.76288,2,0,0,2,17,Andreas Beck
1996,103182,2171.761103,5,1,0,4,7,Markus Hipfl
1992,100553,2171.757139,2,0,0,2,6,Nduka Odizor
2015,104847,2171.754181,2,0,0,2,21,Adrien Bossel
2002,103204,2171.753281,2,0,0,2,35,Hugo Armando
1999,102180,2171.743393,2,0,0,2,24,Charles Auffray
2007,104753,2171.737022,6,2,0,4,7,Woong Sun Jun
1997,102347,2171.728184,7,2,0,5,10,Dmitri Tomashevich
2009,105585,2171.726402,4,1,0,3,11,Ze Zhang
1988,108875,2171.705651,2,0,0,2,29,Abou Berthe
1995,101781,2171.701883,4,1,0,3,35,Robert Angelo
1994,101477,2171.700111,4,1,0,3,22,Chris Bailey
2006,104433,2171.686622,18,7,0,11,3,Frank Dancevic
2010,102886,2171.683862,2,0,0,2,5,Frantisek Cermak
2011,104735,2171.680017,38,15,0,23,4,Tobias Kamke
1999,102002,2171.677971,2,0,0,2,10,Davide Scala
2006,104117,2171.669669,2,0,0,2,30,Giovanni Lapentti
1988,100648,2171.664574,2,0,0,2,14,Sadiq Abdullahi
1996,102872,2171.664108,2,0,0,2,11,James Sekulov
2002,102574,2171.654696,2,0,0,2,9,Gabriel Trifu
1990,101650,2171.634811,2,0,0,2,11,Shane Barr
2004,102558,2171.633547,2,0,0,2,25,Eric Taino
1992,102331,2171.617471,4,1,0,3,19,Ilou Lonfo
1993,101765,2171.603697,3,0,0,3,18,Tomas Anzari
2006,103581,2171.596889,20,8,0,12,8,Flavio Saretta
1995,102198,2171.591077,9,3,0,6,6,Paul Kilderry
2015,105899,2171.589904,2,0,0,2,36,Martin Cuevas
1987,101040,2171.585252,5,1,0,4,21,Peter Lindgren
1999,101549,2171.570299,5,1,0,4,8,Rodolphe Gilbert
2002,103948,2171.563773,2,0,0,2,6,Maximilian Abel
1996,102464,2171.563703,2,0,0,2,26,Todd Larkham
1999,101439,2171.561584,4,1,0,3,32,Javier Sanchez
1997,101826,2171.55697,2,0,0,2,31,Alex Lopez Moron
1990,101318,2171.55487,4,1,0,3,3,Javier Frana
2009,103872,2171.550225,4,1,0,3,11,Dimitar Grabuloski
2014,105074,2171.529724,2,0,0,2,40,Ruben Bemelmans
2010,104004,2171.515066,4,1,0,3,6,Filip Prpic
1995,103102,2171.508952,2,0,0,2,10,John Hui
1989,101064,2171.508802,4,1,0,3,12,David Lewis
1995,102269,2171.505099,2,0,0,2,15,Jeff Salzenstein
1995,101409,2171.50319,43,17,0,26,4,Jaime Yzaga
2004,104014,2171.496052,2,0,0,2,21,Lee Childs
1988,107918,2171.492903,2,0,0,2,39,Panomkorn Pladchunil
1986,106458,2171.476547,4,1,0,3,26,Alain Brichant
1997,102133,2171.46107,2,0,0,2,3,Laurence Tieleman
1994,101920,2171.456161,39,18,0,21,6,Jamie Morgan
1997,102887,2171.44595,12,5,0,7,3,Ramon Delgado
2008,103758,2171.436864,2,0,0,2,13,Taylor Dent
1998,103504,2171.427237,4,1,0,3,9,Febi Widhiyanto
2015,106136,2171.407569,4,1,0,3,11,Warit Sornbutnark
1992,101728,2171.399559,2,0,0,2,17,Laszlo Markovits
1993,100815,2171.387334,4,1,0,3,25,David Pate
1993,101864,2171.380822,5,1,0,4,19,Fernon Wibier
2006,103007,2171.376941,2,0,0,2,27,Mounir El Aarej
1993,101122,2171.370956,2,0,0,2,30,Alberto Paris
1999,103337,2171.37044,6,2,0,4,7,Ben Qiang Zhu
2003,102457,2171.345327,2,0,0,2,14,Miles Maclagan
2011,105657,2171.342188,4,1,0,3,7,Marius Copil
2010,104268,2171.33142,34,14,0,20,5,Alejandro Falla
1989,101088,2171.326272,2,0,0,2,39,Larry Scott
1995,102605,2171.316157,2,0,0,2,35,Jaka Bozic
1986,100587,2171.305219,7,2,0,5,8,Steve Guy
1992,100714,2171.302791,2,0,0,2,14,Broderick Dyke
1999,102133,2171.301801,35,14,0,21,2,Laurence Tieleman
1999,102938,2171.300059,4,1,0,3,18,Alejandro Olivera
1993,101888,2171.293084,37,14,0,23,3,Daniel Vacek
2009,104736,2171.279813,4,1,0,3,11,Farrukh Dustov
2007,103534,2171.275325,25,10,0,15,8,Nicolas Devilder
2007,103701,2171.272589,32,14,0,18,3,Diego Hartfield
2009,106090,2171.271116,2,0,0,2,20,Daniel Berta
2014,104571,2171.25857,18,7,0,11,4,Marcos Baghdatis
2010,103228,2171.257983,17,6,0,11,24,Marcos Daniel
1991,101264,2171.25351,6,2,0,4,10,Michael Tauson
2004,103193,2171.251209,2,0,0,2,19,Peter Wessels
1999,102087,2171.2511,8,3,0,5,2,Oleg Ogorodov
1994,101407,2171.238712,4,1,0,3,14,David Engel
1987,101249,2171.201036,2,0,0,2,26,Andrei Olhovskiy
1989,101696,2171.194182,2,0,0,2,15,Federico Mordegan
2002,103835,2171.189716,2,0,0,2,7,Filippo Volandri
1987,101058,2171.18826,20,8,0,12,3,Francisco Yunis
2010,104512,2171.173948,2,0,0,2,22,Ergun Zorlu
2008,103709,2171.165471,2,0,0,2,18,Kristian Pless
2005,102271,2171.162654,2,0,0,2,31,Hicham Arazi
1990,102000,2171.15903,43,20,0,23,1,Aki Rahunen
2010,103206,2171.146212,4,1,0,3,41,Sebastien Grosjean
2003,104379,2171.145604,7,2,0,5,22,Todd Reid
2012,105558,2171.131856,10,3,0,7,12,Guillaume Rufin
2008,104233,2171.129421,4,1,0,3,5,Frederik Nielsen
2008,103657,2171.128961,2,0,0,2,28,Ivo Klec
1990,101392,2171.123403,2,0,0,2,10,Dan Goldberg
1996,102497,2171.117889,2,0,0,2,38,Mashiska Washington
2003,101889,2171.11581,2,0,0,2,8,Todd Woodbridge
2008,103612,2171.101993,4,1,0,3,31,Alexey Kedryuk
2005,108940,2171.096361,2,0,0,2,17,David Josepa
2010,104676,2171.095146,24,9,0,15,11,Andreas Beck
2000,102524,2171.08911,9,3,0,6,17,Neville Godwin
2006,104010,2171.083915,4,1,0,3,17,Dieter Kindlmann
1986,108487,2171.076859,4,1,0,3,26,Waldemar Rogowski
2007,102306,2171.071184,2,0,0,2,25,Michael Kohlmann
1991,101593,2171.068719,19,8,0,11,14,Chris Garner
1985,100696,2171.0678,4,1,0,3,19,Mark Buckley
2004,103530,2171.059446,2,0,0,2,19,Zack Fleishman
1999,101609,2171.053248,2,0,0,2,13,David Wheaton
2000,102905,2171.047731,57,27,0,30,4,Stefan Koubek
1992,101581,2171.017159,2,0,0,2,23,Jose Luis Aparisi
1996,101543,2171.006393,32,14,0,18,3,Jeff Tarango
1990,100551,2170.961253,4,1,0,3,24,Brad Drewett
1989,100935,2170.960445,14,5,0,9,3,Michael Robertson
1988,101097,2170.957367,18,6,0,12,3,Rick Leach
1988,101093,2170.952374,4,1,0,3,24,Steve Devries
2006,104624,2170.947136,2,0,0,2,10,Joshua Goodall
2014,134677,2170.921837,4,1,0,3,32,Juan Borba
1996,101821,2170.916872,6,2,0,4,12,Peter Tramacchi
1993,101866,2170.914646,20,7,0,13,3,David Rikl
2011,104499,2170.913804,4,1,0,3,12,Jimmy Wang
1992,110810,2170.905983,2,0,0,2,35,Lionel Eli
2003,103413,2170.8797,2,0,0,2,8,Genius Chidzikwe
1989,101717,2170.863368,31,12,0,19,9,Diego Nargiso
2003,102902,2170.843392,2,0,0,2,14,Thomas Blake
2000,108587,2170.838846,2,0,0,2,37,Kerlin Leon Zamora
2009,105402,2170.829059,2,0,0,2,21,Peerakiat Siriluethaiwattana
2008,108701,2170.815584,2,0,0,2,31,Juan Sebastian Cabal
2014,105830,2170.779918,4,1,0,3,31,Hicham Khaddari
2001,103131,2170.779225,2,0,0,2,7,Michihisa Onoda
2008,104515,2170.766463,5,1,0,4,18,Mathieu Montcourt
1987,101380,2170.762248,2,0,0,2,10,Amit Naor
1997,101902,2170.755745,2,0,0,2,21,Stephane Huet
2003,103470,2170.742159,16,6,0,10,6,Robert Kendrick
2007,102834,2170.739866,22,9,0,13,12,Paul Goldstein
2013,106105,2170.728688,4,1,0,3,1,Guilherme Clezar
1996,101767,2170.727954,9,3,0,6,6,Lars Jonsson
1989,101126,2170.725123,20,8,0,12,18,Chris Pridham
1985,100906,2170.722673,2,0,0,2,3,Antony Emerson
2002,104011,2170.715662,2,0,0,2,8,Lefteris Alexiou
1999,102730,2170.69906,4,1,0,3,10,Ivo Heuberger
1991,100864,2170.658456,15,6,0,9,7,Martin Wostenholme
2011,104229,2170.658437,33,12,0,21,8,Yen Hsun Lu
1988,101365,2170.646263,12,4,0,8,9,Paul Wekesa
2004,104330,2170.641695,4,1,0,3,11,Rajeev Ram
2012,105831,2170.629134,2,0,0,2,31,Marko Djokovic
2008,102563,2170.626455,37,16,0,21,5,Thomas Johansson
1990,100965,2170.625028,4,1,0,3,13,Peter Ballauff
2009,104233,2170.613847,6,2,0,4,6,Frederik Nielsen
2006,102999,2170.611901,13,5,0,8,6,Stefano Galvani
1997,102464,2170.598253,5,1,0,4,12,Todd Larkham
2009,103428,2170.596016,25,11,0,14,12,Juan Ignacio Chela
1997,102950,2170.567126,21,9,0,12,2,Fernando Vicente
1988,101728,2170.565899,2,0,0,2,34,Laszlo Markovits
2014,105080,2170.55876,2,0,0,2,4,Miloslav Mecir
1991,101407,2170.534011,17,6,0,11,3,David Engel
2001,102214,2170.526807,2,0,0,2,40,Oscar Ortiz
2001,103240,2170.51135,4,1,0,3,14,Kevin Kim
1988,101469,2170.510536,2,0,0,2,13,Brian Garrow
2002,102585,2170.504048,2,0,0,2,16,Sebastian Prieto
2009,103971,2170.49994,11,4,0,7,5,Karol Beck
1987,101076,2170.492543,2,0,0,2,15,Cesar Kist
2007,104624,2170.484017,2,0,0,2,22,Joshua Goodall
2004,103891,2170.472556,2,0,0,2,8,Alexandros Jakupovic
1993,102055,2170.464102,2,0,0,2,36,Bertrand Madsen
1988,100802,2170.461474,2,0,0,2,13,Charles Honey
1995,102436,2170.447128,2,0,0,2,11,Borut Urh
1993,101329,2170.443702,2,0,0,2,5,Christer Allgardh
2005,103849,2170.440801,5,1,0,4,7,Francesco Aldi
1989,108373,2170.427995,2,0,0,2,53,Thierno Ly
1989,101007,2170.426545,14,6,0,8,17,Guillermo Rivas
1987,101481,2170.417475,4,1,0,3,29,Omar Camporese
1988,101284,2170.406104,2,0,0,2,25,Lars Anders Wahlgren
2009,103103,2170.404157,11,4,0,7,4,Dominik Hrbaty
2002,101733,2170.382811,2,0,0,2,16,Jan Siemerink
1985,101147,2170.366346,13,5,0,8,19,Claudio Mezzadri
1992,101659,2170.347518,9,3,0,6,14,Jan Apell
1996,101441,2170.342083,19,7,0,12,3,Martin Sinner
1994,102169,2170.338904,7,2,0,5,13,Michael Joyce
2010,105643,2170.316151,2,0,0,2,10,Federico Delbonis
1994,102477,2170.311114,5,1,0,4,3,Gaston Etlis
1993,101119,2170.300003,2,0,0,2,29,Marian Vajda
1995,101468,2170.285707,9,3,0,6,17,Gerard Solves
2015,105487,2170.26524,6,2,0,4,22,Facundo Bagnis
1988,101031,2170.26141,5,1,0,4,13,Massimo Cierro
1997,101955,2170.250684,12,4,0,8,4,Luis Herrera
2003,101868,2170.242475,10,3,0,7,6,Dick Norman
2011,105723,2170.232256,6,2,0,4,7,Andrey Kuznetsov
1998,108585,2170.225277,2,0,0,2,18,Americo Venero Montes
1996,102139,2170.208143,11,4,0,7,6,Eyal Ran
1992,101280,2170.202598,2,0,0,2,3,Mikael Stadling
1999,103184,2170.200628,7,2,0,5,6,Bob Bryan
1999,102410,2170.186752,2,0,0,2,36,David Caldwell
2002,103264,2170.165251,6,2,0,4,15,Mariano Puerta
2009,104252,2170.159041,9,3,0,6,5,Florian Mayer
2005,103752,2170.154939,2,0,0,2,7,Simon Greul
2004,102610,2170.13829,43,19,0,24,4,Albert Costa
1999,103758,2170.132164,2,0,0,2,11,Taylor Dent
1995,101849,2170.130545,2,0,0,2,8,Nicola Bruno
1996,101819,2170.122576,7,2,0,5,6,Frederic Vitoux
1997,101263,2170.092878,7,2,0,5,18,Luke Jensen
1991,100955,2170.092429,2,0,0,2,6,Yahiya Doumbia
2011,105575,2170.080094,18,8,0,10,17,Ricardas Berankis
1994,101490,2170.061253,13,5,0,8,8,Daniel Orsanic
1993,101590,2170.051328,3,0,0,3,11,Eui Jong Chang
1999,103082,2170.049951,6,2,0,4,10,Markus Hantschk
2004,103201,2170.009332,18,8,0,10,3,Adrian Garcia
1987,100544,2170.003137,21,8,0,13,4,Tony Mmoh
2006,103693,2169.986321,9,3,0,6,3,Thierry Ascione
2008,102567,2169.985174,5,1,0,4,3,George Bastl
1994,101511,2169.98364,27,11,0,16,3,Horst Skoff
1992,101196,2169.982747,47,20,0,27,4,Derrick Rostagno
2013,105547,2169.976017,2,0,0,2,4,Dean Obrien
2006,104198,2169.955128,35,15,0,20,3,Guillermo Garcia Lopez
1985,100383,2169.952618,13,4,0,9,4,Peter Mcnamara
1999,102723,2169.951752,4,1,0,3,16,Eduardo Medica
1989,101263,2169.950107,5,1,0,4,25,Luke Jensen
2002,104259,2169.941041,3,0,0,3,23,Philipp Kohlschreiber
2001,102154,2169.938267,5,1,0,4,18,Marcos Ondruska
2010,105738,2169.928767,7,2,0,5,7,Tsung Hua Yang
1985,100877,2169.910692,4,1,0,3,9,Brett Dickinson
1989,100570,2169.888708,23,9,0,14,3,Marty Davis
2004,103516,2169.858906,2,0,0,2,7,Nathan Healey
1991,101009,2169.857663,2,0,0,2,7,John Sobel
1992,107022,2169.85515,2,0,0,2,24,Francesco Michelotti
2015,105302,2169.851771,2,0,0,2,6,Ante Pavic
1993,101869,2169.846963,2,0,0,2,31,Juan Luis Tati Rascon
2003,104035,2169.814654,2,0,0,2,14,Bobby Reynolds
2002,102401,2169.809764,10,3,0,7,8,Scott Draper
1997,102455,2169.806105,3,0,0,3,7,Lorenzo Manta
1991,102147,2169.786189,2,0,0,2,3,Oliver Fernandez
2003,104312,2169.781786,2,0,0,2,9,Andreas Seppi
2005,104332,2169.751664,2,0,0,2,20,Philipp Petzschner
1986,100286,2169.742651,12,4,0,8,17,Harold Solomon
1990,101412,2169.736144,22,9,0,13,5,Shuzo Matsuoka
1985,100793,2169.731491,11,4,0,7,1,Stephane Bonneau
2006,104499,2169.715744,26,10,0,16,6,Jimmy Wang
1997,101563,2169.705337,4,1,0,3,10,Joseph Lizardo
1997,108886,2169.705337,2,0,0,2,10,Michael John Misa
1993,102147,2169.692126,11,4,0,7,15,Oliver Fernandez
2000,102911,2169.690029,14,5,0,9,4,Andrei Stoliarov
1997,102615,2169.680516,25,10,0,15,11,Dennis Van Scheppingen
2002,103105,2169.675819,3,0,0,3,7,Ruben Ramirez Hidalgo
2005,104229,2169.655975,15,6,0,9,7,Yen Hsun Lu
2003,102780,2169.655809,6,1,0,5,8,Frederic Niemeyer
2007,105559,2169.614379,2,0,0,2,18,Jonathan Eysseric
1986,101115,2169.606204,8,2,0,6,13,Jorge Bardou
2015,106232,2169.59961,2,0,0,2,11,Roberto Cid
1993,101126,2169.597261,26,11,0,15,6,Chris Pridham
1994,101945,2169.59193,7,2,0,5,4,Thierry Guardiola
1995,101377,2169.574661,7,2,0,5,6,Christian Bergstrom
1992,101797,2169.533501,41,18,0,23,3,Jacco Eltingh
1987,101233,2169.532189,17,7,0,10,6,Alex Antonitsch
2015,104505,2169.504304,2,0,0,2,11,Konstantin Kravchuk
2005,104996,2169.500401,2,0,0,2,17,Alexander Blom
2014,104068,2169.491492,11,3,0,8,11,Robby Ginepri
1987,100939,2169.477248,15,5,0,10,6,Joey Rive
2002,101611,2169.465591,26,10,0,16,3,Cedric Pioline
2014,103565,2169.426682,13,5,0,8,19,Stephane Robert
1988,101265,2169.426332,7,2,0,5,3,Patrick Mcenroe
2001,103468,2169.425669,3,0,0,3,5,Harsh Mankad
1998,101479,2169.423593,2,0,0,2,7,TJ Middleton
1988,101934,2169.399648,5,1,0,4,22,Paul Dogger
2007,104216,2169.357583,2,0,0,2,16,Maximo Gonzalez
1988,100966,2169.297195,4,1,0,3,27,Nick Fulwood
2013,105539,2169.275766,33,13,0,20,6,Evgeny Donskoy
1986,100628,2169.222054,45,20,0,25,4,Michiel Schapers
1988,101009,2169.215052,2,0,0,2,8,John Sobel
2012,104330,2169.206687,16,7,0,9,5,Rajeev Ram
2001,103888,2169.204112,13,5,0,8,12,Mardy Fish
1995,101263,2169.191141,10,3,0,7,13,Luke Jensen
2004,103035,2169.169434,4,1,0,3,7,Alessio Di Mauro
2014,111511,2169.15955,2,0,0,2,10,Noah Rubin
2015,105902,2169.136398,20,9,0,11,9,James Duckworth
2010,104926,2169.126901,42,16,0,26,2,Fabio Fognini
2002,102607,2169.097375,19,7,0,12,9,Juan Balcells
2013,106298,2169.011165,5,1,0,4,24,Lucas Pouille
1988,101019,2168.98311,5,1,0,4,27,David Felgate
1997,102029,2168.964776,46,22,0,24,2,Filip Dewulf
1986,100826,2168.948333,5,1,0,4,15,Juan Antonio Rodriguez
2009,105777,2168.939719,10,4,0,6,6,Grigor Dimitrov
2001,101885,2168.921744,43,19,0,24,0,Wayne Arthurs
1995,101962,2168.898152,12,4,0,8,10,Younes El Aynaoui
2004,102179,2168.897142,38,17,0,21,3,Antony Dupuis
1993,101594,2168.889984,12,4,0,8,6,Carsten Arriens
1998,103758,2168.873718,4,1,0,3,11,Taylor Dent
2006,105023,2168.855383,17,6,0,11,10,Sam Querrey
1988,101263,2168.84447,4,1,0,3,10,Luke Jensen
1993,101897,2168.835308,15,6,0,9,3,Fernando Meligeni
2003,102179,2168.80896,39,17,0,22,3,Antony Dupuis
1991,101685,2168.773683,2,0,0,2,21,Markus Naewie
2003,102998,2168.768573,47,22,0,25,3,Jan Michael Gambill
1998,101735,2168.76574,57,26,0,31,3,Richard Fromberg
2012,105051,2168.746061,40,17,0,23,4,Matthew Ebden
1997,103084,2168.738712,5,1,0,4,3,Guillermo Canas
1988,101251,2168.73367,15,5,0,10,2,Eric Winogradsky
2001,102574,2168.72485,7,2,0,5,9,Gabriel Trifu
2005,103535,2168.707838,7,2,0,5,22,Olivier Patience
1988,101256,2168.685918,9,3,0,6,10,Mark Kratzmann
2008,102905,2168.646688,11,4,0,7,5,Stefan Koubek
2003,102023,2168.591722,3,0,0,3,7,Petr Luxa
2012,104262,2168.591346,40,17,0,23,6,Flavio Cipolla
2004,103455,2168.578973,2,0,0,2,20,Michal Mertinak
2015,105550,2168.561058,9,3,0,6,1,Guido Pella
2001,102143,2168.556052,7,2,0,5,3,Nicolas Thomann
2006,103714,2168.5412,5,1,0,4,5,Andreas Vinciguerra
1991,100972,2168.532593,28,12,0,16,13,Todd Witsken
1991,101932,2168.521401,4,1,0,3,13,Jared Palmer
1999,103484,2168.510447,5,1,0,4,11,James Blake
1988,100934,2168.49997,27,10,0,17,3,Matt Anger
2004,103029,2168.488813,3,0,0,3,8,Mehdi Tahiri
2015,105053,2168.471037,51,23,0,28,5,Santiago Giraldo
1988,101007,2168.469832,3,0,0,3,5,Guillermo Rivas
2006,103709,2168.422045,15,5,0,10,6,Kristian Pless
1996,102687,2168.410657,5,1,0,4,17,Herbert Wiltschnig
2006,103252,2168.378857,40,18,0,22,10,Alberto Martin
1990,101097,2168.371095,10,3,0,7,1,Rick Leach
1990,101080,2168.35715,30,12,0,18,6,Lawson Duncan
2001,103171,2168.325612,24,9,0,15,9,Raemon Sluiter
1992,101050,2168.309031,10,4,0,6,18,Martin Laurendeau
2007,104180,2168.290526,9,3,0,6,9,Gilles Muller
1986,100799,2168.279338,5,1,0,4,4,Carlos Castellan
1999,101772,2168.267547,9,3,0,6,2,Andrei Cherkasov
1998,102615,2168.253507,27,11,0,16,3,Dennis Van Scheppingen
2007,104122,2168.237719,23,9,0,14,3,Carlos Berlocq
1995,101772,2168.232728,7,2,0,5,17,Andrei Cherkasov
1999,102966,2168.2296,10,3,0,7,6,Fredrik Jonsson
1988,100899,2168.185449,5,1,0,4,6,Jorgen Windahl
2005,104433,2168.16906,11,4,0,7,8,Frank Dancevic
1992,101722,2168.15302,3,0,0,3,10,Han Cheol Shin
2010,105065,2168.141351,5,1,0,4,13,Tim Smyczek
2006,104056,2168.119633,5,1,0,4,3,Roko Karanusic
1997,101926,2168.086058,7,2,0,5,11,Andrei Merinov
1998,103735,2168.084135,2,0,0,2,9,Lovro Zovko
1989,101378,2168.062752,11,4,0,7,31,Tore Meinecke
1992,102238,2168.054831,19,8,0,11,3,Alberto Berasategui
1996,101026,2168.042688,16,6,0,10,3,Jim Grabb
2006,103169,2168.00267,8,2,0,6,7,Oscar Hernandez
2009,103490,2167.991886,13,5,0,8,10,Santiago Ventura
1985,101035,2167.984063,12,5,0,7,4,Menno Oosting
1986,100964,2167.974408,5,1,0,4,8,Jon Levine
1988,101149,2167.92976,5,1,0,4,14,Morten Christensen
1997,102106,2167.892348,16,5,0,11,2,Davide Sanguinetti
1993,102521,2167.892148,7,2,0,5,3,Hendrik Dreekmann
2009,102780,2167.87302,5,1,0,4,15,Frederic Niemeyer
1995,101133,2167.859283,14,6,0,8,14,Patrick Baur
1986,101040,2167.835252,4,1,0,3,19,Peter Lindgren
1996,102019,2167.834939,10,3,0,7,12,Dirk Dier
2006,103369,2167.8253,5,1,0,4,19,Melle Van Gemerden
2004,103181,2167.815584,11,4,0,7,3,Jiri Vanek
1993,101685,2167.807252,23,9,0,14,6,Markus Naewie
2003,102374,2167.79569,37,14,0,23,3,Alex Corretja
2011,104534,2167.779387,28,11,0,17,2,Dudi Sela
1990,100431,2167.772815,5,1,0,4,6,Mansour Bahrami
2004,102344,2167.76425,26,11,0,15,5,Karol Kucera
2012,104932,2167.757867,5,1,0,4,10,Kenny De Schepper
1989,101475,2167.740142,7,2,0,5,13,Carlos Costa
1990,101398,2167.729454,5,1,0,4,10,Neil Borwick
1998,102069,2167.696162,3,0,0,3,34,Andrei Rybalko
1988,100865,2167.665252,14,5,0,9,2,Marcelo Ingaramo
2010,105074,2167.661012,6,1,0,5,9,Ruben Bemelmans
1993,101133,2167.64797,14,5,0,9,18,Patrick Baur
2002,103318,2167.580002,13,5,0,8,5,Zeljko Krajan
2003,102381,2167.54559,9,3,0,6,6,Werner Eschauer
2013,105436,2167.52804,6,2,0,4,6,Markus Eriksson
1986,100837,2167.519123,29,12,0,17,3,Jeremy Bates
1994,101767,2167.514085,44,19,0,25,3,Lars Jonsson
1990,101593,2167.496847,15,6,0,9,1,Chris Garner
1994,101145,2167.450357,3,0,0,3,14,Jonathan Canter
2008,104619,2167.412244,7,2,0,5,8,Jesse Huta Galung
2011,103429,2167.386664,5,1,0,4,18,Peter Luczak
2015,104291,2167.380917,32,12,0,20,6,Malek Jaziri
2003,103157,2167.380307,7,2,0,5,3,Arvind Parmar
1989,101279,2167.356604,5,1,0,4,18,Philippe Pech
2006,104926,2167.312227,7,2,0,5,7,Fabio Fognini
1997,102061,2167.267819,11,4,0,7,15,Kevin Ullyett
1989,100701,2167.252977,15,5,0,10,13,Marko Ostoja
1987,100877,2167.1151,3,0,0,3,25,Brett Dickinson
2005,103201,2167.114851,7,2,0,5,8,Adrian Garcia
2004,101924,2167.092352,5,1,0,4,17,Stefano Pescosolido
1989,100833,2167.073063,3,0,0,3,16,Marc Flur
1997,102269,2167.061256,13,4,0,9,12,Jeff Salzenstein
1986,100669,2167.056021,7,2,0,5,9,Charles Bud Cox
1994,102521,2167.035828,37,15,0,22,3,Hendrik Dreekmann
1995,102477,2167.027796,14,5,0,9,3,Gaston Etlis
1991,101971,2167.022617,13,5,0,8,7,Johan Anderson
1993,101775,2166.985699,6,1,0,5,11,Frederik Fetterlein
2000,103252,2166.951,48,20,0,28,4,Alberto Martin
2015,105575,2166.933261,34,14,0,20,6,Ricardas Berankis
2005,103580,2166.911965,3,0,0,3,5,Alexander Peya
1995,102259,2166.89215,18,7,0,11,4,Jerome Golmard
1986,101663,2166.866691,2,0,0,2,12,Eugenio Rossi
2004,103535,2166.864423,27,12,0,15,5,Olivier Patience
2001,103566,2166.85911,17,6,0,11,2,Michael Llodra
1995,101703,2166.821427,39,17,0,22,4,Guillaume Raoux
1996,102455,2166.810659,2,0,0,2,14,Lorenzo Manta
1993,101955,2166.806951,28,11,0,17,20,Luis Herrera
1999,101956,2166.789908,7,2,0,5,5,Mark Knowles
1989,101613,2166.781126,7,2,0,5,5,Malivai Washington
2009,104214,2166.766391,59,28,0,31,3,Igor Andreev
2012,104229,2166.758552,30,12,0,18,7,Yen Hsun Lu
2003,103451,2166.71603,5,1,0,4,6,Bjorn Phau
2010,105332,2166.706751,5,1,0,4,4,Benoit Paire
1985,101378,2166.693224,7,2,0,5,1,Tore Meinecke
1989,101500,2166.656258,31,13,0,18,4,Christian Saceanu
1988,101020,2166.653769,14,5,0,9,13,Hans Schwaier
2009,103808,2166.653115,40,16,0,24,5,Potito Starace
1991,100532,2166.639539,10,3,0,7,6,Johan Kriek
1998,102567,2166.638795,5,1,0,4,18,George Bastl
2003,102770,2166.628445,24,10,0,14,3,John Van Lottum
1992,101097,2166.593993,3,0,0,3,3,Rick Leach
2001,103852,2166.589379,7,2,0,5,19,Feliciano Lopez
2011,104262,2166.583873,17,5,0,12,9,Flavio Cipolla
1989,101789,2166.576273,7,2,0,5,16,Steve Bryan
1989,101035,2166.575593,5,1,0,4,9,Menno Oosting
2001,102776,2166.554891,48,20,0,28,7,Andrew Ilie
1998,101463,2166.548047,13,5,0,8,10,Bernd Karbacher
2010,104592,2166.523857,5,1,0,4,18,Ilija Bozoljac
2010,104068,2166.506359,22,8,0,14,13,Robby Ginepri
2010,104460,2166.501248,16,6,0,10,10,Dustin Brown
1994,101432,2166.497808,22,9,0,13,6,Dimitri Poliakov
1987,100836,2166.482338,17,7,0,10,7,Glenn Michibata
1998,102463,2166.47842,27,11,0,16,2,Lucas Arnold Ker
1985,100477,2166.475556,15,5,0,10,10,Gianni Ocleppo
1986,101340,2166.459253,5,1,0,4,8,Ricky Brown
1995,101761,2166.452109,5,1,0,4,5,Jaime Oncins
2008,103821,2166.39298,6,2,0,4,6,Danai Udomchoke
1990,101789,2166.389321,5,1,0,4,9,Steve Bryan
2009,104117,2166.38869,7,2,0,5,6,Giovanni Lapentti
2010,104225,2166.378647,34,13,0,21,3,Jan Hajek
2005,102562,2166.373929,49,22,0,27,2,Jiri Novak
2001,102987,2166.361246,23,8,0,15,7,Andre Sa
2003,103857,2166.359971,3,0,0,3,6,Igor Kunitsyn
2008,104665,2166.351385,9,3,0,6,5,Pablo Andujar
1995,102243,2166.337275,5,1,0,4,14,Marcelo Charpentier
1996,101602,2166.321144,3,0,0,3,20,Jack Waite
1986,100617,2166.306338,39,15,0,24,3,Bud Schultz
1987,101035,2166.285976,5,1,0,4,21,Menno Oosting
2010,104281,2166.283928,3,0,0,3,9,Ryler Deheart
2006,102567,2166.282614,14,5,0,9,3,George Bastl
2007,105579,2166.267085,3,0,0,3,8,Kittipong Wachiramanowong
1994,101430,2166.224122,9,3,0,6,5,Sergio Cortes
2012,105099,2166.209828,9,3,0,6,19,Antonio Veic
1988,100817,2166.202885,3,0,0,3,21,Mark Basham
1995,102234,2166.185695,23,9,0,14,6,Oliver Gross
1997,102087,2166.183539,21,9,0,12,3,Oleg Ogorodov
2013,105173,2166.174341,25,10,0,15,3,Adrian Mannarino
2004,104548,2166.173176,7,2,0,5,11,Brian Baker
1985,100624,2166.168805,5,1,0,4,21,Derek Tarr
1986,101476,2166.152953,3,0,0,3,8,Rolf Hertzog
2000,102401,2166.149678,7,2,0,5,19,Scott Draper
1999,103264,2166.1465,44,17,0,27,7,Mariano Puerta
2009,103714,2166.109374,12,4,0,8,6,Andreas Vinciguerra
1995,101767,2166.061182,16,6,0,10,14,Lars Jonsson
1989,100587,2166.060321,14,5,0,9,9,Steve Guy
2008,103240,2166.038753,3,0,0,3,6,Kevin Kim
1988,101324,2166.012313,17,6,0,11,16,Ulf Stenlund
1989,101029,2166.008118,12,4,0,8,9,Ricki Osterthun
2015,111577,2165.993648,11,4,0,7,12,Jared Donaldson
2000,103184,2165.975746,11,4,0,7,14,Bob Bryan
2001,104117,2165.966943,3,0,0,3,9,Giovanni Lapentti
1995,102148,2165.915701,41,16,0,25,4,Fabrice Santoro
2008,104978,2165.913202,5,1,0,4,18,Daniel Brands
2003,103248,2165.913196,11,4,0,7,14,Harel Levy
1993,102184,2165.891005,41,16,0,25,3,David Prinosil
1999,102987,2165.886939,5,1,0,4,20,Andre Sa
1989,101365,2165.869205,11,4,0,7,39,Paul Wekesa
2002,101647,2165.850388,9,3,0,6,8,Byron Black
1991,100946,2165.829627,12,4,0,8,10,Slobodan Zivojinovic
2011,104857,2165.765136,5,1,0,4,5,Robert Farah
1995,101016,2165.713591,3,0,0,3,14,Marcos Aurelio Gorriz
2001,102110,2165.685702,9,3,0,6,16,Daniel Nestor
1992,100815,2165.6847,5,1,0,4,8,David Pate
1995,102271,2165.596717,9,3,0,6,10,Hicham Arazi
1996,101833,2165.596268,29,13,0,16,6,Michael Tebbutt
1993,107310,2165.590567,3,0,0,3,21,Jean Nabi
2006,101885,2165.561499,18,7,0,11,3,Wayne Arthurs
1989,100619,2165.559424,7,2,0,5,22,George Kalovelonis
1986,100618,2165.548455,7,2,0,5,3,Leif Shiras
2004,102369,2165.523892,5,1,0,4,21,Julien Boutter
1996,101660,2165.517698,7,2,0,5,14,Francisco Montana
2001,103282,2165.50669,3,0,0,3,32,Tiago Sousa
2011,103454,2165.479387,3,0,0,3,12,Nicolas Massu
1985,100515,2165.447635,29,11,0,18,4,Shlomo Glickstein
1986,100865,2165.389977,24,9,0,15,4,Marcelo Ingaramo
1985,100119,2165.388531,5,1,0,4,11,Ilie Nastase
1997,103252,2165.383235,22,9,0,13,2,Alberto Martin
1989,101459,2165.375651,14,5,0,9,9,Tomas Nydahl
2002,102834,2165.368984,4,1,0,3,12,Paul Goldstein
2002,102548,2165.368641,12,4,0,8,7,Juan Antonio Marin
1989,101265,2165.365961,6,1,0,5,8,Patrick Mcenroe
2011,103565,2165.359864,7,2,0,5,11,Stephane Robert
1990,101668,2165.353917,3,0,0,3,18,Peter Nyborg
1986,101007,2165.339606,3,0,0,3,4,Guillermo Rivas
1985,100652,2165.328123,20,8,0,12,16,Cassio Motta
2004,104166,2165.323482,27,10,0,17,6,Alex Bogomolov Jr
1996,102304,2165.291736,3,0,0,3,16,Grant Doyle
1998,101772,2165.281112,3,0,0,3,2,Andrei Cherkasov
1993,101482,2165.27005,23,9,0,14,6,Markus Zoecke
1986,100884,2165.260718,3,0,0,3,24,Steve Shaw
2015,103582,2165.259363,16,6,0,10,12,Michael Berrer
2011,104535,2165.228705,5,1,0,4,12,Daniel Garza
1987,100240,2165.21791,3,0,0,3,5,Joao Soares
2002,104068,2165.21004,18,6,0,12,10,Robby Ginepri
1992,100978,2165.208381,3,0,0,3,17,Andrew Castle
2010,103096,2165.201383,40,16,0,24,2,Arnaud Clement
2001,102607,2165.166287,43,19,0,24,3,Juan Balcells
1990,101338,2165.163794,3,0,0,3,6,Olivier Soules
2013,104386,2165.159965,44,20,0,24,5,Janko Tipsarevic
2011,104882,2165.097597,32,14,0,18,13,Blaz Kavcic
2013,103926,2165.089431,7,2,0,5,21,Daniel Munoz De La Nava
1999,102524,2165.077171,5,1,0,4,9,Neville Godwin
1986,101461,2165.063063,3,0,0,3,8,Brett Custer
1999,101711,2165.059294,10,3,0,7,15,Alex Obrien
1988,100652,2165.041504,19,7,0,12,2,Cassio Motta
1997,103305,2165.028905,3,0,0,3,18,Daniel Elsner
1997,102965,2165.025991,3,0,0,3,21,Jamie Delgado
2006,105385,2165.007179,3,0,0,3,10,Donald Young
1997,102548,2164.995873,22,9,0,13,2,Juan Antonio Marin
2001,101611,2164.990891,39,17,0,22,2,Cedric Pioline
2013,103444,2164.988813,3,0,0,3,34,Jean Rene Lisnard
1988,100957,2164.973529,22,8,0,14,3,Greg Holmes
1989,100553,2164.947218,12,4,0,8,9,Nduka Odizor
2008,104753,2164.941369,7,2,0,5,8,Woong Sun Jun
2003,102464,2164.920469,5,1,0,4,9,Todd Larkham
1990,100865,2164.918395,5,1,0,4,8,Marcelo Ingaramo
1998,101382,2164.898154,26,9,0,17,9,Marcelo Filippini
2002,102642,2164.886227,11,3,0,8,3,Cyril Saulnier
1988,101964,2164.823471,5,1,0,4,9,Goran Ivanisevic
1999,102029,2164.807906,6,1,0,5,2,Filip Dewulf
2013,104804,2164.779431,7,2,0,5,12,Amir Weintraub
1995,103009,2164.777906,5,1,0,4,5,Razvan Sabau
2005,103586,2164.774415,3,0,0,3,9,Mariusz Fyrstenberg
1997,102465,2164.749263,11,4,0,7,2,Gabriel Silberstein
2006,102694,2164.741524,11,4,0,7,3,Lars Burgsmuller
2007,102434,2164.728671,52,24,0,28,2,Vincent Spadea
2008,105041,2164.726453,5,1,0,4,8,Lukas Lacko
1994,100763,2164.723529,38,18,0,20,3,Brad Gilbert
2005,103499,2164.713623,5,1,0,4,8,Aqeel Khan
2001,103294,2164.707959,38,14,0,24,2,Christophe Rochus
1995,102139,2164.7048,9,3,0,6,6,Eyal Ran
1985,101124,2164.697537,7,2,0,5,19,Paolo Cane
1988,101126,2164.694951,33,15,0,18,8,Chris Pridham
2001,103917,2164.671613,5,1,0,4,2,Nicolas Mahut
2013,104660,2164.665749,28,11,0,17,6,Sergiy Stakhovsky
2000,103182,2164.657229,22,9,0,13,14,Markus Hipfl
2005,104182,2164.656131,3,0,0,3,7,Sasa Tuksar
2008,104160,2164.625457,7,2,0,5,3,Lukas Dlouhy
1994,101612,2164.612444,7,2,0,5,6,Roland Burtscher
2008,104770,2164.579429,3,0,0,3,5,Martin Fischer
1998,101591,2164.570729,3,0,0,3,5,Danny Sapsford
2007,104620,2164.562013,24,9,0,15,3,Simone Bolelli
1996,101745,2164.551189,5,1,0,4,3,Roberto Jabali
1994,102205,2164.543631,22,8,0,14,3,Sebastien Lareau
1996,101196,2164.541667,7,2,0,5,20,Derrick Rostagno
1985,100751,2164.521481,16,6,0,10,1,Roberto Saad
1997,102131,2164.511426,5,1,0,4,10,Alistair Hunt
2013,105657,2164.510671,9,3,0,6,6,Marius Copil
1988,101481,2164.49693,12,4,0,8,14,Omar Camporese
2003,103373,2164.479096,5,1,0,4,14,Sergio Roitman
2011,105894,2164.466689,5,1,0,4,4,Javier Marti
2001,102921,2164.461303,5,1,0,4,7,Ota Fukarek
2015,105872,2164.460026,5,1,0,4,18,Christian Lindell
2006,103917,2164.452609,30,11,0,19,2,Nicolas Mahut
2010,104976,2164.452309,13,4,0,9,13,Ryan Sweeting
2007,103857,2164.439183,40,16,0,24,3,Igor Kunitsyn
2011,105688,2164.436564,3,0,0,3,38,Manuel Sanchez
2006,103920,2164.422011,3,0,0,3,8,Sanchai Ratiwatana
1993,101354,2164.403554,11,3,0,8,16,Andrew Sznajder
2009,103676,2164.384603,3,0,0,3,9,Michael Yani
2005,102610,2164.382776,30,13,0,17,4,Albert Costa
1993,101374,2164.379734,15,6,0,9,29,Leonardo Lavalle
1994,101285,2164.374914,8,2,0,6,11,Thierry Champion
1989,101174,2164.353025,5,1,0,4,2,Fernando Roese
2001,102443,2164.345892,5,1,0,4,7,Barry Cowan
1986,100639,2164.332691,14,5,0,9,2,Blaine Willenborg
1989,100922,2164.327408,10,3,0,7,15,Roberto Arguello
2011,105899,2164.317048,3,0,0,3,21,Martin Cuevas
2007,105217,2164.312679,5,1,0,4,20,Thiemo De Bakker
1991,101543,2164.299117,39,16,0,23,3,Jeff Tarango
2008,103529,2164.295221,5,1,0,4,7,Aisam Ul Haq Qureshi
1999,102521,2164.252772,26,11,0,15,8,Hendrik Dreekmann
2012,104112,2164.248886,5,1,0,4,33,Benjamin Balleret
1989,100714,2164.21208,21,8,0,13,8,Broderick Dyke
2015,105341,2164.205243,3,0,0,3,18,Thomas Fabbiano
2011,104268,2164.178673,26,10,0,16,5,Alejandro Falla
1990,100930,2164.168022,15,6,0,9,3,Paul Vojtischek
2004,102998,2164.144278,43,18,0,25,3,Jan Michael Gambill
1994,102146,2164.127368,52,21,0,31,3,Jordi Burillo
2005,103429,2164.126593,15,5,0,10,6,Peter Luczak
1987,101154,2164.096491,21,8,0,13,3,Simon Youl
1991,101731,2164.093538,26,11,0,15,12,Nuno Marques
2007,104371,2164.086098,5,1,0,4,6,Ivo Minar
2012,105738,2164.077246,5,1,0,4,9,Tsung Hua Yang
1989,101014,2164.065755,8,2,0,6,12,John Ross
2010,105899,2164.059627,3,0,0,3,30,Martin Cuevas
2014,105216,2164.046792,3,0,0,3,14,Yuichi Sugita
1988,101115,2164.039747,3,0,0,3,26,Jorge Bardou
2000,102494,2164.038649,18,7,0,11,13,Tomas Behrend
2012,104999,2164.025157,3,0,0,3,10,Mischa Zverev
2008,103401,2164.01843,12,4,0,8,5,Jan Hernych
1988,100714,2163.963747,34,15,0,19,3,Broderick Dyke
1998,102694,2163.954681,19,7,0,12,2,Lars Burgsmuller
2013,103451,2163.952237,8,2,0,6,36,Bjorn Phau
1990,100896,2163.950451,16,6,0,10,3,Miguel Nido
2010,105385,2163.914325,9,3,0,6,13,Donald Young
1998,101636,2163.87871,3,0,0,3,13,Wade Mcguire
1988,101312,2163.878647,4,0,0,4,15,Robbie Weiss
1993,102205,2163.858502,8,2,0,6,19,Sebastien Lareau
2006,104779,2163.848692,3,0,0,3,8,Jamie Baker
2014,104500,2163.826354,18,7,0,11,7,Somdev Devvarman
1992,100901,2163.810072,5,1,0,4,13,Paul Annacone
2011,103799,2163.796056,3,0,0,3,11,Eric Prodon
1989,101772,2163.784503,33,14,0,19,4,Andrei Cherkasov
1990,101552,2163.761338,5,1,0,4,3,Xavier Daufresne
1990,100284,2163.759795,3,0,0,3,6,Jimmy Connors
1994,101821,2163.75561,3,0,0,3,11,Peter Tramacchi
1988,100782,2163.730782,32,15,0,17,2,Pablo Arraya
2012,103735,2163.707543,3,0,0,3,27,Lovro Zovko
1994,101353,2163.705118,3,0,0,3,8,Lionel Barthez
1997,101510,2163.673531,7,2,0,5,2,Henrik Holm
2005,102703,2163.665837,31,12,0,19,7,Hyung Taik Lee
1996,103193,2163.638173,3,0,0,3,6,Peter Wessels
2013,104714,2163.609466,9,3,0,6,20,Julian Reister
2011,102967,2163.599138,3,0,0,3,13,Marc Gicquel
1988,100606,2163.545699,5,1,0,4,24,Mike Bauer
1997,103344,2163.524938,5,1,0,4,14,Ivan Ljubicic
1985,100611,2163.49959,17,6,0,11,16,Mel Purcell
2007,103035,2163.484467,13,5,0,8,26,Alessio Di Mauro
1988,101650,2163.477227,6,1,0,5,10,Shane Barr
2002,103333,2163.458212,5,1,0,4,21,Ivo Karlovic
1999,102233,2163.440213,16,6,0,10,6,Leander Paes
1996,101549,2163.425853,3,0,0,3,11,Rodolphe Gilbert
1988,101243,2163.42011,9,3,0,6,2,Roberto Azar
2009,104010,2163.407332,4,0,0,4,4,Dieter Kindlmann
2012,103344,2163.398489,9,3,0,6,33,Ivan Ljubicic
1987,100876,2163.386559,5,1,0,4,22,Bong Soo Kim
1997,102259,2163.380159,28,12,0,16,12,Jerome Golmard
2008,104500,2163.376338,7,2,0,5,8,Somdev Devvarman
1988,101358,2163.363002,5,1,0,4,9,Olivier Delaitre
2004,103506,2163.332189,10,3,0,7,14,Martin Vassallo Arguello
1991,100800,2163.327361,16,6,0,10,9,Diego Perez
1991,100950,2163.307586,5,1,0,4,5,Libor Pimek
1986,100362,2163.294219,16,6,0,10,9,Peter Fleming
1999,102519,2163.288059,5,1,0,4,30,Marcio Carlsson
2013,104890,2163.275271,10,3,0,7,6,Andreas Haider Maurer
1994,101606,2163.267933,7,2,0,5,29,Alberto Mancini
1988,101532,2163.255495,5,1,0,4,2,Francisco Clavet
1990,101256,2163.232068,44,21,0,23,1,Mark Kratzmann
1998,103568,2163.215843,5,1,0,4,9,Valentin Sanon
1987,101727,2163.205713,5,1,0,4,10,Jason Stoltenberg
2008,104557,2163.165583,3,0,0,3,8,Andis Juska
2005,103193,2163.161922,25,10,0,15,6,Peter Wessels
2014,104676,2163.157062,3,0,0,3,10,Andreas Beck
2003,102957,2163.119712,7,2,0,5,31,Vadim Kutsenko
1998,103026,2163.117259,3,0,0,3,34,Teo Susnjak
2011,105015,2163.115345,3,0,0,3,31,Franco Skugor
1995,101444,2163.102322,5,1,0,4,35,Bonit Wiryawan
1998,103096,2163.100498,38,13,0,25,2,Arnaud Clement
1988,100997,2163.076238,26,10,0,16,3,Roger Smith
1985,101115,2163.075439,8,2,0,6,13,Jorge Bardou
1995,102106,2163.071503,3,0,0,3,17,Davide Sanguinetti
2006,103758,2163.070825,5,1,0,4,34,Taylor Dent
2014,103582,2163.05289,9,3,0,6,14,Michael Berrer
1987,107480,2163.033714,3,0,0,3,28,Karel Demuynck
1987,101366,2163.016539,3,0,0,3,19,David Macpherson
2003,103273,2163.007741,3,0,0,3,31,Dong Hyun Kim
2001,103176,2163.001487,31,12,0,19,3,David Sanchez
2007,103999,2162.996909,5,1,0,4,20,Thiago Alves
2002,102544,2162.973001,3,0,0,3,17,Pablo Bianchi
2005,102269,2162.952781,5,1,0,4,33,Jeff Salzenstein
2000,102198,2162.941288,3,0,0,3,19,Paul Kilderry
2010,103917,2162.929212,10,3,0,7,2,Nicolas Mahut
2013,105558,2162.91794,22,8,0,14,13,Guillaume Rufin
1986,100844,2162.908147,6,1,0,5,9,Jerome Potier
2007,103722,2162.901919,40,16,0,24,5,Florent Serra
1989,101611,2162.858921,3,0,0,3,31,Cedric Pioline
1992,108277,2162.857965,3,0,0,3,17,Srdan Muskatirovic
2000,101750,2162.835965,5,1,0,4,23,Cristiano Caratti
1997,101929,2162.832289,3,0,0,3,31,Joost Winnink
2003,103525,2162.790572,17,7,0,10,6,Ivan Miranda
2002,101938,2162.767535,5,1,0,4,8,Bernardo Mota
1985,100640,2162.767295,26,10,0,16,6,Stefan Simonsson
1994,101576,2162.761668,3,0,0,3,34,Ryuso Tsujino
2010,105585,2162.738264,5,1,0,4,7,Ze Zhang
2008,102703,2162.716908,30,12,0,18,6,Hyung Taik Lee
1993,100437,2162.712672,3,0,0,3,3,Bjorn Borg
1987,101066,2162.705876,23,8,0,15,9,Richard Matuszewski
1985,101096,2162.705432,4,0,0,4,1,Gary Muller
1986,101113,2162.702809,35,12,0,23,3,Michael Westphal
2007,104864,2162.670394,12,4,0,8,12,Alex Kuznetsov
1985,100848,2162.654254,16,6,0,10,14,Alberto Tous
1988,100807,2162.639127,9,3,0,6,2,Marcelo Hennemann
1989,100949,2162.638208,6,1,0,5,5,Mauro Menezes
2005,103063,2162.619722,7,2,0,5,14,Sebastien De Chaunac
2007,102450,2162.616614,19,7,0,12,9,Tim Henman
1987,101048,2162.600549,13,4,0,9,14,Francisco Maciel
2001,103397,2162.592712,19,8,0,11,7,Alexandre Simoni
1993,101835,2162.582957,13,5,0,8,10,Arne Thoms
1986,101344,2162.564996,19,7,0,12,13,Bruno Oresar
2014,105585,2162.553235,5,1,0,4,5,Ze Zhang
1988,101134,2162.544784,3,0,0,3,25,Fredrik Waern
1992,101789,2162.542517,8,2,0,6,12,Steve Bryan
1986,100553,2162.489621,25,11,0,14,9,Nduka Odizor
2002,104433,2162.489358,7,2,0,5,8,Frank Dancevic
1994,102153,2162.486314,3,0,0,3,15,German Puentes
1990,100978,2162.482052,3,0,0,3,17,Andrew Castle
2015,104629,2162.478788,5,1,0,4,18,Adrian Menendez Maceiras
2006,104812,2162.476062,5,1,0,4,10,Scoville Jenkins
2007,104171,2162.472181,3,0,0,3,22,Richard Bloomfield
1989,101593,2162.469164,12,4,0,8,18,Chris Garner
1986,100606,2162.460497,7,2,0,5,8,Mike Bauer
2002,104755,2162.459777,6,1,0,5,5,Richard Gasquet
2005,104717,2162.441278,3,0,0,3,16,Brendan Evans
1986,100502,2162.431292,7,2,0,5,19,Vincent Van Patten
1993,101945,2162.423215,3,0,0,3,26,Thierry Guardiola
2006,102434,2162.385624,45,19,0,26,2,Vincent Spadea
2006,103632,2162.381125,41,19,0,22,7,Luis Horna
2009,103999,2162.377999,6,1,0,5,12,Thiago Alves
1999,103202,2162.373561,3,0,0,3,32,Oscar Serrano
1990,100922,2162.368958,5,1,0,4,8,Roberto Arguello
2008,104779,2162.36352,5,1,0,4,20,Jamie Baker
2000,102809,2162.363256,7,2,0,5,23,Axel Pretzsch
1991,101484,2162.357011,3,0,0,3,7,Vladimir Gabrichidze
2013,104868,2162.348744,5,1,0,4,22,James Ward
2006,103201,2162.345845,3,0,0,3,14,Adrian Garcia
1994,102219,2162.343486,5,1,0,4,11,Juan Garat
1986,100598,2162.302411,11,4,0,7,33,Wolfgang Popp
1988,100639,2162.298366,3,0,0,3,36,Blaine Willenborg
2014,104327,2162.297916,3,0,0,3,9,Steve Darcis
1989,100555,2162.293806,5,1,0,4,18,Jose Luis Clerc
2001,103118,2162.287567,3,0,0,3,11,Ion Moldovan
2012,105147,2162.26281,26,10,0,16,6,Tatsuma Ito
2003,103709,2162.257771,7,2,0,5,35,Kristian Pless
1987,100824,2162.251302,3,0,0,3,15,Peter Bastiansen
2007,104035,2162.229035,3,0,0,3,12,Bobby Reynolds
1992,101462,2162.216205,40,18,0,22,3,Francisco Roig
1992,101764,2162.212646,3,0,0,3,6,Yu Hui Lien
1999,102957,2162.208459,7,2,0,5,9,Vadim Kutsenko
2009,105554,2162.20739,3,0,0,3,11,Daniel Evans
2015,105932,2162.199642,12,4,0,8,7,Nikoloz Basilashvili
2006,103209,2162.198362,3,0,0,3,15,Leonardo Azzaro
1987,101226,2162.191498,30,12,0,18,4,Johan Carlsson
1993,101062,2162.189661,10,3,0,7,3,Mats Wilander
1994,101534,2162.189231,5,1,0,4,16,Libor Nemecek
1998,101675,2162.186684,8,2,0,6,2,Martin Rodriguez
1985,100967,2162.185804,12,3,0,9,14,Dan Goldie
1991,100930,2162.179093,3,0,0,3,6,Paul Vojtischek
2015,104297,2162.177814,3,0,0,3,16,Rogerio Dutra Silva
1994,101924,2162.16135,44,18,0,26,7,Stefano Pescosolido
1992,102338,2162.144103,5,1,0,4,3,Yevgeny Kafelnikov
2014,106105,2162.137291,3,0,0,3,32,Guilherme Clezar
2000,103114,2162.135786,5,1,0,4,2,Martin Lee
2005,104025,2162.132994,5,1,0,4,16,Amer Delic
1995,101826,2162.11637,26,11,0,15,3,Alex Lopez Moron
2011,105029,2162.113592,3,0,0,3,21,Sergey Betov
1992,101715,2162.106944,5,1,0,4,9,Jose Antonio Pepe Conde
1996,101138,2162.104414,3,0,0,3,12,Pat Cash
1993,101567,2162.103276,3,0,0,3,9,Hendrik Jan Davids
2013,105011,2162.099794,5,1,0,4,20,Illya Marchenko
2001,101711,2162.094624,3,0,0,3,14,Alex Obrien
1997,102655,2162.078089,7,2,0,5,10,Jimy Szymanski
2008,104591,2162.0695,3,0,0,3,8,Patrick Tierro
1986,100740,2162.060203,8,2,0,6,3,Dan Cassidy
1988,101108,2162.053066,3,0,0,3,50,Richard Schmidt
1985,100452,2162.036279,20,7,0,13,1,Bill Scanlon
2015,108786,2162.034124,3,0,0,3,4,Seanon Williams
2011,104308,2162.001836,5,1,0,4,40,Michal Przysiezny
2008,102821,2161.999393,7,2,0,5,6,Cecil Mamiit
1993,102135,2161.998942,5,1,0,4,5,Emilio Benfele Alvarez
2000,102652,2161.99451,18,7,0,11,2,Christian Vinck
2002,103594,2161.982262,3,0,0,3,14,Oliver Marach
2009,102148,2161.978617,35,15,0,20,2,Fabrice Santoro
2000,102730,2161.970023,5,1,0,4,16,Ivo Heuberger
2014,105807,2161.955746,39,14,0,25,3,Pablo Carreno Busta
1989,100603,2161.953922,3,0,0,3,15,Roland Stadler
1997,102753,2161.947339,3,0,0,3,17,Wolfgang Schranz
1997,103009,2161.942736,7,2,0,5,11,Razvan Sabau
1996,102655,2161.942236,12,4,0,8,12,Jimy Szymanski
1987,101108,2161.934927,3,0,0,3,24,Richard Schmidt
1998,101776,2161.926538,18,6,0,12,16,Sandon Stolle
1988,101057,2161.91038,5,1,0,4,20,Peter Carter
1993,102843,2161.905245,5,1,0,4,30,Suwandi Suwandi
1997,102110,2161.902836,31,12,0,19,2,Daniel Nestor
2007,104779,2161.897125,5,1,0,4,9,Jamie Baker
1996,102375,2161.870316,7,2,0,5,11,Dinu Pescariu
1997,101441,2161.848186,23,9,0,14,6,Martin Sinner
1991,101441,2161.842236,9,3,0,6,29,Martin Sinner
2015,106032,2161.841442,6,1,0,5,26,Facundo Arguello
2007,102567,2161.835452,5,1,0,4,8,George Bastl
1989,100900,2161.83198,20,8,0,12,9,Josef Cihak
2007,107552,2161.828135,3,0,0,3,19,Laurent Bram
1988,100567,2161.820307,3,0,0,3,18,Chip Hooper
1989,107101,2161.794784,3,0,0,3,36,Giorgio Carneade
1995,101789,2161.778688,5,1,0,4,28,Steve Bryan
2009,105053,2161.77211,5,1,0,4,16,Santiago Giraldo
2004,104308,2161.76073,3,0,0,3,8,Michal Przysiezny
1988,100880,2161.760133,5,1,0,4,2,Russell Barlow
1991,100536,2161.74054,3,0,0,3,17,Fernando Luna
1998,102263,2161.737807,5,1,0,4,11,Yong Il Yoon
2001,102966,2161.733426,5,1,0,4,20,Fredrik Jonsson
1994,101224,2161.728889,7,2,0,5,9,Kenny Thorne
1992,101421,2161.723519,11,4,0,7,24,Veli Paloheimo
2008,104949,2161.719824,3,0,0,3,31,Weerapat Doakmaiklee
1985,100398,2161.719623,5,1,0,4,12,Julio Goes
1990,100607,2161.711871,13,5,0,8,3,Eduardo Bengoechea
1994,101416,2161.704284,5,1,0,4,11,Joao Cunha Silva
2011,106077,2161.697328,3,0,0,3,21,Mike Vermeer
2007,103894,2161.695618,3,0,0,3,8,Phillip King
1993,102300,2161.693095,3,0,0,3,7,Gouichi Motomura
1993,101492,2161.683503,3,0,0,3,22,Sander Groen
2004,103499,2161.68164,5,1,0,4,8,Aqeel Khan
2009,103835,2161.677319,3,0,0,3,10,Filippo Volandri
1991,101549,2161.662705,28,11,0,17,3,Rodolphe Gilbert
1989,110876,2161.660853,3,0,0,3,28,Norbert Oduor
2008,103096,2161.654302,28,11,0,17,3,Arnaud Clement
1990,101366,2161.647649,3,0,0,3,13,David Macpherson
1999,102053,2161.646284,3,0,0,3,7,Brian Macphie
1999,102655,2161.640042,5,1,0,4,9,Jimy Szymanski
2015,106105,2161.635433,7,2,0,5,1,Guilherme Clezar
2001,103066,2161.62845,5,1,0,4,33,Mark Nielsen
2003,102231,2161.627738,3,0,0,3,23,Alex Calatrava
1993,102132,2161.623384,3,0,0,3,14,Ivan Baron
2011,105638,2161.622359,3,0,0,3,24,Daniel Cox
1987,100515,2161.619687,5,1,0,4,10,Shlomo Glickstein
2006,103967,2161.616679,3,0,0,3,34,Michael Lammer
2014,104330,2161.615763,10,3,0,7,6,Rajeev Ram
1988,101609,2161.603677,3,0,0,3,22,David Wheaton
1998,102097,2161.60138,5,1,0,4,9,Naratorn Srichaphan
2000,101185,2161.59402,10,3,0,7,24,Mark Woodforde
2003,101964,2161.593316,3,0,0,3,22,Goran Ivanisevic
1986,100330,2161.590878,3,0,0,3,39,David Imonitie
1995,108828,2161.590878,3,0,0,3,20,Emmanuel Udozorh
1997,102372,2161.590878,3,0,0,3,19,Sule Ladipo
1999,108793,2161.590878,3,0,0,3,18,Goran Sterijovski
2001,108625,2161.590878,3,0,0,3,33,Mohammed Rajan Sundera Karuppiah
2015,111167,2161.590878,3,0,0,3,19,Ugo Nastasi
2012,108740,2161.581497,3,0,0,3,35,Cyril Jacobe
2014,105156,2161.581497,3,0,0,3,32,Federico Zeballos
2004,104019,2161.58007,23,9,0,14,3,Kristof Vliegen
2010,103499,2161.572339,3,0,0,3,22,Aqeel Khan
2013,105154,2161.56705,5,1,0,4,19,Joao Souza
1995,100800,2161.504738,3,0,0,3,35,Diego Perez
2005,103789,2161.495079,17,6,0,11,7,Irakli Labadze
2008,105671,2161.483752,3,0,0,3,8,Gastao Elias
2009,103794,2161.483507,33,14,0,19,2,Benjamin Becker
2005,104658,2161.478572,3,0,0,3,17,Gustavo Ramirez
2004,103133,2161.478039,20,7,0,13,5,Olivier Mutis
2006,103104,2161.47416,3,0,0,3,35,Bjorn Rehnquist
1999,103101,2161.466646,3,0,0,3,18,Daouda Ndiaye
2002,103248,2161.4511,15,5,0,10,3,Harel Levy
2012,103507,2161.43393,17,5,0,12,5,Juan Carlos Ferrero
1989,109940,2161.426845,3,0,0,3,36,Ernesto Lingen
1988,101407,2161.416724,5,1,0,4,10,David Engel
2004,104639,2161.411979,3,0,0,3,10,Wayne Odesnik
1988,101000,2161.393406,20,7,0,13,7,Carl Limberger
1993,101383,2161.380552,3,0,0,3,26,Stephane Sansoni
2006,103566,2161.356719,14,4,0,10,2,Michael Llodra
2012,103675,2161.348598,5,1,0,4,31,Diego Junqueira
2003,104311,2161.345153,3,0,0,3,17,Leonardo Tavares
2003,103898,2161.333595,10,3,0,7,3,Julien Benneteau
2009,104068,2161.324765,34,13,0,21,5,Robby Ginepri
2004,101820,2161.317801,12,4,0,8,3,Marc Rosset
1986,100918,2161.313427,3,0,0,3,9,Harald Rittersbacher
1989,101723,2161.304437,3,0,0,3,20,Magnus Larsson
2001,101902,2161.299058,6,1,0,5,3,Stephane Huet
1985,100551,2161.293927,35,14,0,21,1,Brad Drewett
1998,103171,2161.286888,5,1,0,4,2,Raemon Sluiter
2005,103133,2161.279158,3,0,0,3,31,Olivier Mutis
2009,104467,2161.278976,3,0,0,3,4,Lamine Ouahab
2001,101675,2161.263298,3,0,0,3,30,Martin Rodriguez
2009,104620,2161.25258,37,14,0,23,3,Simone Bolelli
2000,102869,2161.246442,32,12,0,20,11,Galo Blanco
1996,103084,2161.216196,3,0,0,3,7,Guillermo Canas
2001,102401,2161.201197,8,2,0,6,21,Scott Draper
1993,102025,2161.200268,3,0,0,3,13,Mikael Tillstrom
2011,103228,2161.1962,3,0,0,3,31,Marcos Daniel
1991,101050,2161.195827,11,4,0,7,7,Martin Laurendeau
1991,102247,2161.195446,3,0,0,3,8,Andrea Gaudenzi
1988,100598,2161.19139,9,3,0,6,24,Wolfgang Popp
2015,106290,2161.189421,3,0,0,3,15,Filip Peliwo
2010,104219,2161.188989,3,0,0,3,3,Stephane Bohli
1985,100592,2161.157269,5,1,0,4,10,Robert Vant Hof
1988,101971,2161.131816,9,3,0,6,10,Johan Anderson
2006,103165,2161.129388,3,0,0,3,4,Gorka Fraile
1989,108565,2161.112587,3,0,0,3,39,Young Min Kwon
2013,104592,2161.088041,3,0,0,3,6,Ilija Bozoljac
2013,106397,2161.081663,3,0,0,3,9,Wishaya Trongcharoenchaikul
2010,105554,2161.074322,3,0,0,3,40,Daniel Evans
2007,108942,2161.071302,3,0,0,3,35,Henry Estrella
2014,111167,2161.071302,3,0,0,3,32,Ugo Nastasi
2015,105853,2161.071302,3,0,0,3,19,Tigre Hank
1996,108792,2161.066584,3,0,0,3,19,Ognen Nikolovski
1992,101440,2161.056333,32,12,0,20,7,Mark Koevermans
1988,101637,2161.05105,3,0,0,3,10,Brian Roe
2005,104379,2161.051021,3,0,0,3,39,Todd Reid
2009,104623,2161.029836,3,0,0,3,23,Josh Goodall
1988,100611,2161.002816,9,3,0,6,26,Mel Purcell
1988,101451,2160.994248,5,1,0,4,5,Gustavo Giussani
2001,102959,2160.976243,5,1,0,4,9,Marko Tkalec
2005,102642,2160.944377,42,16,0,26,3,Cyril Saulnier
1989,101274,2160.942951,25,9,0,16,5,Udo Riglewski
1994,100772,2160.936378,3,0,0,3,30,Kelly Evernden
1987,101276,2160.91339,40,17,0,23,2,Horacio De La Pena
2001,103632,2160.894776,7,2,0,5,9,Luis Horna
1995,101590,2160.885791,3,0,0,3,31,Eui Jong Chang
2004,103007,2160.874732,5,1,0,4,8,Mounir El Aarej
1987,101332,2160.872489,26,10,0,16,2,Gilad Bloom
2013,105147,2160.862059,14,5,0,9,7,Tatsuma Ito
1996,102192,2160.849689,21,9,0,12,3,Luis Adrian Morejon
1989,101589,2160.849273,9,3,0,6,13,Arnaud Boetsch
2003,103429,2160.838677,12,4,0,8,7,Peter Luczak
1992,101906,2160.799274,5,1,0,4,7,Yasufumi Yamamoto
2003,103324,2160.798011,5,1,0,4,34,Arnaud Di Pasquale
2012,104623,2160.790926,3,0,0,3,22,Josh Goodall
2002,103047,2160.740815,3,0,0,3,12,Julien Varlet
1989,100815,2160.723587,28,9,0,19,3,David Pate
1992,101226,2160.720187,6,1,0,5,5,Johan Carlsson
2007,103523,2160.718291,5,1,0,4,6,Rohan Bopanna
1996,102033,2160.713784,3,0,0,3,19,Abdelhak Hameurlaine
1998,101955,2160.692652,3,0,0,3,18,Luis Herrera
2006,104250,2160.688616,7,2,0,5,30,Prakash Amritraj
2007,104592,2160.683101,7,2,0,5,17,Ilija Bozoljac
1993,101912,2160.671624,5,1,0,4,5,Felipe Rivera
1988,100730,2160.655205,8,2,0,6,15,Florin Segarceanu
2007,104949,2160.64857,3,0,0,3,35,Weerapat Doakmaiklee
2005,103976,2160.643567,3,0,0,3,7,Juan Pablo Brzezicki
1996,101750,2160.639446,23,8,0,15,4,Cristiano Caratti
2007,103594,2160.629976,5,1,0,4,3,Oliver Marach
2001,102770,2160.628218,6,1,0,5,3,John Van Lottum
2003,104076,2160.624809,30,11,0,19,7,Jose Acasuso
2006,104008,2160.586008,3,0,0,3,8,Carlos Avellan
2012,104970,2160.583807,3,0,0,3,20,Matteo Viola
1999,102615,2160.583676,5,1,0,4,21,Dennis Van Scheppingen
2004,103435,2160.574702,3,0,0,3,27,Massimo Dellacqua
2014,104225,2160.571769,3,0,0,3,36,Jan Hajek
1989,111023,2160.548588,3,0,0,3,43,Aymen Ibrahim Al Ashwak
1998,108818,2160.548588,3,0,0,3,18,Givi Samkharadze
2000,108592,2160.548588,3,0,0,3,37,Pavel Baranov
2001,102467,2160.548588,3,0,0,3,40,Fazaluddin Syed
2004,103427,2160.548588,3,0,0,3,31,Yew Ming Si
2005,104063,2160.548588,3,0,0,3,17,Mait Kunnap
2007,104463,2160.548588,3,0,0,3,35,Dmitriy Makeyev
2009,108711,2160.548588,3,0,0,3,21,Christopher Lawson
2013,104580,2160.548588,3,0,0,3,34,Haithem Abid
2013,121908,2160.548588,3,0,0,3,34,Naser Al Obaidly
1998,101840,2160.547008,3,0,0,3,18,Jacobo Chavez
1999,102405,2160.547008,3,0,0,3,33,Mahesh Bhupathi
2003,102607,2160.547008,3,0,0,3,38,Juan Balcells
2003,104752,2160.547008,3,0,0,3,31,Dilshod Sharifi
2006,104800,2160.547008,3,0,0,3,30,Mauricio Estivariz
2008,105656,2160.547008,3,0,0,3,31,Marcelo Arevalo
2010,108740,2160.547008,3,0,0,3,22,Cyril Jacobe
2011,105372,2160.547008,3,0,0,3,21,Issam Al Tawil
2011,108721,2160.547008,3,0,0,3,21,Philippos Tsangaridis
2011,108740,2160.547008,3,0,0,3,21,Cyril Jacobe
2013,105852,2160.547008,3,0,0,3,34,Viktor Filipenko
2014,105239,2160.547008,3,0,0,3,32,Daniel Glancy
2013,108618,2160.54229,3,0,0,3,34,Karim Alayli
2001,102831,2160.523099,23,9,0,14,3,Jacobo Diaz
1995,108730,2160.505067,3,0,0,3,20,Sten Sumberg
2009,105187,2160.496944,3,0,0,3,21,Daniel Danilovic
2015,122669,2160.492129,3,0,0,3,19,Juan Pablo Varillas Patino Samudio
2011,105065,2160.484356,9,3,0,6,17,Tim Smyczek
2014,106065,2160.479574,3,0,0,3,16,Marco Cecchinato
2005,103693,2160.478595,6,1,0,5,3,Thierry Ascione
1993,101862,2160.447145,7,2,0,5,18,Maurice Ruah
2008,104655,2160.437384,25,10,0,15,8,Pablo Cuevas
1985,100781,2160.435522,11,4,0,7,10,Bernhard Pils
1987,101445,2160.42898,3,0,0,3,13,Alessandro Baldoni
2012,104907,2160.418599,3,0,0,3,11,Jose Rubin Statham
1988,101071,2160.410509,21,7,0,14,2,Tom Nijssen
1994,101957,2160.404973,3,0,0,3,40,Milen Velev
1999,102069,2160.404075,3,0,0,3,9,Andrei Rybalko
2004,103505,2160.39315,3,0,0,3,8,Vasilis Mazarakis
1988,101165,2160.387509,5,1,0,4,16,Mario Tabares
1999,102443,2160.384527,3,0,0,3,20,Barry Cowan
1999,102477,2160.36562,3,0,0,3,10,Gaston Etlis
2013,104770,2160.34718,3,0,0,3,6,Martin Fischer
2007,104261,2160.342187,7,2,0,5,9,Peng Sun
2010,103105,2160.30883,5,1,0,4,13,Ruben Ramirez Hidalgo
1990,100926,2160.288227,9,3,0,6,11,Ken Flach
2012,103565,2160.274816,3,0,0,3,32,Stephane Robert
2002,103525,2160.258409,5,1,0,4,9,Ivan Miranda
2003,103781,2160.239373,34,14,0,20,3,Jurgen Melzer
2008,108696,2160.23906,3,0,0,3,17,Philippe Grandjean
1998,103007,2160.237972,3,0,0,3,18,Mounir El Aarej
2013,104233,2160.236911,3,0,0,3,14,Frederik Nielsen
2005,103176,2160.198569,24,9,0,15,7,David Sanchez
1989,107178,2160.186092,3,0,0,3,40,Haruo Nakano
2014,104098,2160.18465,34,14,0,20,10,Dmitry Tursunov
1989,100551,2160.159344,26,11,0,15,3,Brad Drewett
1988,101133,2160.15292,23,9,0,14,6,Patrick Baur
1994,102304,2160.149089,3,0,0,3,12,Grant Doyle
2001,102205,2160.148972,13,5,0,8,14,Sebastien Lareau
1988,101321,2160.147347,3,0,0,3,16,Juan Carlos Baguena
2009,104909,2160.140488,3,0,0,3,21,Sunu Wahyu Trijati
2010,105842,2160.126478,5,1,0,4,7,Di Wu
2003,102259,2160.105874,3,0,0,3,23,Jerome Golmard
2014,103812,2160.103973,28,11,0,17,4,Victor Hanescu
1999,102192,2160.100126,5,1,0,4,9,Luis Adrian Morejon
2003,104548,2160.086691,3,0,0,3,10,Brian Baker
2006,107552,2160.072603,3,0,0,3,30,Laurent Bram
2002,102271,2160.060054,38,14,0,24,3,Hicham Arazi
2001,102982,2160.055758,3,0,0,3,7,Yaoki Ishii
2003,102539,2160.050689,10,3,0,7,3,Bohdan Ulihrach
2001,104000,2160.040358,3,0,0,3,9,Andrey Dernovskiy
1997,101462,2160.030069,10,3,0,7,11,Francisco Roig
1996,101710,2160.024924,3,0,0,3,34,Martin Blackman
1998,108878,2160.024294,3,0,0,3,18,Lency Tenai
1999,102956,2160.024294,3,0,0,3,34,Sultan Khalfan
2001,103875,2160.024294,3,0,0,3,33,Anoosha Shahgholi
2004,103472,2160.024294,3,0,0,3,18,Karim Maamoun
2004,108646,2160.024294,3,0,0,3,31,Joseph Victorino
2005,103568,2160.024294,3,0,0,3,17,Valentin Sanon
2007,108959,2160.024294,3,0,0,3,35,Eldad Campbell
2009,108691,2160.024294,3,0,0,3,21,Khalid Al Nabhani
1995,101506,2160.021796,3,0,0,3,20,Eoin Collins
1987,100835,2160.01963,3,0,0,3,10,Hans Dieter Beutel
1994,101106,2160.014117,5,1,0,4,21,Peter Lundgren
2002,103583,2160.009748,3,0,0,3,17,Evghenii Plugariov
1997,102832,2160.003922,3,0,0,3,33,Andrian Raturandang
2007,104816,2160.002375,5,1,0,4,35,Karan Rastogi
2015,104672,2159.9848,3,0,0,3,10,Vincent Millot
2012,103851,2159.984454,3,0,0,3,35,Conor Niland
1988,101166,2159.973192,3,0,0,3,5,Gustavo Garetto
2007,104464,2159.965087,3,0,0,3,19,Abdul Mumin Babalola
2008,103393,2159.963263,12,4,0,8,5,Yuri Schukin
1998,108819,2159.955489,3,0,0,3,18,Irakli Kunchulia
1986,101500,2159.95218,3,0,0,3,9,Christian Saceanu
1999,102826,2159.946977,3,0,0,3,9,Muhammad Khaliq Siddiq
2015,104945,2159.922328,3,0,0,3,19,James Mcgee
2010,105723,2159.9213,5,1,0,4,5,Andrey Kuznetsov
1993,101660,2159.914616,12,4,0,8,3,Francisco Montana
1998,102443,2159.903734,3,0,0,3,10,Barry Cowan
2005,104338,2159.893983,43,18,0,25,3,Juan Monaco
1994,101154,2159.891593,8,2,0,6,9,Simon Youl
2009,103821,2159.88083,9,3,0,6,9,Danai Udomchoke
2013,105051,2159.868418,17,6,0,11,17,Matthew Ebden
1990,101020,2159.867399,3,0,0,3,15,Hans Schwaier
1996,101430,2159.85377,3,0,0,3,3,Sergio Cortes
1993,102434,2159.849904,6,1,0,5,14,Vincent Spadea
1998,101582,2159.841645,5,1,0,4,28,Gilbert Schaller
2012,108749,2159.840826,3,0,0,3,35,Sergis Kyratzis
1989,101412,2159.826243,19,8,0,11,7,Shuzo Matsuoka
2013,103484,2159.819724,23,9,0,14,13,James Blake
2000,101772,2159.810831,5,1,0,4,4,Andrei Cherkasov
2002,102231,2159.810412,16,6,0,10,20,Alex Calatrava
1990,100321,2159.781247,3,0,0,3,17,Vijay Amritraj
1988,100864,2159.750875,9,3,0,6,6,Martin Wostenholme
2014,105613,2159.74798,6,1,0,5,3,Norbert Gombos
2012,105671,2159.740358,5,1,0,4,0,Gastao Elias
1997,102279,2159.733299,3,0,0,3,19,Gehad El Deeb
1992,108827,2159.714205,3,0,0,3,19,Mike Amoah
2011,104500,2159.702402,44,20,0,24,6,Somdev Devvarman
1993,101242,2159.664422,3,0,0,3,20,Brad Pearce
2000,102448,2159.64913,7,2,0,5,9,Ali Hamadeh
2003,101746,2159.640461,5,1,0,4,16,Renzo Furlan
1989,101578,2159.631382,3,0,0,3,32,Markus Rackl
2010,103899,2159.629679,3,0,0,3,22,Stian Boretti
1993,102148,2159.626922,52,24,0,28,3,Fabrice Santoro
2003,103421,2159.619704,3,0,0,3,31,Peter Handoyo
2005,103672,2159.618399,39,16,0,23,3,Ricardo Mello
1994,101701,2159.618155,3,0,0,3,6,Bing Pan
1988,100871,2159.605878,5,1,0,4,11,Laurie Warder
2005,104386,2159.575402,26,11,0,15,6,Janko Tipsarevic
1991,101422,2159.568556,5,1,0,4,15,Mark Kaplan
2010,105781,2159.565101,3,0,0,3,22,Andrei Vasilevski
1993,101914,2159.564052,7,2,0,5,29,Lars Koslowski
1994,102192,2159.552745,3,0,0,3,11,Luis Adrian Morejon
2006,104660,2159.551014,7,1,0,6,5,Sergiy Stakhovsky
1998,102269,2159.550302,3,0,0,3,32,Jeff Salzenstein
2005,102869,2159.544381,3,0,0,3,16,Galo Blanco
2012,105154,2159.540669,16,6,0,10,19,Joao Souza
1991,101651,2159.540313,3,0,0,3,34,Owen Casey
2012,104225,2159.534284,11,4,0,7,5,Jan Hajek
1992,101727,2159.533746,26,10,0,16,14,Jason Stoltenberg
2003,103182,2159.533542,9,3,0,6,15,Markus Hipfl
2008,104736,2159.52034,3,0,0,3,31,Farrukh Dustov
1996,101171,2159.515751,3,0,0,3,34,Armando Perez
1985,100870,2159.502354,13,3,0,10,9,Christo Van Rensburg
1985,100771,2159.500789,3,0,0,3,45,Kelvin Belcher
1992,108883,2159.5,3,0,0,3,35,Kuen Yiep Ho
1995,101802,2159.5,3,0,0,3,35,Ramayah Ramachandran
1997,108686,2159.5,3,0,0,3,33,Alejandro Aramburu Acuna
2002,106536,2159.5,3,0,0,3,17,Andres Filimonov
2010,106277,2159.5,3,0,0,3,22,Ariez Elyaas Deen Heshaam
1987,101097,2159.491575,16,5,0,11,3,Rick Leach
1995,101406,2159.484699,6,1,0,5,6,Wojtek Kowalski
2007,108909,2159.479628,3,0,0,3,35,Jalil Khan
1995,108815,2159.477844,3,0,0,3,20,Kojo Atiso
1989,101050,2159.4753,15,5,0,10,10,Martin Laurendeau
1992,102158,2159.472341,3,0,0,3,9,Patrick Rafter
1986,100489,2159.47135,13,4,0,9,8,Larry Stefanki
2009,104268,2159.469787,12,3,0,9,2,Alejandro Falla
2012,105349,2159.459252,3,0,0,3,11,Harri Heliovaara
2009,108925,2159.457675,3,0,0,3,21,Ahmad Rabeea Muhammad
2013,104225,2159.455971,24,9,0,15,6,Jan Hajek
2012,104035,2159.452041,11,4,0,7,12,Bobby Reynolds
2012,108778,2159.41809,3,0,0,3,35,Christos Hadjigeorgiou
2006,104559,2159.408919,18,6,0,12,2,Teymuraz Gabashvili
1991,101185,2159.381208,33,12,0,21,3,Mark Woodforde
2012,104660,2159.380421,44,16,0,28,6,Sergiy Stakhovsky
2010,105992,2159.369772,13,4,0,9,13,Ryan Harrison
2015,106121,2159.367259,8,2,0,6,5,Taro Daniel
1996,101362,2159.331803,16,6,0,10,6,Stephane Simian
1989,100536,2159.325721,27,11,0,16,13,Fernando Luna
1985,101366,2159.297061,3,0,0,3,5,David Macpherson
2002,108614,2159.268484,3,0,0,3,31,Raoul Behr
2014,105311,2159.250827,60,24,0,36,2,Joao Sousa
1991,100619,2159.218474,3,0,0,3,8,George Kalovelonis
1997,101746,2159.211376,50,22,0,28,6,Renzo Furlan
2000,102987,2159.182274,30,12,0,18,7,Andre Sa
2006,103429,2159.162288,16,6,0,10,14,Peter Luczak
2007,102106,2159.154825,13,5,0,8,8,Davide Sanguinetti
1997,102410,2159.147093,3,0,0,3,14,David Caldwell
2014,111781,2159.130712,3,0,0,3,9,Janis Podzus
1989,101189,2159.13,10,3,0,7,13,Stefan Lochbihler
1988,100402,2159.124112,3,0,0,3,39,Francisco Gonzalez
1991,101945,2159.108523,4,0,0,4,8,Thierry Guardiola
1995,101462,2159.075542,3,0,0,3,33,Francisco Roig
2009,103206,2159.067078,6,1,0,5,2,Sebastien Grosjean
1998,103029,2159.052996,3,0,0,3,27,Mehdi Tahiri
1988,100810,2159.052669,20,7,0,13,8,Paul Chamberlin
1992,102368,2159.051304,5,1,0,4,12,Brian Dunn
1993,101582,2159.036817,34,12,0,22,3,Gilbert Schaller
2014,104907,2159.01645,3,0,0,3,41,Jose Rubin Statham
1989,101735,2159.014485,20,7,0,13,10,Richard Fromberg
1996,101730,2159.003811,3,0,0,3,11,Piet Norval
2009,105002,2158.99386,3,0,0,3,21,Timothy Neilly
1995,101354,2158.988895,7,2,0,5,18,Andrew Sznajder
2006,103530,2158.97668,3,0,0,3,15,Zack Fleishman
2002,108652,2158.975706,3,0,0,3,31,Shane Stone
2007,103674,2158.965679,3,0,0,3,19,Jonathan Igbinovia
2003,103682,2158.959114,3,0,0,3,8,Kyu Tae Im
1998,102023,2158.939844,3,0,0,3,7,Petr Luxa
1995,102511,2158.937006,3,0,0,3,10,Sven Koehler
2009,103672,2158.914459,3,0,0,3,22,Ricardo Mello
2005,108931,2158.912577,3,0,0,3,8,Enzo Pigola
1988,101030,2158.899799,4,0,0,4,9,Goran Prpic
1992,101285,2158.878139,51,21,0,30,6,Thierry Champion
2007,102856,2158.861612,7,2,0,5,36,Gustavo Kuerten
2014,105379,2158.858559,14,5,0,9,19,Aljaz Bedene
1995,101976,2158.853442,3,0,0,3,10,Federico Dondo
1996,102869,2158.845959,27,11,0,16,3,Galo Blanco
2004,101774,2158.835418,25,10,0,15,11,Todd Martin
1985,100644,2158.828681,7,1,0,6,5,Alexander Zverev
2001,102780,2158.813016,5,1,0,4,16,Frederic Niemeyer
1999,101086,2158.801102,10,3,0,7,8,Ronald Agenor
1989,100728,2158.793981,3,0,0,3,19,Todd Nelson
1987,101186,2158.78767,3,0,0,3,26,Desmond Tyson
2002,104417,2158.783292,6,1,0,5,3,Robin Soderling
2003,102247,2158.773394,10,3,0,7,26,Andrea Gaudenzi
2012,103573,2158.755236,3,0,0,3,37,Rik De Voest
2013,106032,2158.753703,3,0,0,3,20,Facundo Arguello
2014,104719,2158.71695,47,19,0,28,3,Marcel Granollers
2002,102950,2158.712044,51,23,0,28,3,Fernando Vicente
1985,100663,2158.70756,12,4,0,8,9,Marcel Freeman
1988,101029,2158.704903,31,12,0,19,4,Ricki Osterthun
1987,100924,2158.682337,14,4,0,10,2,Jorge Lozano
2008,103280,2158.656015,3,0,0,3,18,Martin Verkerk
1996,102119,2158.655527,5,1,0,4,10,Chih Jung Chen
2000,102821,2158.643443,18,6,0,12,7,Cecil Mamiit
1992,101420,2158.631796,3,0,0,3,15,Vaclav Roubicek
2015,103794,2158.629048,32,11,0,21,6,Benjamin Becker
2015,104273,2158.57086,18,6,0,12,3,Edouard Roger Vasselin
1999,102204,2158.560548,3,0,0,3,18,Nebojsa Djordjevic
1993,101196,2158.550932,38,17,0,21,14,Derrick Rostagno
1988,100900,2158.550162,13,4,0,9,13,Josef Cihak
2014,106243,2158.541751,9,3,0,6,9,Mate Delic
2009,104976,2158.536987,8,2,0,6,12,Ryan Sweeting
2010,103936,2158.534519,3,0,0,3,22,Todor Enev
2004,104036,2158.530891,5,1,0,4,8,Simon Rea
1986,101256,2158.520149,15,5,0,10,6,Mark Kratzmann
1998,101475,2158.51325,45,21,0,24,2,Carlos Costa
2011,105286,2158.504,3,0,0,3,10,Greg Jones
2001,102811,2158.483436,3,0,0,3,18,Dusan Vemic
2005,104463,2158.473366,3,0,0,3,17,Dmitriy Makeyev
1988,100440,2158.457899,8,2,0,6,19,Eddie Edwards
1994,108790,2158.451412,3,0,0,3,36,Nicholas Malcolm
1994,108814,2158.451412,3,0,0,3,19,Konstantinos Effraimoglou
1999,108836,2158.451412,3,0,0,3,34,Jayendra Wijeyesekera
1989,101730,2158.442482,3,0,0,3,21,Piet Norval
1988,100751,2158.426158,10,3,0,7,33,Roberto Saad
2014,103105,2158.415188,3,0,0,3,31,Ruben Ramirez Hidalgo
1994,102093,2158.35578,39,15,0,24,3,Martin Damm
2000,101964,2158.354602,36,14,0,22,2,Goran Ivanisevic
1992,101318,2158.301885,32,12,0,20,3,Javier Frana
1999,103428,2158.282696,3,0,0,3,13,Juan Ignacio Chela
1985,101368,2158.280733,5,1,0,4,19,Christian Miniussi
2009,104731,2158.259174,8,2,0,6,4,Kevin Anderson
1996,101492,2158.217491,3,0,0,3,23,Sander Groen
1992,100782,2158.203734,18,7,0,11,14,Pablo Arraya
1986,107183,2158.187112,3,0,0,3,8,Hatem Mcdadi
2005,102401,2158.182019,4,0,0,4,19,Scott Draper
1994,101577,2158.146814,3,0,0,3,6,Jia Ping Xia
1990,101109,2158.088271,29,12,0,17,4,Tarik Benhabiles
2014,105302,2158.087687,8,2,0,6,16,Ante Pavic
1988,101150,2158.083873,12,4,0,8,15,Gianluca Pozzi
1988,100935,2158.081258,16,6,0,10,3,Michael Robertson
2008,108699,2158.078168,3,0,0,3,8,Nodar Itonishvili
1987,100795,2158.042815,5,1,0,4,23,Alvaro Jordan
1988,100949,2158.036459,6,1,0,5,2,Mauro Menezes
2004,103544,2158.033649,4,0,0,4,3,Andy Ram
1994,101460,2158.02255,10,3,0,7,22,Jose Francisco Altur
1991,101243,2158.010386,21,8,0,13,3,Roberto Azar
1993,101156,2158.002098,4,0,0,4,11,Juan Pino
1993,101165,2158.002098,4,0,0,4,11,Mario Tabares
1987,100663,2158.001961,30,11,0,19,10,Marcel Freeman
2002,102722,2157.987634,37,14,0,23,3,Attila Savolt
2014,105641,2157.977296,14,5,0,9,10,Blaz Rola
2005,103413,2157.968804,3,0,0,3,8,Genius Chidzikwe
2003,103254,2157.962369,3,0,0,3,21,Yves Allegro
2013,105550,2157.955206,20,7,0,13,13,Guido Pella
2007,104068,2157.938637,31,11,0,20,3,Robby Ginepri
2010,103607,2157.906094,3,0,0,3,11,Victor Estrella
1985,100417,2157.898838,20,7,0,13,16,Hans Gildemeister
2012,104593,2157.895243,18,6,0,12,3,Daniel Gimeno Traver
2006,103726,2157.894528,8,2,0,6,14,Jean Christophe Faurel
1995,101717,2157.890838,15,5,0,10,9,Diego Nargiso
2012,105649,2157.884491,25,9,0,16,10,Cedrik Marcel Stebe
2002,101750,2157.881794,3,0,0,3,19,Cristiano Caratti
1991,101387,2157.871879,20,7,0,13,6,Claudio Pistolesi
1995,108832,2157.828017,5,1,0,4,10,Thorsten Poelzl
1998,102854,2157.823965,55,23,0,32,2,Sjeng Schalken
2014,111575,2157.812102,3,0,0,3,4,Karen Khachanov
2014,105539,2157.806169,13,4,0,9,4,Evgeny Donskoy
1994,101719,2157.755024,6,1,0,5,5,Frederic Fontang
1998,102839,2157.748804,49,19,0,30,2,Nicolas Lapentti
1993,101719,2157.74216,11,3,0,8,10,Frederic Fontang
1986,100719,2157.737839,16,6,0,10,2,Juan Avendano
2012,103451,2157.716855,21,7,0,14,6,Bjorn Phau
2010,105453,2157.691302,12,3,0,9,8,Kei Nishikori
2009,103668,2157.687999,3,0,0,3,11,Lazar Magdincev
1988,101445,2157.661288,3,0,0,3,20,Alessandro Baldoni
2007,107098,2157.656026,5,1,0,4,9,Gilles Kremer
2008,103252,2157.655168,8,2,0,6,9,Alberto Martin
1996,102287,2157.644606,4,0,0,4,3,Albert Portas
2004,102106,2157.63059,31,11,0,20,2,Davide Sanguinetti
1988,100926,2157.629706,19,7,0,12,3,Ken Flach
2007,104976,2157.62786,7,2,0,5,12,Ryan Sweeting
2013,105738,2157.625176,3,0,0,3,34,Tsung Hua Yang
1989,101012,2157.585395,11,3,0,8,18,Massimiliano Narducci
1994,101276,2157.572199,18,6,0,12,21,Horacio De La Pena
2004,103413,2157.559267,3,0,0,3,31,Genius Chidzikwe
2009,104332,2157.55837,40,15,0,25,2,Philipp Petzschner
2006,104620,2157.550156,4,0,0,4,3,Simone Bolelli
2015,126207,2157.523288,6,1,0,5,12,Francis Tiafoe
1998,102287,2157.521224,37,13,0,24,7,Albert Portas
2011,105318,2157.515705,6,1,0,5,21,Thomas Schoorel
1998,101932,2157.494685,3,0,0,3,2,Jared Palmer
2010,103714,2157.413611,6,1,0,5,11,Andreas Vinciguerra
2015,104386,2157.38943,10,3,0,7,12,Janko Tipsarevic
2005,103204,2157.370728,6,1,0,5,15,Hugo Armando
1998,101868,2157.362595,3,0,0,3,36,Dick Norman
2012,104500,2157.359415,3,0,0,3,6,Somdev Devvarman
2003,102720,2157.289503,6,1,0,5,3,Tomas Zib
2001,103746,2157.284883,3,0,0,3,9,Miguel Gallardo Valles
1995,102093,2157.264267,37,15,0,22,3,Martin Damm
2004,103325,2157.252661,26,9,0,17,3,Wesley Moodie
2012,106045,2157.234371,8,2,0,6,12,Denis Kudla
1985,100711,2157.226795,10,3,0,7,19,Pedro Rebolledo
1992,101938,2157.222722,4,0,0,4,17,Bernardo Mota
1985,100951,2157.212301,12,4,0,8,6,Alessandro De Minicis
2013,103843,2157.192264,6,1,0,5,5,Marco Chiudinelli
2013,105575,2157.178874,29,13,0,16,6,Ricardas Berankis
2012,104273,2157.175748,33,14,0,19,6,Edouard Roger Vasselin
2002,103182,2157.171939,30,12,0,18,15,Markus Hipfl
2014,111200,2157.150674,5,1,0,4,4,Elias Ymer
2008,104371,2157.147434,37,14,0,23,5,Ivo Minar
2015,104719,2157.143122,35,14,0,21,3,Marcel Granollers
1990,101014,2157.120581,5,1,0,4,12,John Ross
2001,101843,2157.098906,36,15,0,21,8,Sergi Bruguera
2007,104871,2157.066982,3,0,0,3,18,Jeremy Chardy
2012,104198,2157.011568,45,20,0,25,3,Guillermo Garcia Lopez
1990,100920,2156.992814,6,1,0,5,9,Robert Seguso
2000,103009,2156.970557,6,1,0,5,13,Razvan Sabau
2007,103794,2156.943557,53,21,0,32,3,Benjamin Becker
1997,101507,2156.939323,21,8,0,13,9,Tomas Carbonell
2010,103693,2156.939255,3,0,0,3,10,Thierry Ascione
1996,100837,2156.935659,3,0,0,3,21,Jeremy Bates
2010,104397,2156.93382,6,1,0,5,9,Laurent Recouderc
2004,102925,2156.930322,6,1,0,5,6,Justin Gimelstob
1989,101068,2156.89935,4,0,0,4,18,Byron Talbot
2012,105028,2156.873801,22,7,0,15,6,Jesse Levine
1991,101337,2156.772544,3,0,0,3,7,Martin Strelba
2000,102205,2156.770395,19,6,0,13,12,Sebastien Lareau
1988,100790,2156.709915,10,3,0,7,10,Bruce Derlin
2010,104557,2156.652162,3,0,0,3,11,Andis Juska
2000,102061,2156.608051,10,3,0,7,2,Kevin Ullyett
1997,102437,2156.588152,34,13,0,21,7,Adrian Voinea
1985,100517,2156.587236,16,6,0,10,4,Matt Doyle
2008,104628,2156.564455,8,2,0,6,3,Alexander Kudryavtsev
2007,108628,2156.557289,5,1,0,4,9,Jhonnatan Medina Alvarez
2004,101964,2156.553306,14,4,0,10,21,Goran Ivanisevic
2002,103971,2156.547527,8,2,0,6,3,Karol Beck
1992,101775,2156.52613,6,1,0,5,10,Frederik Fetterlein
1995,102104,2156.520225,43,17,0,26,3,Christian Ruud
2011,104714,2156.511413,10,3,0,7,19,Julian Reister
2001,101888,2156.485607,9,2,0,7,3,Daniel Vacek
2003,102997,2156.481611,8,2,0,6,9,Hermes Gamonal
1987,100848,2156.437859,19,8,0,11,2,Alberto Tous
1997,102521,2156.344607,37,15,0,22,2,Hendrik Dreekmann
1992,101265,2156.344409,35,14,0,21,6,Patrick Mcenroe
1986,100343,2156.342157,16,6,0,10,24,John Lloyd
2000,103451,2156.33779,4,0,0,4,5,Bjorn Phau
1992,102110,2156.26587,8,2,0,6,10,Daniel Nestor
1995,102455,2156.264461,4,0,0,4,7,Lorenzo Manta
2004,102785,2156.222308,14,5,0,9,5,Glenn Weiner
2007,103181,2156.191048,20,7,0,13,6,Jiri Vanek
1997,102854,2156.178834,43,16,0,27,2,Sjeng Schalken
1996,101805,2156.159404,15,5,0,10,6,David Nainkin
1986,100793,2156.151047,4,0,0,4,16,Stephane Bonneau
2002,102821,2156.141116,22,8,0,14,6,Cecil Mamiit
1988,101205,2156.140606,27,10,0,17,3,Grant Connell
1990,100857,2156.096986,10,3,0,7,1,Sergio Casal
1992,101131,2156.025985,6,1,0,5,12,Jimmy Brown
2004,102571,2155.972907,34,14,0,20,3,Gregory Carraz
1998,102234,2155.967701,22,8,0,14,2,Oliver Gross
1989,101215,2155.95572,10,3,0,7,12,Scott Warner
1992,101806,2155.952637,15,5,0,10,3,Marc Kevin Goellner
1996,102146,2155.936043,35,14,0,21,3,Jordi Burillo
1999,101717,2155.815355,6,1,0,5,7,Diego Nargiso
2000,102795,2155.778493,4,0,0,4,15,Scott Humphries
2013,103105,2155.669179,8,2,0,6,33,Ruben Ramirez Hidalgo
1994,102223,2155.649801,35,16,0,19,3,Karim Alami
1988,101096,2155.63024,25,8,0,17,3,Gary Muller
2008,104545,2155.623984,30,11,0,19,10,John Isner
1989,101027,2155.572252,6,1,0,5,18,Jaroslav Bulant
1996,102654,2155.560207,4,0,0,4,16,Steven Downs
2002,102306,2155.558744,23,8,0,15,3,Michael Kohlmann
1994,102650,2155.547658,6,1,0,5,9,Roberto Carretero
1992,101500,2155.510152,24,8,0,16,18,Christian Saceanu
1994,102214,2155.34733,3,0,0,3,7,Oscar Ortiz
1996,101809,2155.319484,39,16,0,23,3,Nicolas Pereira
1989,101312,2155.298548,10,3,0,7,5,Robbie Weiss
2002,102809,2155.263561,8,2,0,6,18,Axel Pretzsch
1995,102118,2155.22209,26,10,0,16,7,Radomir Vasek
1988,100930,2155.218326,13,4,0,9,21,Paul Vojtischek
2010,103582,2155.185238,48,20,0,28,2,Michael Berrer
1992,102104,2155.166115,4,0,0,4,12,Christian Ruud
1986,101004,2155.148827,4,0,0,4,8,Jim Pugh
2001,101806,2155.146559,10,3,0,7,7,Marc Kevin Goellner
2009,105385,2155.130981,4,0,0,4,9,Donald Young
2013,105902,2155.126198,10,3,0,7,13,James Duckworth
2008,104273,2155.062854,8,2,0,6,18,Edouard Roger Vasselin
1993,101179,2155.062307,5,1,0,4,4,Jean Philippe Fleurian
2003,102703,2155.045104,41,18,0,23,3,Hyung Taik Lee
1994,102006,2155.035312,12,4,0,8,9,Brent Larkham
1985,100616,2155.019146,6,1,0,5,10,Andy Kohlberg
2007,105053,2155.015127,6,1,0,5,9,Santiago Giraldo
1985,100765,2154.977891,10,3,0,7,21,Rodney Harmon
2012,103843,2154.972664,14,4,0,10,4,Marco Chiudinelli
2003,103356,2154.97033,35,13,0,22,3,Michel Kratochvil
1989,101407,2154.954751,6,1,0,5,9,David Engel
1995,101179,2154.948813,13,4,0,9,6,Jean Philippe Fleurian
1990,101327,2154.898966,4,0,0,4,4,Cyril Suk
1995,101353,2154.892395,5,1,0,4,8,Lionel Barthez
2003,102722,2154.863766,16,5,0,11,14,Attila Savolt
1988,101123,2154.745763,13,4,0,9,10,Alexander Mronz
2009,103857,2154.735862,47,16,0,31,3,Igor Kunitsyn
2003,103154,2154.723243,5,1,0,4,7,Jaymon Crabb
2012,105561,2154.710663,5,1,0,4,19,Alessandro Giannessi
1997,101745,2154.705866,4,0,0,4,17,Roberto Jabali
1996,101636,2154.699138,6,1,0,5,11,Wade Mcguire
2005,103917,2154.689611,6,1,0,5,2,Nicolas Mahut
1993,102201,2154.667285,4,0,0,4,4,Lionel Roux
1986,100449,2154.661742,10,3,0,7,8,Stanislav Birner
2001,101647,2154.647328,23,8,0,15,7,Byron Black
2010,103470,2154.642883,4,0,0,4,13,Robert Kendrick
2005,103009,2154.626331,16,6,0,10,3,Razvan Sabau
2015,104252,2154.615992,13,4,0,9,12,Florian Mayer
1987,101358,2154.601323,4,0,0,4,19,Olivier Delaitre
2005,104160,2154.581556,11,3,0,8,3,Lukas Dlouhy
2001,104076,2154.556147,20,8,0,12,8,Jose Acasuso
2000,103031,2154.549238,13,4,0,9,13,Julian Alonso
1992,101337,2154.54815,22,9,0,13,7,Martin Strelba
2013,104180,2154.544427,12,4,0,8,26,Gilles Muller
2009,104180,2154.538157,14,5,0,9,23,Gilles Muller
2004,103096,2154.531353,41,17,0,24,2,Arnaud Clement
2010,102845,2154.459422,8,2,0,6,29,Carlos Moya
1994,101731,2154.456228,8,2,0,6,10,Nuno Marques
2002,101868,2154.440302,6,1,0,5,6,Dick Norman
1990,101368,2154.43853,4,0,0,4,13,Christian Miniussi
2009,103292,2154.435184,6,1,0,5,18,Gaston Gaudio
2015,105430,2154.411891,10,3,0,7,1,Radu Albot
2003,102911,2154.390245,8,2,0,6,6,Andrei Stoliarov
1987,101344,2154.388022,17,6,0,11,2,Bruno Oresar
1989,100744,2154.362837,6,1,0,5,12,Peter Doohan
2011,105074,2154.323865,6,1,0,5,12,Ruben Bemelmans
1997,101688,2154.271292,6,1,0,5,12,Geoff Grant
1992,101387,2154.257546,24,9,0,15,9,Claudio Pistolesi
1990,101731,2154.254578,12,4,0,8,1,Nuno Marques
1997,101150,2154.236119,10,3,0,7,5,Gianluca Pozzi
2010,105028,2154.233764,6,1,0,5,23,Jesse Levine
2010,103722,2154.207356,46,19,0,27,2,Florent Serra
2009,103228,2154.141755,20,7,0,13,8,Marcos Daniel
1991,102358,2154.121585,6,1,0,5,5,Thomas Enqvist
1989,100727,2154.076845,10,3,0,7,15,Raul Antonio Viver
1997,101138,2154.039968,9,2,0,7,4,Pat Cash
2014,104735,2154.027792,27,10,0,17,4,Tobias Kamke
1989,101451,2154.019914,19,7,0,12,5,Gustavo Giussani
1994,101510,2154.016799,44,18,0,26,3,Henrik Holm
2003,101885,2154.016575,38,14,0,24,6,Wayne Arthurs
1987,101088,2154.008692,6,1,0,5,19,Larry Scott
2007,103506,2153.986815,30,11,0,19,11,Martin Vassallo Arguello
2006,103151,2153.931193,12,4,0,8,7,Mariano Zabaleta
1995,101142,2153.905779,35,13,0,22,3,Emilio Sanchez
1989,101251,2153.901614,14,4,0,10,10,Eric Winogradsky
2014,104736,2153.897211,6,1,0,5,9,Farrukh Dustov
2013,106207,2153.87317,4,0,0,4,11,Mate Pavic
1985,100907,2153.854015,8,2,0,6,19,Luca Bottazzi
2009,103580,2153.836907,6,1,0,5,22,Alexander Peya
1986,100411,2153.663419,24,8,0,16,8,Pavel Slozil
1993,100772,2153.661871,8,2,0,6,11,Kelly Evernden
1986,101031,2153.647199,4,0,0,4,12,Massimo Cierro
1988,100728,2153.63444,30,11,0,19,3,Todd Nelson
2001,103387,2153.610827,26,10,0,16,7,Paradorn Srichaphan
2004,102374,2153.601707,32,12,0,20,3,Alex Corretja
2009,104619,2153.594119,5,0,0,5,11,Jesse Huta Galung
2007,104523,2153.53238,6,1,0,5,9,Frederico Gil
1997,103118,2153.480146,4,0,0,4,9,Ion Moldovan
2015,105208,2153.479761,35,11,0,24,5,Ernests Gulbis
1986,100970,2153.475463,25,9,0,16,5,Stefan Eriksson
1987,101057,2153.469267,4,0,0,4,11,Peter Carter
2009,105173,2153.468376,4,0,0,4,10,Adrian Mannarino
1986,100644,2153.443648,4,0,0,4,10,Alexander Zverev
2013,103722,2153.395,4,0,0,4,13,Florent Serra
1986,100995,2153.360796,4,0,0,4,20,Eduardo Masso
1997,101797,2153.334039,6,1,0,5,22,Jacco Eltingh
2007,103700,2153.329234,8,2,0,6,12,Juan Pablo Guzman
2005,102998,2153.317739,15,5,0,10,6,Jan Michael Gambill
1988,101477,2153.315435,6,1,0,5,27,Chris Bailey
2003,102851,2153.314602,12,4,0,8,7,Giorgio Galimberti
2013,104665,2153.307254,49,18,0,31,3,Pablo Andujar
2011,104813,2153.299481,8,2,0,6,9,Grega Zemlja
1986,106997,2153.279971,4,0,0,4,22,Ferenc Csepai
1996,102821,2153.254916,4,0,0,4,12,Cecil Mamiit
1987,100669,2153.206689,12,4,0,8,19,Charles Bud Cox
2010,104273,2153.167254,9,2,0,7,5,Edouard Roger Vasselin
1993,101642,2153.146091,32,12,0,20,11,Bart Wuyts
2005,103166,2153.131012,6,1,0,5,8,Vladimir Voltchkov
2009,103470,2153.116196,25,9,0,16,4,Robert Kendrick
2004,102494,2153.071044,15,5,0,10,17,Tomas Behrend
1994,101597,2153.057818,11,3,0,8,8,Louis Gloria
1990,100714,2153.05296,16,5,0,11,3,Broderick Dyke
2003,103656,2153.001911,26,10,0,16,7,Albert Montanes
1997,102644,2152.986471,15,6,0,9,4,Franco Squillari
2011,104619,2152.886115,8,2,0,6,13,Jesse Huta Galung
1993,101375,2152.820706,6,1,0,5,13,Brian Devening
1993,101725,2152.808786,30,11,0,19,3,Gabriel Markus
1988,101161,2152.785187,6,1,0,5,10,Thomas Haldin
2000,103568,2152.775745,6,1,0,5,9,Valentin Sanon
1990,101761,2152.773755,4,0,0,4,1,Jaime Oncins
1987,100920,2152.769772,24,9,0,15,6,Robert Seguso
2012,105095,2152.766829,6,1,0,5,6,Evgeny Korolev
2004,104597,2152.766672,9,2,0,7,7,Nicolas Almagro
1986,100445,2152.736444,9,2,0,7,8,Steve Denton
1987,101374,2152.706168,14,4,0,10,4,Leonardo Lavalle
1991,101131,2152.658721,11,3,0,8,13,Jimmy Brown
1996,102088,2152.639262,10,3,0,7,13,Joern Renzenbrink
2002,102911,2152.61886,24,9,0,15,3,Andrei Stoliarov
2015,117356,2152.60169,6,1,0,5,6,Cem Ilkel
2000,102950,2152.581964,56,24,0,32,3,Fernando Vicente
2005,102287,2152.578221,8,2,0,6,7,Albert Portas
2004,103356,2152.559671,15,5,0,10,3,Michel Kratochvil
1989,101318,2152.481207,25,9,0,16,2,Javier Frana
2002,103060,2152.456638,6,1,0,5,8,Alejandro Hernandez
1988,101434,2152.42058,21,8,0,13,9,Petr Korda
1996,101381,2152.413914,4,0,0,4,36,Aaron Krickstein
2005,104198,2152.412964,45,19,0,26,3,Guillermo Garcia Lopez
2011,103096,2152.409839,17,6,0,11,11,Arnaud Clement
2000,102533,2152.372079,20,7,0,13,2,Jens Knippschild
1999,101902,2152.360018,11,3,0,8,6,Stephane Huet
2012,104890,2152.351192,6,1,0,5,6,Andreas Haider Maurer
2012,105894,2152.333248,6,1,0,5,30,Javier Marti
2012,104424,2152.320824,34,13,0,21,4,Go Soeda
1988,100595,2152.311211,9,2,0,7,10,Ronnie Bathman
1993,101073,2152.303557,5,1,0,4,17,Martin Jaite
1990,101263,2152.282313,4,0,0,4,4,Luke Jensen
1997,101473,2152.26986,6,1,0,5,24,Jozsef Krocsko
1985,101031,2152.259168,9,2,0,7,13,Massimo Cierro
2008,104719,2152.237974,35,15,0,20,2,Marcel Granollers
2006,103455,2152.237196,4,0,0,4,3,Michal Mertinak
1986,100636,2152.212857,4,0,0,4,4,Gustavo Tiberti
1987,100617,2152.189964,12,4,0,8,37,Bud Schultz
1998,102359,2152.177927,6,1,0,5,20,Andrew Richardson
2001,102834,2152.168229,15,5,0,10,14,Paul Goldstein
1995,108811,2152.15279,4,0,0,4,20,Christophe Boggetti
2014,104559,2152.133589,45,19,0,26,3,Teymuraz Gabashvili
1985,100868,2152.114461,9,2,0,7,5,Craig A Miller
1998,101681,2152.11375,10,3,0,7,9,Chris Wilkinson
1988,101179,2152.10731,10,3,0,7,17,Jean Philippe Fleurian
2014,105671,2152.082033,11,3,0,8,3,Gastao Elias
1997,102538,2152.082032,6,1,0,5,10,Tuomas Ketola
2009,104534,2152.057189,40,18,0,22,7,Dudi Sela
1988,101033,2152.04743,6,1,0,5,15,John Letts
1991,100942,2152.024831,4,0,0,4,12,Thierry Tulasne
2000,103387,2152.006407,29,11,0,18,7,Paradorn Srichaphan
2001,102567,2152.003085,27,10,0,17,3,George Bastl
1986,101080,2151.996311,29,11,0,18,2,Lawson Duncan
1987,101109,2151.988959,29,12,0,17,6,Tarik Benhabiles
2010,104958,2151.949009,15,5,0,10,11,Carsten Ball
2000,103894,2151.935865,4,0,0,4,10,Phillip King
1992,101338,2151.929798,4,0,0,4,6,Olivier Soules
2013,105526,2151.921084,13,4,0,9,6,Jan Lennard Struff
1996,101374,2151.909013,6,1,0,5,10,Leonardo Lavalle
2004,104117,2151.885898,6,1,0,5,18,Giovanni Lapentti
1989,108823,2151.827922,4,0,0,4,22,Tintus Arianto Wibowo
2015,103720,2151.768365,13,4,0,9,12,Lleyton Hewitt
1993,102277,2151.748703,6,1,0,5,30,Bing Chao Lin
1991,101238,2151.74447,6,1,0,5,4,Andres Vysand
2003,103319,2151.741797,14,4,0,10,10,Jeff Morrison
2012,104676,2151.72561,8,2,0,6,32,Andreas Beck
2009,103429,2151.724545,8,2,0,6,3,Peter Luczak
1987,101251,2151.720337,18,7,0,11,16,Eric Winogradsky
2006,103868,2151.718077,9,2,0,7,4,Ivan Navarro
2005,104499,2151.696706,14,4,0,10,6,Jimmy Wang
2008,102035,2151.676055,22,8,0,14,5,Jonas Bjorkman
1992,102028,2151.66555,4,0,0,4,7,Massimo Valeri
2013,104932,2151.658459,24,9,0,15,5,Kenny De Schepper
1989,100825,2151.63778,4,0,0,4,22,Hugo Chapacu
2012,104559,2151.630959,6,1,0,5,6,Teymuraz Gabashvili
2014,106423,2151.579795,9,2,0,7,5,Thanasi Kokkinakis
2007,103201,2151.541098,4,0,0,4,11,Adrian Garcia
1996,101956,2151.508735,31,13,0,18,12,Mark Knowles
2014,104619,2151.477811,6,1,0,5,21,Jesse Huta Galung
2003,102107,2151.456366,6,1,0,5,3,Jan Frode Andersen
2000,102965,2151.370987,13,4,0,9,2,Jamie Delgado
2000,102247,2151.364099,27,9,0,18,7,Andrea Gaudenzi
2013,105132,2151.343092,7,1,0,6,6,Jurgen Zopp
1995,100997,2151.326043,6,1,0,5,33,Roger Smith
1993,101362,2151.303723,44,18,0,26,6,Stephane Simian
2007,103823,2151.267119,4,0,0,4,6,Denis Gremelmayr
2006,103672,2151.262121,13,4,0,9,8,Ricardo Mello
1989,101423,2151.245669,4,0,0,4,16,John Boytim
1991,101924,2151.236153,26,10,0,16,3,Stefano Pescosolido
1986,101097,2151.232216,4,0,0,4,20,Rick Leach
1985,100840,2151.219845,6,1,0,5,4,Mark Wooldridge
2011,105332,2151.216935,15,5,0,10,11,Benoit Paire
2005,102839,2151.192707,28,10,0,18,2,Nicolas Lapentti
2007,103188,2151.185637,29,10,0,19,3,Michael Russell
2012,104154,2151.158098,10,3,0,7,11,Paul Capdeville
2015,104424,2151.157271,19,6,0,13,7,Go Soeda
2012,104433,2151.133111,8,2,0,6,11,Frank Dancevic
1987,100928,2151.122046,21,7,0,14,3,Barry Moir
1990,100894,2151.115314,6,1,0,5,10,Francesco Cancellotti
2004,104229,2151.097694,15,5,0,10,6,Yen Hsun Lu
1986,101265,2151.095084,4,0,0,4,18,Patrick Mcenroe
2009,104323,2151.062887,4,0,0,4,11,Photos Kallias
1988,101061,2151.050008,21,7,0,14,3,Jimmy Arias
1997,102018,2151.042389,6,1,0,5,31,Tamer El Sawy
1991,101750,2151.037603,44,22,0,22,0,Cristiano Caratti
1999,102644,2151.03115,42,18,0,24,7,Franco Squillari
1997,102524,2151.020936,20,7,0,13,14,Neville Godwin
1999,102369,2150.942411,6,1,0,5,10,Julien Boutter
2004,102615,2150.917237,21,7,0,14,5,Dennis Van Scheppingen
1986,100417,2150.898824,16,6,0,10,2,Hans Gildemeister
2011,103812,2150.872991,41,16,0,25,11,Victor Hanescu
2002,103786,2150.870972,36,12,0,24,3,Nikolay Davydenko
1988,100603,2150.849454,9,2,0,7,11,Roland Stadler
2005,103240,2150.845963,44,19,0,25,3,Kevin Kim
2002,103151,2150.805414,48,20,0,28,2,Mariano Zabaleta
1991,101507,2150.797385,42,15,0,27,3,Tomas Carbonell
2015,105074,2150.754605,13,3,0,10,0,Ruben Bemelmans
1985,101007,2150.754071,11,3,0,8,19,Guillermo Rivas
2000,103484,2150.717722,4,0,0,4,16,James Blake
2002,104339,2150.705304,10,3,0,7,6,Mario Ancic
2011,104976,2150.692755,33,14,0,19,6,Ryan Sweeting
2011,104219,2150.675669,4,0,0,4,8,Stephane Bohli
2012,103672,2150.675585,8,2,0,6,12,Ricardo Mello
1986,100962,2150.670792,10,2,0,8,5,Thomas Hogstedt
1995,101233,2150.655317,8,2,0,6,17,Alex Antonitsch
2009,103573,2150.654833,10,3,0,7,11,Rik De Voest
2009,103868,2150.61975,28,9,0,19,12,Ivan Navarro
2008,102856,2150.610275,4,0,0,4,24,Gustavo Kuerten
1997,108820,2150.560391,4,0,0,4,19,Ganiyu Adenekan
2000,103294,2150.454665,38,15,0,23,2,Christophe Rochus
1998,102987,2150.443671,6,1,0,5,2,Andre Sa
2005,102494,2150.436675,21,7,0,14,5,Tomas Behrend
2013,104813,2150.430626,34,13,0,21,9,Grega Zemlja
1991,101809,2150.418186,10,3,0,7,4,Nicolas Pereira
1999,102023,2150.380335,6,1,0,5,8,Petr Luxa
2003,102796,2150.361263,28,10,0,18,7,Magnus Norman
1991,100978,2150.347679,7,1,0,6,13,Andrew Castle
2003,103786,2150.347486,63,30,0,33,2,Nikolay Davydenko
1996,103018,2150.339918,4,0,0,4,13,Max Mirnyi
1986,100657,2150.336704,39,16,0,23,2,Mike Leach
1989,100995,2150.292923,14,4,0,10,5,Eduardo Masso
1992,100870,2150.287707,34,12,0,22,3,Christo Van Rensburg
1996,102148,2150.277273,18,6,0,12,3,Fabrice Santoro
1988,100452,2150.274889,18,6,0,12,3,Bill Scanlon
1987,101550,2150.274007,6,1,0,5,16,Al Parker
1989,101308,2150.269375,19,6,0,13,3,Neil Broad
2003,103899,2150.264958,4,0,0,4,8,Stian Boretti
2015,104873,2150.24226,8,2,0,6,9,Aleksandr Nedovyesov
2011,103708,2150.208319,4,0,0,4,20,Jaroslav Pospisil
2012,104453,2150.146689,4,0,0,4,11,Michael Ryderstedt
2006,102642,2150.13285,14,4,0,10,3,Cyril Saulnier
2005,104166,2150.125611,4,0,0,4,10,Alex Bogomolov Jr
1986,101285,2150.112012,15,4,0,11,5,Thierry Champion
1989,110812,2150.100555,4,0,0,4,43,Alexander Schad
1997,101142,2150.098295,4,0,0,4,11,Emilio Sanchez
2011,104672,2150.089538,4,0,0,4,27,Vincent Millot
2015,105216,2150.066588,8,2,0,6,6,Yuichi Sugita
2015,104735,2150.052674,6,1,0,5,33,Tobias Kamke
2014,104166,2150.040277,8,2,0,6,31,Alex Bogomolov Jr
1996,102617,2150.01573,4,0,0,4,10,Kim Tiilikainen
2015,106045,2150.010138,22,8,0,14,5,Denis Kudla
2002,102887,2149.989463,31,10,0,21,6,Ramon Delgado
1996,101865,2149.958187,4,0,0,4,13,Albert Chang
1989,100905,2149.955332,16,5,0,11,18,Sammy Giammalva Jr
2008,103976,2149.952817,10,3,0,7,28,Juan Pablo Brzezicki
2000,103420,2149.912131,8,2,0,6,2,Michal Tabara
2004,101885,2149.886635,35,14,0,21,3,Wayne Arthurs
2006,102257,2149.883599,24,8,0,16,8,Greg Rusedski
1991,101086,2149.87681,43,16,0,27,3,Ronald Agenor
2015,126094,2149.858286,21,8,0,13,5,Andrey Rublev
2015,103813,2149.808208,30,12,0,18,6,Jarkko Nieminen
1991,101179,2149.727221,48,20,0,28,3,Jean Philippe Fleurian
1992,101133,2149.717727,34,13,0,21,3,Patrick Baur
2010,104947,2149.693424,15,5,0,10,5,Marsel Ilhan
2013,104897,2149.645955,8,2,0,6,20,Matthias Bachinger
1999,101917,2149.596983,5,0,0,5,9,Grant Stafford
2000,101945,2149.582969,9,2,0,7,4,Thierry Guardiola
1986,100360,2149.560894,21,8,0,13,8,Brian Teacher
1998,102076,2149.548666,4,0,0,4,11,Mark Merklein
1992,101238,2149.534354,4,0,0,4,18,Andres Vysand
1996,101417,2149.521927,4,0,0,4,11,Mario Rincon
1996,101358,2149.516811,10,2,0,8,6,Olivier Delaitre
1995,100763,2149.490141,6,1,0,5,37,Brad Gilbert
1993,101284,2149.455817,6,1,0,5,6,Lars Anders Wahlgren
2009,103967,2149.455132,6,1,0,5,3,Michael Lammer
1988,100884,2149.447077,21,8,0,13,20,Steve Shaw
1988,100772,2149.42703,44,16,0,28,3,Kelly Evernden
1985,101340,2149.418573,10,2,0,8,4,Ricky Brown
2011,104273,2149.40979,18,6,0,12,13,Edouard Roger Vasselin
2000,102776,2149.360738,48,21,0,27,2,Andrew Ilie
1996,101816,2149.325934,9,2,0,7,14,Steve Campbell
1987,100935,2149.315968,6,1,0,5,3,Michael Robertson
2010,103565,2149.285571,28,11,0,17,13,Stephane Robert
1990,101422,2149.284537,14,5,0,9,8,Mark Kaplan
1989,101731,2149.279766,15,5,0,10,18,Nuno Marques
1988,101174,2149.254676,4,0,0,4,2,Fernando Roese
1994,101233,2149.251057,33,12,0,21,6,Alex Antonitsch
1996,101962,2149.2331,37,15,0,22,6,Younes El Aynaoui
1991,110810,2149.128505,4,0,0,4,42,Lionel Eli
2007,103252,2149.122558,17,5,0,12,31,Alberto Martin
1993,101463,2149.087206,46,18,0,28,3,Bernd Karbacher
1989,101364,2149.070949,8,2,0,6,18,Bret Garnett
1992,102093,2149.051108,23,8,0,15,7,Martin Damm
1998,102770,2149.021324,37,15,0,22,2,John Van Lottum
2004,104259,2148.984285,16,6,0,10,3,Philipp Kohlschreiber
2002,102855,2148.980778,6,1,0,5,10,Jack Brasington
2009,104230,2148.976677,27,10,0,17,3,Daniel Koellerer
1997,101463,2148.976019,16,5,0,11,11,Bernd Karbacher
2006,105227,2148.938581,16,5,0,11,3,Marin Cilic
2006,103171,2148.937747,26,8,0,18,3,Raemon Sluiter
1999,101463,2148.926417,30,13,0,17,11,Bernd Karbacher
2009,104219,2148.868352,4,0,0,4,3,Stephane Bohli
2002,102934,2148.848022,21,8,0,13,7,Nicolas Coutelot
2006,103444,2148.845052,6,1,0,5,14,Jean Rene Lisnard
1985,101174,2148.773471,4,0,0,4,19,Fernando Roese
2008,104897,2148.766976,4,0,0,4,5,Matthias Bachinger
2013,106043,2148.766275,6,1,0,5,20,Diego Sebastian Schwartzman
1995,101567,2148.759778,7,1,0,6,3,Hendrik Jan Davids
1997,101772,2148.733913,16,5,0,11,11,Andrei Cherkasov
1999,103084,2148.643349,40,16,0,24,2,Guillermo Canas
2003,102696,2148.613592,4,0,0,4,17,Guillaume Couillard
1993,101096,2148.604267,6,1,0,5,32,Gary Muller
2015,106243,2148.596445,5,0,0,5,11,Mate Delic
2015,104268,2148.578844,20,7,0,13,11,Alejandro Falla
2005,108930,2148.577807,4,0,0,4,8,Juan Carlos Ramirez
1999,102131,2148.534129,4,0,0,4,34,Alistair Hunt
1994,101373,2148.521898,57,26,0,31,3,Karsten Braasch
2001,102971,2148.51936,4,0,0,4,18,Christophe Bosio
1990,100652,2148.487562,26,10,0,16,1,Cassio Motta
1987,100449,2148.48277,12,3,0,9,4,Stanislav Birner
1996,101179,2148.474927,24,9,0,15,6,Jean Philippe Fleurian
2004,104250,2148.467248,6,1,0,5,7,Prakash Amritraj
1998,102832,2148.454234,6,1,0,5,9,Andrian Raturandang
1999,101889,2148.405742,24,8,0,16,6,Todd Woodbridge
1999,102463,2148.379267,6,1,0,5,16,Lucas Arnold Ker
1998,101821,2148.366897,6,1,0,5,16,Peter Tramacchi
2002,103174,2148.352005,26,9,0,17,6,Noam Okun
1989,101368,2148.348991,4,0,0,4,15,Christian Miniussi
2007,102811,2148.306889,6,1,0,5,25,Dusan Vemic
1998,102110,2148.28704,31,12,0,19,2,Daniel Nestor
2001,102694,2148.26015,33,14,0,19,3,Lars Burgsmuller
2005,102374,2148.225229,6,1,0,5,28,Alex Corretja
1986,101131,2148.221474,27,9,0,18,9,Jimmy Brown
2014,103843,2148.213125,4,0,0,4,3,Marco Chiudinelli
1989,101327,2148.204441,7,1,0,6,17,Cyril Suk
1995,101866,2148.194725,20,7,0,13,3,David Rikl
2008,104323,2148.126864,4,0,0,4,17,Photos Kallias
1992,107117,2148.094017,4,0,0,4,19,Gordon Asciak
1992,110866,2148.094017,4,0,0,4,19,Christopher Gatt
1994,102078,2148.094017,4,0,0,4,36,Jorge Gonzalez
1995,102285,2148.094017,4,0,0,4,35,Nasser Ghanim Al Khulaifi
1995,102956,2148.094017,4,0,0,4,35,Sultan Khalfan
1995,108732,2148.094017,4,0,0,4,35,Carlos Martin Navarro Vergara
2004,104299,2148.094017,4,0,0,4,31,Hiu Tung Yu
2013,125572,2148.094017,4,0,0,4,34,Hillel Rousseau
2015,109257,2148.094017,4,0,0,4,19,Ignaci Roca
1998,102685,2148.090879,4,0,0,4,18,Sebastien Graeff
1998,102971,2148.090879,4,0,0,4,18,Christophe Bosio
2012,105935,2148.090204,4,0,0,4,11,Duilio Beretta
2014,123997,2148.081497,4,0,0,4,32,Joachim Bjerke
1985,100796,2148.056752,10,3,0,7,9,Ahmed El Mehelmy
2015,103898,2148.042135,6,1,0,5,35,Julien Benneteau
2008,103470,2147.990536,12,3,0,9,6,Robert Kendrick
1991,100815,2147.981015,29,11,0,18,7,David Pate
1988,101163,2147.978911,4,0,0,4,39,Juan Pablo Queirolo
1994,101298,2147.973786,26,9,0,17,5,Jonas Svensson
1989,101321,2147.964627,7,1,0,6,13,Juan Carlos Baguena
1985,100966,2147.964527,4,0,0,4,3,Nick Fulwood
2006,102565,2147.949971,28,9,0,19,6,Alexander Waske
1990,101500,2147.928378,12,3,0,9,12,Christian Saceanu
2011,104198,2147.917052,49,20,0,29,3,Guillermo Garcia Lopez
1988,101048,2147.839212,11,3,0,8,14,Francisco Maciel
2000,102737,2147.838937,4,0,0,4,9,Gergely Kisgyorgy
2010,105590,2147.825857,6,1,0,5,11,Uladzimir Ignatik
1989,101249,2147.810681,14,4,0,10,16,Andrei Olhovskiy
1986,100398,2147.803397,7,1,0,6,2,Julio Goes
1990,100990,2147.767982,47,20,0,27,1,Milan Srejber
1996,101507,2147.767109,46,21,0,25,3,Tomas Carbonell
2002,102999,2147.763776,23,8,0,15,7,Stefano Galvani
1999,103292,2147.721984,23,8,0,15,7,Gaston Gaudio
2001,102162,2147.683863,28,11,0,17,12,Chris Woodruff
2014,103997,2147.661646,17,5,0,12,19,Lukasz Kubot
1992,102146,2147.651946,9,2,0,7,7,Jordi Burillo
1998,108858,2147.627394,4,0,0,4,18,Jermaine Smith
1985,100884,2147.618779,23,9,0,14,5,Steve Shaw
2014,126340,2147.601814,4,0,0,4,32,Viktor Durasovic
1986,100831,2147.599575,6,1,0,5,2,Rick Rudeen
1996,101101,2147.592904,4,0,0,4,34,Richard Ashby
2011,104035,2147.590491,6,1,0,5,2,Bobby Reynolds
1997,103739,2147.581066,4,0,0,4,10,Jose De Armas
2002,108610,2147.572882,4,0,0,4,17,Tsolak Gevorgyan
2002,108618,2147.572603,4,0,0,4,8,Karim Alayli
1993,110943,2147.571302,4,0,0,4,21,Adel Lahdhiri
1998,108879,2147.571302,4,0,0,4,18,Lawrence Tere
1999,102285,2147.571302,4,0,0,4,34,Nasser Ghanim Al Khulaifi
1999,108757,2147.571302,4,0,0,4,18,Jean Kome Loglo
2002,108645,2147.571302,4,0,0,4,31,Musaad Al Jazzaf
2010,105499,2147.571302,4,0,0,4,22,Christopher Diaz Figueroa
2006,103181,2147.568597,27,10,0,17,3,Jiri Vanek
1986,100253,2147.550038,14,4,0,10,17,Tom Gullikson
2005,102615,2147.545331,4,0,0,4,16,Dennis Van Scheppingen
2012,104868,2147.543251,7,1,0,6,22,James Ward
1996,101473,2147.525301,7,1,0,6,10,Jozsef Krocsko
1996,102669,2147.439848,4,0,0,4,6,Noam Behr
1988,101058,2147.433451,17,6,0,11,5,Francisco Yunis
1998,102533,2147.40019,23,8,0,15,2,Jens Knippschild
1996,100936,2147.387464,4,0,0,4,23,Henri Leconte
1988,107468,2147.378436,4,0,0,4,29,Julian Stamatov
1987,100315,2147.375764,4,0,0,4,18,Hank Pfister
2014,105589,2147.374555,4,0,0,4,4,Gerald Melzer
2012,104898,2147.374406,47,19,0,28,4,Robin Haase
1996,101285,2147.35751,6,1,0,5,6,Thierry Champion
1986,100602,2147.340305,11,3,0,8,7,Vallis Wilder
1996,101582,2147.303142,44,18,0,26,3,Gilbert Schaller
1997,102405,2147.265214,10,2,0,8,10,Mahesh Bhupathi
2003,104250,2147.259403,9,2,0,7,7,Prakash Amritraj
1999,102783,2147.216329,52,23,0,29,2,Rainer Schuettler
1987,100714,2147.195861,32,12,0,20,7,Broderick Dyke
2002,102965,2147.186466,4,0,0,4,18,Jamie Delgado
1994,101439,2147.183859,58,25,0,33,3,Javier Sanchez
2004,102720,2147.166861,11,3,0,8,6,Tomas Zib
1996,101150,2147.15652,21,7,0,14,7,Gianluca Pozzi
1996,108825,2147.082134,4,0,0,4,19,Mark Schembri
2000,101825,2147.048588,4,0,0,4,37,Manuel Tejada
2007,108958,2147.047008,4,0,0,4,35,Damion Johnson
2014,105812,2147.047008,4,0,0,4,28,David Agung Susanto
2015,105909,2147.042498,4,0,0,4,19,Sam Barry
1996,101649,2147.028798,7,1,0,6,8,Guillermo Perez Roldan
2005,102843,2147.006265,4,0,0,4,17,Suwandi Suwandi
2014,105166,2146.97675,10,2,0,8,13,Peter Polansky
1987,100736,2146.969683,4,0,0,4,12,Hugo Nunez
1985,101158,2146.961536,37,14,0,23,3,John Frawley
1987,100841,2146.943078,4,0,0,4,22,Jin Sun Yoo
1992,101373,2146.908998,21,7,0,14,11,Karsten Braasch
2015,104593,2146.906526,31,13,0,18,6,Daniel Gimeno Traver
1991,101117,2146.894992,39,14,0,25,3,Eric Jelen
2012,105539,2146.836162,4,0,0,4,6,Evgeny Donskoy
1992,101701,2146.813524,4,0,0,4,35,Bing Pan
1999,101969,2146.797048,16,5,0,11,10,Orlin Stanoytchev
2009,104397,2146.794022,4,0,0,4,26,Laurent Recouderc
2007,102565,2146.780899,10,2,0,8,12,Alexander Waske
1993,101776,2146.726555,27,8,0,19,16,Sandon Stolle
1991,101232,2146.716762,14,4,0,10,7,Nicklas Kroon
1985,101265,2146.711825,5,0,0,5,13,Patrick Mcenroe
2008,103917,2146.699558,42,16,0,26,3,Nicolas Mahut
2002,104215,2146.689623,4,0,0,4,17,Andrei Gorban
2003,102382,2146.661353,8,2,0,6,14,Julian Knowle
2001,102832,2146.658936,4,0,0,4,33,Andrian Raturandang
2010,105095,2146.606598,32,12,0,20,13,Evgeny Korolev
1996,108752,2146.584784,4,0,0,4,34,Shehab Shehab
1988,108532,2146.582902,4,0,0,4,39,Worapol Thongkamcho
1993,111001,2146.563402,4,0,0,4,36,Emad Abou Hamdeh
1991,101642,2146.558837,26,9,0,17,3,Bart Wuyts
2004,104580,2146.524294,4,0,0,4,18,Haithem Abid
2010,103506,2146.521992,4,0,0,4,43,Martin Vassallo Arguello
1995,102214,2146.511947,4,0,0,4,19,Oscar Ortiz
2014,104593,2146.50436,31,11,0,20,4,Daniel Gimeno Traver
1994,101165,2146.495419,4,0,0,4,36,Mario Tabares
2002,102524,2146.490173,9,2,0,7,12,Neville Godwin
2011,104890,2146.48932,22,8,0,14,6,Andreas Haider Maurer
1993,106506,2146.477251,4,0,0,4,21,Alkis Papamichael
1998,103114,2146.464796,4,0,0,4,20,Martin Lee
1987,101284,2146.447618,9,2,0,7,6,Lars Anders Wahlgren
1998,102118,2146.430819,16,5,0,11,16,Radomir Vasek
1991,102223,2146.395186,4,0,0,4,34,Karim Alami
1988,100833,2146.331426,22,7,0,15,3,Marc Flur
2005,103656,2146.296043,29,10,0,19,7,Albert Montanes
1989,101371,2146.291206,6,1,0,5,24,Malcolm Allen
2003,103166,2146.256504,30,12,0,18,3,Vladimir Voltchkov
1993,101364,2146.246174,4,0,0,4,14,Bret Garnett
1997,101750,2146.228897,7,1,0,6,11,Cristiano Caratti
2013,104619,2146.216689,8,2,0,6,1,Jesse Huta Galung
1995,100954,2146.215271,13,4,0,9,35,Luiz Mattar
1991,101106,2146.21425,38,13,0,25,3,Peter Lundgren
2008,102434,2146.199502,32,13,0,19,10,Vincent Spadea
1996,101924,2146.176706,38,13,0,25,6,Stefano Pescosolido
2010,103454,2146.167561,14,5,0,9,22,Nicolas Massu
1991,101765,2146.11474,4,0,0,4,7,Tomas Anzari
2007,103387,2146.110902,6,1,0,5,36,Paradorn Srichaphan
2015,111200,2146.088453,13,4,0,9,12,Elias Ymer
1986,100922,2146.065067,22,7,0,15,4,Roberto Arguello
2014,104639,2146.061266,5,0,0,5,10,Wayne Odesnik
1989,100924,2146.053769,9,2,0,7,2,Jorge Lozano
1999,102831,2146.049243,9,2,0,7,7,Jacobo Diaz
1996,108800,2146.040927,4,0,0,4,28,Alexander Lehnhoff
1992,101101,2146,4,0,0,4,35,Richard Ashby
2001,102911,2145.971976,42,18,0,24,3,Andrei Stoliarov
2015,104660,2145.910632,47,20,0,27,5,Sergiy Stakhovsky
2005,103888,2145.890371,17,6,0,11,10,Mardy Fish
1986,101185,2145.886724,25,11,0,14,3,Mark Woodforde
1985,100450,2145.879823,4,0,0,4,10,Leo Palin
2000,102104,2145.874915,27,9,0,18,2,Christian Ruud
2009,103240,2145.843604,23,7,0,16,4,Kevin Kim
1985,100660,2145.835327,37,13,0,24,4,Bob Green
2004,101962,2145.803029,5,0,0,5,11,Younes El Aynaoui
1985,100645,2145.777779,29,11,0,18,3,Huub Van Boeckel
2013,105053,2145.701278,41,16,0,25,3,Santiago Giraldo
2008,103794,2145.637877,31,11,0,20,3,Benjamin Becker
2004,103709,2145.636478,12,3,0,9,5,Kristian Pless
2005,102202,2145.620792,42,17,0,25,3,Kenneth Carlsen
2013,103598,2145.559171,32,13,0,19,13,Xavier Malisse
1994,101071,2145.486159,4,0,0,4,17,Tom Nijssen
1990,100800,2145.46514,30,12,0,18,1,Diego Perez
2005,104121,2145.45559,5,0,0,5,6,Tobias Summerer
1988,101262,2145.423779,4,0,0,4,19,Rikard Bergh
1988,101232,2145.415037,27,10,0,17,9,Nicklas Kroon
1988,101274,2145.407543,14,4,0,10,6,Udo Riglewski
1990,101387,2145.396501,26,8,0,18,7,Claudio Pistolesi
2007,103401,2145.270906,22,7,0,15,17,Jan Hernych
2006,103582,2145.258883,15,4,0,11,6,Michael Berrer
2008,103799,2145.251251,4,0,0,4,18,Eric Prodon
1991,101421,2145.22495,32,12,0,20,6,Veli Paloheimo
1990,101066,2145.206918,13,4,0,9,9,Richard Matuszewski
1993,100628,2145.15711,11,3,0,8,25,Michiel Schapers
2001,102772,2145.143742,6,1,0,5,9,Yu Zhang
2007,103294,2145.114834,12,3,0,9,3,Christophe Rochus
1993,101961,2145.10619,9,2,0,7,3,Martin Stringari
1989,100942,2145.090486,27,10,0,17,10,Thierry Tulasne
1995,101917,2145.087823,9,2,0,7,15,Grant Stafford
1994,107481,2145.053035,4,0,0,4,36,Karl Hale
2012,104122,2145.039845,56,25,0,31,3,Carlos Berlocq
1992,101567,2145.033116,4,0,0,4,7,Hendrik Jan Davids
2005,102358,2145.024253,19,7,0,12,3,Thomas Enqvist
2010,104500,2145.007217,22,8,0,14,11,Somdev Devvarman
2001,103602,2144.867754,15,5,0,10,11,Fernando Gonzalez
1988,101889,2144.841069,7,1,0,6,10,Todd Woodbridge
2014,105077,2144.788557,33,13,0,20,3,Albert Ramos
1998,102050,2144.784579,4,0,0,4,10,Marco Meneschincheri
1987,100280,2144.754697,5,0,0,5,9,Wojtek Fibak
2008,105028,2144.73509,25,8,0,17,6,Jesse Levine
1987,100913,2144.710795,9,2,0,7,24,Peter Carlsson
1992,101232,2144.694647,10,2,0,8,7,Nicklas Kroon
2002,102021,2144.679052,25,7,0,18,6,Michael Chang
1986,100446,2144.644816,33,12,0,21,3,John Sadri
1994,101962,2144.626767,46,19,0,27,3,Younes El Aynaoui
2010,103857,2144.605477,20,6,0,14,5,Igor Kunitsyn
2013,105992,2144.527996,32,11,0,21,8,Ryan Harrison
2001,103817,2144.518533,4,0,0,4,10,Yu Jr Wang
1989,100865,2144.502089,5,0,0,5,17,Marcelo Ingaramo
1989,101133,2144.486244,13,4,0,9,9,Patrick Baur
1991,100711,2144.44537,18,6,0,12,10,Pedro Rebolledo
2014,103786,2144.442268,17,6,0,11,23,Nikolay Davydenko
2013,103812,2144.431052,44,18,0,26,5,Victor Hanescu
2007,103451,2144.421211,14,4,0,10,8,Bjorn Phau
2004,103789,2144.415066,37,16,0,21,3,Irakli Labadze
1992,101685,2144.414854,28,11,0,17,6,Markus Naewie
1988,100978,2144.406194,23,8,0,15,4,Andrew Castle
1999,102306,2144.384,18,5,0,13,10,Michael Kohlmann
2006,103523,2144.38122,7,1,0,6,7,Rohan Bopanna
1995,101150,2144.310531,31,10,0,21,6,Gianluca Pozzi
1986,100640,2144.228878,4,0,0,4,19,Stefan Simonsson
2014,103188,2144.212784,17,6,0,11,13,Michael Russell
1992,101096,2144.193676,29,12,0,17,6,Gary Muller
1997,101362,2144.118476,23,8,0,15,17,Stephane Simian
2007,103286,2144.107525,4,0,0,4,9,Yohny Romero
2002,103656,2144.002869,41,17,0,24,3,Albert Montanes
2004,102269,2143.955746,14,4,0,10,10,Jeff Salzenstein
2011,104978,2143.941151,15,4,0,11,6,Daniel Brands
1985,100719,2143.773998,10,2,0,8,11,Juan Avendano
1989,101285,2143.73492,12,3,0,9,21,Thierry Champion
1986,100728,2143.726616,23,8,0,15,5,Todd Nelson
2011,104797,2143.717197,34,12,0,22,10,Denis Istomin
1987,101053,2143.699196,13,4,0,9,16,Michael Kures
2008,103525,2143.629165,4,0,0,4,8,Ivan Miranda
1997,102821,2143.604391,9,2,0,7,12,Cecil Mamiit
2009,103105,2143.509774,14,4,0,10,4,Ruben Ramirez Hidalgo
1993,101174,2143.467132,4,0,0,4,4,Fernando Roese
2015,105807,2143.444545,39,14,0,25,3,Pablo Carreno Busta
2010,103248,2143.38225,7,1,0,6,12,Harel Levy
1985,100395,2143.371238,35,15,0,20,13,Victor Pecci
1990,101696,2143.334815,5,0,0,5,7,Federico Mordegan
1997,102184,2143.285174,44,16,0,28,2,David Prinosil
2015,104563,2143.256728,13,4,0,9,18,Luca Vanni
2015,105613,2143.211792,7,1,0,6,5,Norbert Gombos
2004,103225,2143.195253,7,1,0,6,8,Simon Larose
2015,103565,2143.177773,7,1,0,6,17,Stephane Robert
1991,101022,2143.1725,7,1,0,6,7,Kelly Jones
2011,103470,2143.169092,13,4,0,9,25,Robert Kendrick
1998,101495,2143.158317,5,0,0,5,9,Miguel Tobon
1987,100964,2143.111754,14,4,0,10,7,Jon Levine
2015,106378,2143.020591,7,1,0,6,0,Kyle Edmund
1990,101174,2142.99808,6,1,0,5,1,Fernando Roese
2013,106035,2142.990016,4,0,0,4,11,Isak Arvidsson
2000,103781,2142.962527,5,0,0,5,19,Jurgen Melzer
1987,100518,2142.918026,15,5,0,10,5,Ricardo Acuna
2000,103444,2142.917983,7,1,0,6,2,Jean Rene Lisnard
1987,100970,2142.895469,12,3,0,9,10,Stefan Eriksson
2001,102446,2142.888557,28,11,0,17,3,Andrei Medvedev
2001,103184,2142.855267,15,4,0,11,3,Bob Bryan
2004,102882,2142.846378,29,11,0,18,6,Mark Philippoussis
2015,105051,2142.82183,7,1,0,6,8,Matthew Ebden
2006,102834,2142.792735,37,16,0,21,3,Paul Goldstein
1997,102318,2142.774438,28,10,0,18,2,Andrei Pavel
1989,101216,2142.773468,20,7,0,13,16,Olli Rahnasto
2004,104433,2142.759365,7,1,0,6,8,Frank Dancevic
1992,101642,2142.750668,39,15,0,24,3,Bart Wuyts
1994,101717,2142.747049,28,10,0,18,6,Diego Nargiso
2011,105872,2142.718833,4,0,0,4,20,Christian Lindell
2001,103188,2142.69704,25,8,0,17,3,Michael Russell
2007,104831,2142.69334,4,0,0,4,21,Bartolome Salva Vidal
2004,103157,2142.639417,8,1,0,7,7,Arvind Parmar
2005,104597,2142.638012,35,13,0,22,5,Nicolas Almagro
2013,103794,2142.608064,29,9,0,20,5,Benjamin Becker
1985,100728,2142.574463,22,7,0,15,5,Todd Nelson
1996,101263,2142.49885,12,3,0,9,14,Luke Jensen
2002,102831,2142.438481,7,1,0,6,34,Jacobo Diaz
2011,104523,2142.423106,29,11,0,18,11,Frederico Gil
2010,104095,2142.407197,5,0,0,5,27,David Guez
2002,102179,2142.373894,37,14,0,23,2,Antony Dupuis
1990,100713,2142.31738,19,6,0,13,1,John Fitzgerald
2001,102800,2142.306269,7,1,0,6,3,Nenad Zimonjic
2008,105053,2142.202831,13,4,0,9,3,Santiago Giraldo
1994,101703,2142.166465,35,15,0,20,4,Guillaume Raoux
2000,102133,2142.163826,29,10,0,19,7,Laurence Tieleman
1990,100901,2142.089572,27,10,0,17,4,Paul Annacone
1999,101382,2142.069852,18,6,0,12,7,Marcelo Filippini
2003,102567,2142.053572,5,0,0,5,6,George Bastl
1997,101767,2142.00155,9,2,0,7,20,Lars Jonsson
1999,102836,2142.000316,4,0,0,4,19,Rogier Wassen
1996,101659,2141.919194,12,3,0,9,27,Jan Apell
1991,101119,2141.862155,44,18,0,26,3,Marian Vajda
2012,105577,2141.805005,20,5,0,15,6,Vasek Pospisil
1985,100276,2141.773851,35,13,0,22,9,Terry Moor
2007,104019,2141.728453,40,15,0,25,3,Kristof Vliegen
2008,103868,2141.70464,21,7,0,14,3,Ivan Navarro
1999,101434,2141.697104,18,6,0,12,22,Petr Korda
2008,103105,2141.669475,7,1,0,6,9,Ruben Ramirez Hidalgo
1992,100829,2141.560172,12,3,0,9,11,Jan Gunnarsson
1996,101086,2141.553827,5,0,0,5,16,Ronald Agenor
2004,103656,2141.543106,28,11,0,17,3,Albert Montanes
1987,101020,2141.514005,13,3,0,10,3,Hans Schwaier
2014,106121,2141.418497,9,2,0,7,6,Taro Daniel
1992,101783,2141.389438,7,1,0,6,10,Mark Petchey
2006,103656,2141.379785,29,11,0,18,3,Albert Montanes
2013,105379,2141.344737,29,11,0,18,13,Aljaz Bedene
2008,102318,2141.299995,5,0,0,5,37,Andrei Pavel
2000,101900,2141.242912,5,0,0,5,23,Nicklas Kulti
1991,101096,2141.232255,38,15,0,23,3,Gary Muller
2009,104154,2141.217301,25,9,0,16,11,Paul Capdeville
2006,104229,2141.17107,9,2,0,7,6,Yen Hsun Lu
2002,103487,2141.160639,7,1,0,6,22,Federico Luzzi
2005,102300,2141.159671,4,0,0,4,6,Gouichi Motomura
1992,101016,2141.13587,31,12,0,19,3,Marcos Aurelio Gorriz
2007,103077,2141.100477,11,3,0,8,17,Konstantinos Economidis
2004,103176,2141.027497,47,20,0,27,4,David Sanchez
2012,103656,2140.94836,23,7,0,16,12,Albert Montanes
2007,103292,2140.92261,20,6,0,14,18,Gaston Gaudio
1989,100978,2140.89908,7,1,0,6,4,Andrew Castle
2000,102722,2140.81146,13,4,0,9,9,Attila Savolt
2000,102443,2140.810396,11,3,0,8,2,Barry Cowan
1989,101574,2140.733849,11,3,0,8,13,Alejandro Aramburu
2008,104635,2140.71384,5,0,0,5,7,Robert Smeets
2000,102455,2140.709617,16,5,0,11,16,Lorenzo Manta
2004,103324,2140.708017,12,3,0,9,7,Arnaud Di Pasquale
1997,103206,2140.675274,5,0,0,5,5,Sebastien Grosjean
2014,105732,2140.660669,16,5,0,11,2,Pierre Hugues Herbert
1985,100986,2140.624093,13,4,0,9,12,Dacio Campos
1995,101373,2140.594687,26,9,0,17,13,Karsten Braasch
1986,100928,2140.581469,24,8,0,16,3,Barry Moir
1999,102433,2140.537879,7,1,0,6,10,Mose Navarra
1987,100356,2140.447385,23,7,0,16,10,Paul Mcnamee
1993,101507,2140.372668,46,18,0,28,3,Tomas Carbonell
2013,105099,2140.313807,5,0,0,5,18,Antonio Veic
1987,100962,2140.303165,23,8,0,15,6,Thomas Hogstedt
2007,103429,2140.273426,12,3,0,9,6,Peter Luczak
2001,102821,2140.234887,28,10,0,18,7,Cecil Mamiit
1995,101441,2140.123875,38,16,0,22,3,Martin Sinner
1999,102401,2140.030511,28,11,0,17,11,Scott Draper
2007,104252,2139.963924,43,18,0,25,6,Florian Mayer
1993,101809,2139.939449,17,5,0,12,13,Nicolas Pereira
1993,101750,2139.915088,7,1,0,6,10,Cristiano Caratti
2011,104003,2139.904751,7,1,0,6,11,Victor Crivoi
2007,102999,2139.884047,11,3,0,8,6,Stefano Galvani
1985,101063,2139.842554,11,3,0,8,13,Jordi Arrese
1987,100957,2139.738659,24,9,0,15,4,Greg Holmes
2012,104214,2139.706236,29,12,0,17,11,Igor Andreev
2008,103701,2139.69364,9,2,0,7,30,Diego Hartfield
2007,104056,2139.690072,10,2,0,8,3,Roko Karanusic
2004,102730,2139.652306,22,7,0,15,3,Ivo Heuberger
2004,103294,2139.636759,28,10,0,18,2,Christophe Rochus
2011,102783,2139.630786,18,5,0,13,24,Rainer Schuettler
1991,101109,2139.608431,16,5,0,11,12,Tarik Benhabiles
2002,103737,2139.561726,5,0,0,5,15,Edgardo Massa
2000,103428,2139.528963,32,14,0,18,12,Juan Ignacio Chela
1989,101226,2139.520473,22,7,0,15,9,Johan Carlsson
2004,103812,2139.493648,44,19,0,25,2,Victor Hanescu
2014,104864,2139.470804,11,3,0,8,14,Alex Kuznetsov
2011,103523,2139.456722,5,0,0,5,12,Rohan Bopanna
1989,101703,2139.438572,7,1,0,6,30,Guillaume Raoux
2015,106043,2139.40848,33,11,0,22,11,Diego Sebastian Schwartzman
2008,103018,2139.40348,10,2,0,8,12,Max Mirnyi
2010,104216,2139.359688,12,3,0,9,5,Maximo Gonzalez
2010,104978,2139.353238,28,9,0,19,3,Daniel Brands
1987,100660,2139.336632,7,1,0,6,37,Bob Green
1986,100280,2139.289878,17,5,0,12,7,Wojtek Fibak
1994,102061,2139.209914,6,0,0,6,12,Kevin Ullyett
1990,101611,2139.209616,17,5,0,12,1,Cedric Pioline
2004,102358,2139.198984,35,14,0,21,2,Thomas Enqvist
1985,100300,2139.187569,20,7,0,13,6,Jose Higueras
1990,101393,2139.175369,27,9,0,18,4,Jens Woehrmann
1988,100950,2139.173034,30,10,0,20,2,Libor Pimek
2001,102135,2139.131441,7,1,0,6,17,Emilio Benfele Alvarez
1992,101924,2139.104957,48,21,0,27,3,Stefano Pescosolido
1999,101688,2139.071653,7,1,0,6,16,Geoff Grant
1996,101230,2139.066487,37,12,0,25,3,Andrei Chesnokov
1992,101205,2139.065661,28,10,0,18,3,Grant Connell
1987,100759,2139.006741,23,8,0,15,3,Danie Visser
1992,101432,2139.005331,10,2,0,8,3,Dimitri Poliakov
2001,101735,2139.001383,10,2,0,8,19,Richard Fromberg
1986,100276,2138.99837,5,0,0,5,3,Terry Moor
1986,100460,2138.997602,18,6,0,12,4,Jose Lopez Maeso
1989,101000,2138.985384,18,6,0,12,13,Carl Limberger
2001,102703,2138.926857,31,12,0,19,7,Hyung Taik Lee
2004,102694,2138.880997,27,8,0,19,6,Lars Burgsmuller
1993,102202,2138.879941,48,19,0,29,3,Kenneth Carlsen
2009,102905,2138.846272,21,8,0,13,4,Stefan Koubek
1995,100936,2138.8083,22,8,0,14,4,Henri Leconte
2003,102184,2138.808238,5,0,0,5,6,David Prinosil
2005,102179,2138.805951,21,7,0,14,5,Antony Dupuis
1987,100646,2138.765746,26,9,0,17,10,Claudio Panatta
2010,104117,2138.734326,5,0,0,5,11,Giovanni Lapentti
1992,101835,2138.702443,24,8,0,16,7,Arne Thoms
1995,101515,2138.666324,9,2,0,7,3,Donald Johnson
1992,101154,2138.639137,40,17,0,23,6,Simon Youl
1987,100978,2138.5946,26,8,0,18,4,Andrew Castle
1998,101589,2138.540079,9,2,0,7,32,Arnaud Boetsch
1997,101589,2138.448121,37,14,0,23,5,Arnaud Boetsch
1996,102832,2138.432771,7,1,0,6,10,Andrian Raturandang
2001,102533,2138.401261,19,6,0,13,17,Jens Knippschild
2011,103451,2138.399424,9,2,0,7,27,Bjorn Phau
1997,101731,2138.282341,14,4,0,10,10,Nuno Marques
1996,101481,2138.210218,18,5,0,13,7,Omar Camporese
1987,100551,2138.198754,29,12,0,17,7,Brad Drewett
1991,101500,2138.1961,35,15,0,20,3,Christian Saceanu
2013,105676,2138.187862,34,11,0,23,13,David Goffin
1994,101066,2138.162418,7,1,0,6,6,Richard Matuszewski
2005,103420,2138.126557,14,4,0,10,15,Michal Tabara
2008,103429,2138.10816,18,6,0,12,8,Peter Luczak
2013,103997,2138.107379,31,11,0,20,5,Lukasz Kubot
1986,101071,2138.067602,5,0,0,5,26,Tom Nijssen
1987,100701,2138.052794,5,0,0,5,10,Marko Ostoja
1993,101440,2137.926326,7,1,0,6,9,Mark Koevermans
1990,100631,2137.874086,20,7,0,13,1,Tim Wilkison
2012,104897,2137.847116,25,9,0,16,10,Matthias Bachinger
2012,103893,2137.834257,28,9,0,19,0,Paolo Lorenzi
2012,104534,2137.736667,31,12,0,19,9,Dudi Sela
2011,104214,2137.671047,45,17,0,28,6,Igor Andreev
1991,100652,2137.616989,10,2,0,8,3,Cassio Motta
1998,103031,2137.595447,48,17,0,31,2,Julian Alonso
1992,100628,2137.556114,43,17,0,26,3,Michiel Schapers
1994,101391,2137.542687,26,8,0,18,3,Carl Uwe Steeb
1996,101717,2137.526104,10,2,0,8,9,Diego Nargiso
2011,104349,2137.508649,21,7,0,14,2,Rui Machado
2000,102154,2137.492947,5,0,0,5,16,Marcos Ondruska
1996,100997,2137.489008,5,0,0,5,14,Roger Smith
2005,103566,2137.472992,32,10,0,22,3,Michael Llodra
2004,103580,2137.426748,15,4,0,11,3,Alexander Peya
2003,103204,2137.418494,5,0,0,5,16,Hugo Armando
2012,103582,2137.408853,16,5,0,11,6,Michael Berrer
1987,100587,2137.38236,5,0,0,5,8,Steve Guy
2015,106065,2137.353949,7,1,0,6,1,Marco Cecchinato
2015,105292,2137.336192,16,5,0,11,12,Alejandro Gonzalez
2014,104433,2137.265087,11,3,0,8,9,Frank Dancevic
1988,101332,2137.220967,20,6,0,14,10,Gilad Bloom
2014,105992,2137.214657,18,5,0,13,10,Ryan Harrison
1987,100780,2137.167011,13,3,0,10,8,Mike De Palmer
2008,103181,2137.147078,22,7,0,15,10,Jiri Vanek
1991,101123,2137.112015,41,16,0,25,3,Alexander Mronz
2014,103917,2136.971392,37,14,0,23,8,Nicolas Mahut
2015,104932,2136.969719,14,4,0,10,6,Kenny De Schepper
2014,106378,2136.909595,5,0,0,5,19,Kyle Edmund
1999,103166,2136.893102,9,2,0,7,10,Vladimir Voltchkov
1998,101997,2136.88791,15,4,0,11,2,Marzio Martelli
2008,104851,2136.878975,7,1,0,6,18,Gianluca Naso
2007,102950,2136.873983,5,0,0,5,22,Fernando Vicente
2013,104330,2136.842056,15,4,0,11,9,Rajeev Ram
2013,104534,2136.802494,14,4,0,10,6,Dudi Sela
1997,101026,2136.774733,9,2,0,7,18,Jim Grabb
2011,105041,2136.773223,13,4,0,9,13,Lukas Lacko
2014,105902,2136.689281,8,1,0,7,7,James Duckworth
2001,102965,2136.674939,11,3,0,8,7,Jamie Delgado
1985,100519,2136.659629,13,3,0,10,10,Scott Mccain
1999,102286,2136.655522,27,10,0,17,9,Wayne Black
2014,105292,2136.595546,30,10,0,20,9,Alejandro Gonzalez
2011,105373,2136.564426,9,2,0,7,2,Martin Klizan
2011,102821,2136.543959,5,0,0,5,12,Cecil Mamiit
1994,101312,2136.521193,35,13,0,22,6,Robbie Weiss
2012,104869,2136.435944,10,2,0,8,11,Sergei Bubka
2013,106309,2136.399274,5,0,0,5,11,Wisnu Adi Nugroho
1990,101126,2136.352996,9,2,0,7,11,Chris Pridham
1993,101460,2136.316652,26,10,0,16,4,Jose Francisco Altur
2002,103297,2136.31632,15,4,0,11,6,Alex Kim
1986,100701,2136.309959,28,10,0,18,5,Marko Ostoja
1992,102304,2136.30918,8,1,0,7,8,Grant Doyle
1986,100337,2136.300623,12,3,0,9,8,Mark Edmondson
1989,100631,2136.253748,24,8,0,16,12,Tim Wilkison
1995,101970,2136.232334,5,0,0,5,11,Iztok Bozic
2009,104719,2136.229017,41,16,0,25,3,Marcel Granollers
1986,100646,2136.212922,27,9,0,18,12,Claudio Panatta
1998,103084,2136.200646,21,7,0,14,2,Guillermo Canas
1995,101682,2136.185584,7,1,0,6,15,David Adams
1999,101150,2136.172958,44,17,0,27,2,Gianluca Pozzi
2013,104297,2136.171183,9,1,0,8,11,Rogerio Dutra Silva
1985,100460,2136.141541,19,7,0,12,13,Jose Lopez Maeso
1994,101710,2136.130224,5,0,0,5,11,Martin Blackman
1986,101374,2136.086851,31,11,0,20,5,Leonardo Lavalle
2002,102567,2136.068088,12,3,0,9,3,George Bastl
1999,101404,2135.993184,16,5,0,11,23,Thomas Muster
2000,102227,2135.92361,41,15,0,26,2,Sargis Sargsian
2013,105733,2135.844018,16,5,0,11,13,Rhyne Williams
1997,101481,2135.839617,15,4,0,11,10,Omar Camporese
1986,100809,2135.819838,19,5,0,14,19,Juan Aguilera
1988,101014,2135.758082,28,9,0,19,3,John Ross
1989,101339,2135.724584,11,2,0,9,5,Agustin Moreno
2001,102880,2135.703968,12,3,0,9,14,Alexander Popp
2004,103153,2135.691416,19,6,0,13,5,Gilles Elseneer
1989,102235,2135.680196,5,0,0,5,8,Tommy Ho
2013,106045,2135.672256,16,5,0,11,5,Denis Kudla
1992,100727,2135.6667,5,0,0,5,3,Raul Antonio Viver
1996,102843,2135.648421,5,0,0,5,34,Suwandi Suwandi
1986,100935,2135.580512,15,5,0,10,3,Michael Robertson
2003,103105,2135.554864,16,5,0,11,3,Ruben Ramirez Hidalgo
1990,100810,2135.523275,37,14,0,23,5,Paul Chamberlin
1986,100945,2135.519556,5,0,0,5,8,Craig Campbell
1986,100894,2135.437052,25,9,0,16,12,Francesco Cancellotti
1995,101249,2135.433868,33,12,0,21,3,Andrei Olhovskiy
1987,100603,2135.383313,16,4,0,12,11,Roland Stadler
1998,103252,2135.296821,8,1,0,7,31,Alberto Martin
1989,100893,2135.276453,10,2,0,8,13,Joakim Nystrom
1985,100562,2135.229746,13,3,0,10,5,Tom Cain
2002,103451,2135.226646,7,1,0,6,9,Bjorn Phau
2006,103535,2135.223525,11,3,0,8,3,Olivier Patience
2003,103294,2135.220233,33,12,0,21,4,Christophe Rochus
1998,102730,2135.213897,21,6,0,15,2,Ivo Heuberger
1985,100565,2135.158366,19,6,0,13,3,Lloyd Bourne
2005,102227,2135.143293,12,3,0,9,18,Sargis Sargsian
2000,102812,2135.142701,5,0,0,5,9,Jicham Zaatini
1995,101597,2135.132642,10,2,0,8,7,Louis Gloria
2013,102967,2135.052666,5,0,0,5,10,Marc Gicquel
2000,101956,2135.047553,5,0,0,5,16,Mark Knowles
1985,100998,2135.02271,10,2,0,8,5,Stuart Bale
1991,101398,2134.970645,10,2,0,8,7,Neil Borwick
2002,102869,2134.925407,27,8,0,19,9,Galo Blanco
1995,101417,2134.908679,5,0,0,5,12,Mario Rincon
1995,102085,2134.903048,10,2,0,8,10,Sasa Hirszon
1985,100524,2134.869374,6,0,0,6,6,Shozo Shiraishi
2011,104433,2134.851917,9,2,0,7,13,Frank Dancevic
2005,103294,2134.795754,46,18,0,28,2,Christophe Rochus
1992,100837,2134.793393,22,7,0,15,3,Jeremy Bates
1997,101098,2134.778526,5,0,0,5,35,Guy Forget
2015,104433,2134.753281,5,0,0,5,15,Frank Dancevic
2002,103789,2134.647038,30,10,0,20,3,Irakli Labadze
1993,108620,2134.594017,5,0,0,5,36,Adel Al Shatti
2004,103917,2134.568008,13,3,0,10,5,Nicolas Mahut
1989,101053,2134.554694,5,0,0,5,50,Michael Kures
1988,100645,2134.540281,5,0,0,5,22,Huub Van Boeckel
2000,102872,2134.433065,12,3,0,9,2,James Sekulov
2006,103573,2134.384062,10,2,0,8,6,Rik De Voest
2010,103752,2134.334731,38,13,0,25,10,Simon Greul
1988,100715,2134.252251,9,2,0,7,5,Jim Gurfein
1989,101161,2134.239116,5,0,0,5,14,Thomas Haldin
1986,100579,2134.23686,15,4,0,11,19,Heinz Gunthardt
2003,102730,2134.197258,13,3,0,10,3,Ivo Heuberger
1993,101214,2134.173688,44,19,0,25,7,Bryan Shelton
2013,105449,2134.114348,14,4,0,10,13,Steve Johnson
2000,102772,2134.094141,5,0,0,5,7,Yu Zhang
2009,103525,2133.931928,5,0,0,5,11,Ivan Miranda
1995,101416,2133.789217,5,0,0,5,10,Joao Cunha Silva
1991,101490,2133.772551,9,2,0,7,7,Daniel Orsanic
2010,104919,2133.749537,34,13,0,21,13,Leonardo Mayer
1985,100445,2133.740976,14,3,0,11,5,Steve Denton
2013,104547,2133.729152,38,15,0,23,5,Horacio Zeballos
1986,100833,2133.721,12,3,0,9,8,Marc Flur
2011,103823,2133.639471,14,4,0,10,17,Denis Gremelmayr
2012,105137,2133.615529,8,1,0,7,34,Pere Riba
2004,101868,2133.611095,8,1,0,7,3,Dick Norman
1987,100770,2133.521132,7,1,0,6,10,Peter Moraing
1985,100727,2133.475051,23,8,0,15,13,Raul Antonio Viver
1992,101660,2133.376353,20,6,0,14,3,Francisco Montana
1990,101050,2133.333074,15,4,0,11,9,Martin Laurendeau
1988,100553,2133.311603,12,3,0,9,14,Nduka Odizor
1997,102205,2133.27821,29,11,0,18,10,Sebastien Lareau
2000,102466,2133.274468,16,5,0,11,6,Jan Kroslak
1986,100326,2133.217099,14,4,0,10,3,Russell Simpson
1997,101582,2133.143226,32,14,0,18,7,Gilbert Schaller
1991,101332,2133.138566,43,15,0,28,7,Gilad Bloom
1991,101510,2133.119976,18,6,0,12,5,Henrik Holm
2013,105464,2133.010104,5,0,0,5,11,Christopher Rungkat
2001,102817,2132.810354,18,6,0,12,7,Edwin Kempes
1997,102169,2132.751128,15,4,0,11,12,Michael Joyce
2006,104386,2132.675155,30,10,0,20,2,Janko Tipsarevic
2008,104589,2132.665807,34,14,0,20,3,Chris Guccione
2001,101820,2132.65967,36,12,0,24,3,Marc Rosset
2013,105028,2132.63408,20,6,0,14,16,Jesse Levine
1986,100941,2132.630714,10,2,0,8,14,Alex Stepanek
1999,102539,2132.541075,36,12,0,24,11,Bohdan Ulihrach
1993,101549,2132.537731,47,18,0,29,4,Rodolphe Gilbert
2014,106032,2132.446347,5,0,0,5,17,Facundo Arguello
1987,101013,2132.309922,18,5,0,13,14,Henrik Sundstrom
1998,101746,2132.25858,10,2,0,8,14,Renzo Furlan
1995,101358,2132.257204,44,17,0,27,3,Olivier Delaitre
2004,103305,2132.214911,10,2,0,8,7,Daniel Elsner
1995,101686,2132.189906,15,4,0,11,3,Franco Davin
1986,101074,2132.158576,16,4,0,12,9,Carlos Di Laura
2009,104056,2132.094671,10,2,0,8,11,Roko Karanusic
1988,100711,2132.072651,30,11,0,19,2,Pedro Rebolledo
2003,103971,2132.065713,34,10,0,24,2,Karol Beck
1991,101233,2131.934087,27,10,0,17,6,Alex Antonitsch
1987,101113,2131.918152,19,5,0,14,3,Michael Westphal
1994,101086,2131.911354,38,15,0,23,3,Ronald Agenor
1986,100730,2131.772532,21,7,0,14,7,Florin Segarceanu
2004,102839,2131.770497,23,7,0,16,13,Nicolas Lapentti
2014,104868,2131.75193,17,5,0,12,5,James Ward
2008,104081,2131.742489,16,4,0,12,18,Boris Pashanski
2007,104160,2131.709018,22,7,0,15,3,Lukas Dlouhy
2000,103188,2131.689656,7,1,0,6,14,Michael Russell
2013,105373,2131.678251,36,12,0,24,5,Martin Klizan
1990,101606,2131.611798,26,9,0,17,1,Alberto Mancini
1996,102925,2131.598509,12,3,0,9,6,Justin Gimelstob
2011,103794,2131.50785,12,3,0,9,35,Benjamin Becker
2008,103506,2131.475793,18,5,0,13,9,Martin Vassallo Arguello
2000,101733,2131.460527,21,7,0,14,13,Jan Siemerink
2007,104501,2131.453726,7,1,0,6,9,Xin Yuan Yu
2000,104027,2131.450388,6,0,0,6,9,Pablo Gonzalez
1986,100864,2131.405438,29,10,0,19,2,Martin Wostenholme
1993,101780,2131.383749,6,0,0,6,15,Alejo Mancisidor
2014,104268,2131.358142,27,10,0,17,4,Alejandro Falla
2003,102950,2131.310231,49,20,0,29,3,Fernando Vicente
1989,101238,2131.307435,17,5,0,12,10,Andres Vysand
1988,101022,2131.306939,11,2,0,9,9,Kelly Jones
1989,101145,2131.299194,19,6,0,13,7,Jonathan Canter
1991,100967,2131.231651,23,8,0,15,15,Dan Goldie
1997,103151,2131.228616,6,0,0,6,24,Mariano Zabaleta
1999,102863,2131.206669,12,3,0,9,11,Takao Suzuki
2008,103534,2131.134188,15,4,0,11,3,Nicolas Devilder
2007,102381,2131.108702,21,7,0,14,3,Werner Eschauer
1996,101681,2131.105089,12,3,0,9,20,Chris Wilkinson
2011,104947,2131.102962,18,5,0,13,8,Marsel Ilhan
1999,102466,2131.097665,39,13,0,26,2,Jan Kroslak
1987,100567,2131.096046,14,4,0,10,11,Chip Hooper
2013,105583,2131.075456,6,0,0,6,0,Dusan Lajovic
1987,100618,2131.068191,15,4,0,11,11,Leif Shiras
1997,101900,2131.053227,26,9,0,17,2,Nicklas Kulti
2013,104268,2131.052106,37,15,0,22,5,Alejandro Falla
2012,103808,2131.036931,26,8,0,18,21,Potito Starace
2001,102179,2131.033635,31,11,0,20,2,Antony Dupuis
2011,104559,2131.030951,30,10,0,20,6,Teymuraz Gabashvili
2008,104372,2131.014906,8,1,0,7,8,Alex Bogdanovic
1989,100782,2130.951099,10,2,0,8,17,Pablo Arraya
1997,101761,2130.892403,6,0,0,6,12,Jaime Oncins
1990,101243,2130.848242,31,13,0,18,1,Roberto Azar
2011,105137,2130.744488,33,11,0,22,6,Pere Riba
2008,103909,2130.705946,10,2,0,8,18,Guillermo Coria
2015,103163,2130.639406,11,2,0,9,6,Tommy Haas
2005,104056,2130.625103,8,1,0,7,6,Roko Karanusic
2013,104424,2130.515161,26,9,0,17,7,Go Soeda
2015,104997,2130.459759,13,3,0,10,22,Igor Sijsling
1993,102304,2130.397903,6,0,0,6,6,Grant Doyle
1992,101123,2130.37946,19,6,0,13,6,Alexander Mronz
1994,101761,2130.328359,10,2,0,8,11,Jaime Oncins
1998,102103,2130.314506,10,2,0,8,13,Michael Sell
1992,101945,2130.239821,10,2,0,8,7,Thierry Guardiola
2011,103971,2130.219366,14,4,0,10,6,Karol Beck
2012,103812,2130.202634,23,8,0,15,0,Victor Hanescu
2009,104999,2130.158081,39,15,0,24,7,Mischa Zverev
2001,102093,2130.134119,8,1,0,7,12,Martin Damm
2009,103084,2130.130708,18,5,0,13,20,Guillermo Canas
2006,101868,2130.121997,13,3,0,10,3,Dick Norman
1985,100597,2130.044659,36,11,0,25,5,Jay Lapidus
1997,102243,2129.999231,10,2,0,8,15,Marcelo Charpentier
2014,105643,2129.843285,47,20,0,27,3,Federico Delbonis
1987,100597,2129.80067,16,4,0,12,21,Jay Lapidus
1999,101185,2129.717555,29,10,0,19,6,Mark Woodforde
2007,104372,2129.715083,10,2,0,8,17,Alex Bogdanovic
1998,101890,2129.560868,15,4,0,11,4,Jonathan Stark
2009,102860,2129.520268,13,3,0,10,23,Agustin Calleri
2014,104947,2129.460465,5,0,0,5,17,Marsel Ilhan
1990,101971,2129.46023,23,8,0,15,6,Johan Anderson
1989,100740,2129.438166,13,3,0,10,2,Dan Cassidy
1992,100757,2129.436905,28,11,0,17,6,Anders Jarryd
2003,104755,2129.423477,10,2,0,8,2,Richard Gasquet
2003,103297,2129.411813,13,3,0,10,7,Alex Kim
1991,101274,2129.378595,30,10,0,20,3,Udo Riglewski
2003,102021,2129.367662,12,2,0,10,10,Michael Chang
2010,103868,2129.349244,10,2,0,8,18,Ivan Navarro
1997,101285,2129.249939,19,5,0,14,11,Thierry Champion
2009,103373,2129.209254,8,1,0,7,17,Sergio Roitman
1987,101179,2129.090979,15,4,0,11,6,Jean Philippe Fleurian
2011,104586,2129.0649,19,6,0,13,6,Lukas Rosol
1987,100657,2129.058329,17,5,0,12,19,Mike Leach
2012,104547,2128.99674,12,3,0,9,10,Horacio Zeballos
2006,103294,2128.994137,41,15,0,26,2,Christophe Rochus
2002,103356,2128.949057,51,20,0,31,2,Michel Kratochvil
1998,101441,2128.866772,22,8,0,14,7,Martin Sinner
1996,102477,2128.824482,14,3,0,11,3,Gaston Etlis
2008,103228,2128.754345,23,8,0,15,10,Marcos Daniel
1991,101256,2128.728967,18,5,0,13,9,Mark Kratzmann
1986,100727,2128.614125,7,0,0,7,10,Raul Antonio Viver
1992,101460,2128.613115,15,4,0,11,3,Jose Francisco Altur
2009,102318,2128.518446,6,0,0,6,10,Andrei Pavel
2008,103694,2128.516459,38,13,0,25,3,Olivier Rochus
2012,103835,2128.430217,32,11,0,21,5,Filippo Volandri
2009,103401,2128.429424,35,11,0,24,3,Jan Hernych
2003,102788,2128.38071,18,5,0,13,3,Jan Vacek
1990,101924,2128.367458,15,4,0,11,3,Stefano Pescosolido
1995,100923,2128.360058,12,3,0,9,19,Wally Masur
1992,101900,2128.275466,43,18,0,25,0,Nicklas Kulti
2005,102571,2127.931516,15,4,0,11,3,Gregory Carraz
2013,103188,2127.834608,22,7,0,15,6,Michael Russell
2011,104314,2127.754302,10,2,0,8,23,Brian Dabul
1988,100964,2127.711645,6,0,0,6,24,Jon Levine
1993,101462,2127.706517,20,6,0,14,3,Francisco Roig
1996,101731,2127.665624,23,7,0,16,11,Nuno Marques
2009,104262,2127.503387,17,5,0,12,12,Flavio Cipolla
1995,101920,2127.463563,26,9,0,17,7,Jamie Morgan
1993,101659,2127.432605,9,1,0,8,5,Jan Apell
2004,103693,2127.259937,28,10,0,18,5,Thierry Ascione
2001,103786,2127.218346,21,6,0,15,3,Nikolay Davydenko
1986,100567,2127.192507,17,5,0,12,3,Chip Hooper
1986,100595,2127.191341,10,2,0,8,5,Ronnie Bathman
1987,101256,2127.178852,20,7,0,13,7,Mark Kratzmann
2000,103084,2127.1101,17,5,0,12,21,Guillermo Canas
1994,102235,2127.055686,12,2,0,10,6,Tommy Ho
1990,100844,2126.932423,22,7,0,15,8,Jerome Potier
2011,104770,2126.881695,5,0,0,5,6,Martin Fischer
1994,101789,2126.866953,39,13,0,26,6,Steve Bryan
1993,101224,2126.854071,18,5,0,13,6,Kenny Thorne
1991,101004,2126.75164,9,1,0,8,13,Jim Pugh
1998,102146,2126.728941,32,11,0,21,4,Jordi Burillo
1993,100972,2126.674025,14,4,0,10,16,Todd Witsken
2007,104229,2126.654942,22,7,0,15,7,Yen Hsun Lu
2007,103110,2126.65125,21,6,0,15,19,Daniele Bracciali
1985,100449,2126.506707,10,2,0,8,6,Stanislav Birner
1988,100431,2126.447604,11,2,0,9,2,Mansour Bahrami
2003,102287,2126.395845,30,10,0,20,7,Albert Portas
1991,101249,2126.375328,14,4,0,10,7,Andrei Olhovskiy
1989,100434,2126.370924,11,2,0,9,13,Tomas Smid
2009,104593,2126.31958,29,9,0,20,3,Daniel Gimeno Traver
2013,105723,2126.283879,28,9,0,19,4,Andrey Kuznetsov
1987,100719,2126.172616,14,4,0,10,14,Juan Avendano
2015,104216,2126.107336,6,0,0,6,26,Maximo Gonzalez
2005,102905,2126.028179,23,7,0,16,5,Stefan Koubek
2010,103843,2125.955838,43,14,0,29,3,Marco Chiudinelli
1995,101711,2125.852084,24,7,0,17,5,Alex Obrien
1991,101955,2125.823874,40,14,0,26,3,Luis Herrera
1988,100530,2125.792618,11,2,0,9,21,Andreas Maurer
2009,104371,2125.78979,16,4,0,12,18,Ivo Minar
2005,102539,2125.762222,9,1,0,8,15,Bohdan Ulihrach
1995,102201,2125.667151,43,16,0,27,3,Lionel Roux
1992,102001,2125.648451,39,15,0,24,3,German Lopez
2008,103535,2125.64292,13,3,0,10,18,Olivier Patience
1996,101797,2125.610831,18,5,0,13,6,Jacco Eltingh
1985,101298,2125.531067,13,3,0,10,3,Jonas Svensson
2009,104314,2125.38015,16,5,0,11,17,Brian Dabul
1995,101945,2125.365672,17,5,0,12,7,Thierry Guardiola
1985,100604,2125.17238,6,0,0,6,19,Egan Adams
1993,101687,2125.166077,6,0,0,6,16,David Dilucia
1999,102093,2125.147054,23,7,0,16,7,Martin Damm
2015,104736,2125.1117,6,0,0,6,1,Farrukh Dustov
1987,108875,2125.098003,6,0,0,6,28,Abou Berthe
2012,103428,2125.095539,18,6,0,12,22,Juan Ignacio Chela
2004,102869,2125.090603,22,7,0,15,7,Galo Blanco
2012,103971,2125.068257,11,2,0,9,12,Karol Beck
1998,101806,2124.919854,36,11,0,25,2,Marc Kevin Goellner
1987,101110,2124.782528,13,3,0,10,10,David De Miguel
1999,101816,2124.742604,6,0,0,6,32,Steve Campbell
1989,101680,2124.728498,9,1,0,8,12,Zeeshan Ali
2009,104003,2124.727811,24,7,0,17,4,Victor Crivoi
2012,105173,2124.553511,8,1,0,7,26,Adrian Mannarino
1994,101977,2124.481441,7,0,0,7,3,Patricio Arnold
2005,103444,2124.353456,28,9,0,19,2,Jean Rene Lisnard
2002,102369,2124.300406,41,16,0,25,3,Julien Boutter
2015,104868,2124.283694,16,4,0,12,12,James Ward
2006,103035,2124.270702,22,7,0,15,5,Alessio Di Mauro
1985,101000,2124.253855,13,3,0,10,1,Carl Limberger
2003,103264,2123.967913,19,5,0,14,6,Mariano Puerta
2007,103105,2123.891514,25,8,0,17,12,Ruben Ramirez Hidalgo
1995,101780,2123.857091,12,2,0,10,12,Alejo Mancisidor
2003,103566,2123.733678,12,2,0,10,3,Michael Llodra
1999,101947,2123.725167,21,7,0,14,10,Vincenzo Santopadre
1990,101022,2123.696556,35,13,0,22,4,Kelly Jones
1997,102085,2123.543621,9,1,0,8,17,Sasa Hirszon
1988,101233,2123.445243,19,4,0,15,6,Alex Antonitsch
2010,105194,2123.439784,6,0,0,6,20,Nick Lindahl
2015,104882,2123.403878,13,3,0,10,17,Blaz Kavcic
2010,102839,2123.33096,9,1,0,8,27,Nicolas Lapentti
1999,102538,2123.173936,9,1,0,8,7,Tuomas Ketola
2000,102477,2123.13961,11,2,0,9,13,Gaston Etlis
2009,102783,2123.019716,43,15,0,28,3,Rainer Schuettler
2001,103181,2123.006328,33,11,0,22,3,Jiri Vanek
2001,102642,2122.991902,15,4,0,11,11,Cyril Saulnier
2012,105138,2122.981938,13,3,0,10,3,Roberto Bautista Agut
1987,100362,2122.927779,16,4,0,12,4,Peter Fleming
1996,101866,2122.926543,31,10,0,21,11,David Rikl
1985,100244,2122.864236,6,0,0,6,4,John Alexander
2003,102925,2122.755432,26,9,0,17,6,Justin Gimelstob
1990,101154,2122.749081,22,7,0,15,5,Simon Youl
1996,101142,2122.665393,23,7,0,16,8,Emilio Sanchez
2008,103206,2122.637108,22,7,0,15,3,Sebastien Grosjean
2000,102024,2122.610811,31,10,0,21,11,Hernan Gumy
2012,104882,2122.509758,21,6,0,15,12,Blaz Kavcic
1999,101235,2122.504245,22,6,0,16,11,Paul Haarhuis
2015,105936,2122.50119,17,4,0,13,6,Filip Krajinovic
2006,103812,2122.490534,7,0,0,7,25,Victor Hanescu
1995,100837,2122.466178,34,12,0,22,6,Jeremy Bates
2011,104154,2122.457435,11,2,0,9,9,Paul Capdeville
2011,103722,2122.333472,16,4,0,12,11,Florent Serra
2011,105011,2122.107568,17,5,0,12,12,Illya Marchenko
2000,102179,2122.095874,17,4,0,13,13,Antony Dupuis
1994,101956,2122.085495,11,2,0,9,11,Mark Knowles
2010,104230,2122.04205,16,4,0,12,26,Daniel Koellerer
2015,103893,2122.011399,29,9,0,20,1,Paolo Lorenzi
2001,102720,2121.976426,14,3,0,11,7,Tomas Zib
1988,101026,2121.870025,40,17,0,23,3,Jim Grabb
2001,102153,2121.806852,19,5,0,14,8,German Puentes
2012,104098,2121.773508,14,3,0,11,8,Dmitry Tursunov
1990,100618,2121.680238,26,8,0,18,11,Leif Shiras
2008,104154,2121.564701,21,6,0,15,8,Paul Capdeville
2008,103248,2121.482011,6,0,0,6,5,Harel Levy
2001,103264,2121.37513,17,4,0,13,8,Mariano Puerta
2009,103169,2121.351073,42,15,0,27,3,Oscar Hernandez
2014,104273,2121.339231,49,21,0,28,2,Edouard Roger Vasselin
1994,101805,2121.335032,13,3,0,10,14,David Nainkin
2014,105332,2121.327054,29,10,0,19,10,Benoit Paire
1991,100855,2121.280298,31,9,0,22,7,Scott Davis
2010,104019,2121.199989,12,2,0,10,10,Kristof Vliegen
1989,101311,2121.181972,6,0,0,6,19,Kent Kinnear
1988,101109,2121.147895,16,4,0,12,27,Tarik Benhabiles
2008,104019,2120.943003,25,7,0,18,3,Kristof Vliegen
1999,102375,2120.911199,13,3,0,10,8,Dinu Pescariu
2011,103672,2120.751697,24,8,0,16,12,Ricardo Mello
2008,103632,2120.702955,26,9,0,17,8,Luis Horna
1987,101145,2120.694054,21,5,0,16,7,Jonathan Canter
1991,101133,2120.656118,39,17,0,22,3,Patrick Baur
1987,100696,2120.61795,13,3,0,10,15,Mark Buckley
1986,100751,2120.601906,6,0,0,6,2,Roberto Saad
1995,101123,2120.598546,25,7,0,18,7,Alexander Mronz
2005,103181,2120.474714,25,7,0,18,3,Jiri Vanek
1998,101843,2120.462047,38,12,0,26,7,Sergi Bruguera
1996,101412,2120.419525,39,13,0,26,8,Shuzo Matsuoka
1997,102069,2120.364066,7,0,0,7,10,Andrei Rybalko
2005,102880,2120.288163,17,4,0,13,3,Alexander Popp
2009,103823,2120.271908,11,2,0,9,26,Denis Gremelmayr
1988,100844,2120.251254,36,13,0,23,2,Jerome Potier
2002,102905,2120.247247,52,20,0,32,2,Stefan Koubek
1993,101711,2120.195013,33,12,0,21,3,Alex Obrien
2011,105062,2120.190126,34,10,0,24,4,Mikhail Kukushkin
2002,103294,2120.036468,31,10,0,21,7,Christophe Rochus
2011,105217,2120.003336,14,3,0,11,13,Thiemo De Bakker
2001,102925,2119.901941,15,3,0,12,10,Justin Gimelstob
1995,102795,2119.825166,6,0,0,6,13,Scott Humphries
1986,100917,2119.712535,17,5,0,12,9,Nelson Aerts
1990,101150,2119.549493,9,1,0,8,5,Gianluca Pozzi
1988,100740,2119.414493,28,7,0,21,2,Dan Cassidy
1993,101147,2119.386163,35,12,0,23,6,Claudio Mezzadri
1988,100548,2119.362275,7,0,0,7,2,Ivan Kley
2006,103499,2119.282272,6,0,0,6,8,Aqeel Khan
2009,102434,2119.264355,11,2,0,9,17,Vincent Spadea
2014,104979,2119.219675,35,12,0,23,3,Andrey Golubev
2007,103103,2119.123703,31,10,0,21,12,Dominik Hrbaty
2009,104559,2119.03334,37,13,0,24,5,Teymuraz Gabashvili
2002,103714,2118.990732,16,3,0,13,3,Andreas Vinciguerra
2000,102642,2118.938627,18,4,0,14,6,Cyril Saulnier
2012,104735,2118.937798,24,6,0,18,6,Tobias Kamke
2013,103908,2118.910934,25,6,0,19,5,Paul Henri Mathieu
2010,104547,2118.900738,44,16,0,28,5,Horacio Zeballos
2013,104262,2118.582451,11,2,0,9,21,Flavio Cipolla
1995,102351,2118.572343,24,7,0,17,8,Oscar Martinez
1996,100757,2118.552612,9,1,0,8,20,Anders Jarryd
2012,105041,2118.547759,34,13,0,21,4,Lukas Lacko
2010,105137,2118.539607,20,6,0,14,5,Pere Riba
1990,101344,2118.419476,23,7,0,16,3,Bruno Oresar
2002,103188,2118.320585,20,5,0,15,12,Michael Russell
2002,102921,2118.258916,9,1,0,8,6,Ota Fukarek
2013,105413,2118.197529,8,1,0,7,1,Andrej Martin
2002,101532,2118.177224,33,11,0,22,4,Francisco Clavet
1997,102375,2118.16505,16,3,0,13,2,Dinu Pescariu
2012,104494,2118.065451,18,4,0,14,0,Adrian Ungur
2014,105137,2118.043043,14,3,0,11,4,Pere Riba
1989,100836,2117.8073,34,13,0,21,5,Glenn Michibata
1991,100962,2117.789895,34,11,0,23,3,Thomas Hogstedt
2008,103490,2117.728227,24,8,0,16,10,Santiago Ventura
1990,101482,2117.585597,22,6,0,16,5,Markus Zoecke
1997,103060,2117.549268,12,2,0,10,3,Alejandro Hernandez
1990,100939,2117.453134,35,14,0,21,5,Joey Rive
2000,102548,2117.436459,32,11,0,21,11,Juan Antonio Marin
2001,103082,2117.404132,16,4,0,12,7,Markus Hantschk
2007,103580,2117.329734,19,5,0,14,6,Alexander Peya
1993,101767,2117.154544,25,8,0,17,15,Lars Jonsson
1997,102139,2117.145727,19,5,0,14,11,Eyal Ran
1998,101917,2117.081939,35,12,0,23,13,Grant Stafford
2010,102967,2117.057803,17,5,0,12,13,Marc Gicquel
1997,101809,2116.994569,9,1,0,8,18,Nicolas Pereira
1995,101783,2116.972302,22,7,0,15,6,Mark Petchey
1986,100221,2116.714998,12,2,0,10,2,Carlos Kirmayr
1991,101920,2116.631981,9,1,0,8,7,Jamie Morgan
2006,104180,2116.60016,33,13,0,20,5,Gilles Muller
1990,101214,2116.587245,26,9,0,17,1,Bryan Shelton
2011,104594,2116.564876,12,2,0,10,10,Marinko Matosevic
1990,101337,2116.448856,33,10,0,23,4,Martin Strelba
2005,104259,2116.365557,37,12,0,25,3,Philipp Kohlschreiber
1996,101133,2116.273092,15,3,0,12,6,Patrick Baur
1987,100440,2116.225326,25,8,0,17,3,Eddie Edwards
2001,101543,2116.147923,9,1,0,8,22,Jeff Tarango
1990,100864,2116.102283,29,10,0,19,1,Martin Wostenholme
2012,103799,2116.056796,7,0,0,7,26,Eric Prodon
2007,104225,2115.79278,18,4,0,14,18,Jan Hajek
1985,100962,2115.655694,13,3,0,10,9,Thomas Hogstedt
1995,101120,2115.635239,37,13,0,24,6,Karel Novacek
2015,104979,2115.593945,14,3,0,11,10,Andrey Golubev
1990,101016,2115.493183,11,2,0,9,3,Marcos Aurelio Gorriz
1985,100651,2115.405426,24,7,0,17,13,Alejandro Ganzabal
2007,103752,2115.394859,12,2,0,10,20,Simon Greul
1995,101731,2115.335764,21,6,0,15,3,Nuno Marques
1998,102201,2115.325013,18,5,0,13,2,Lionel Roux
2000,102437,2115.297919,29,9,0,20,2,Adrian Voinea
2006,104122,2115.281159,22,5,0,17,14,Carlos Berlocq
1993,101686,2115.221896,32,11,0,21,3,Franco Davin
1985,100548,2115.033644,13,3,0,10,19,Ivan Kley
2008,103693,2114.980127,10,1,0,9,3,Thierry Ascione
1990,100942,2114.979268,18,5,0,13,8,Thierry Tulasne
1992,101000,2114.899041,15,3,0,12,3,Carl Limberger
1990,100628,2114.874705,18,5,0,13,11,Michiel Schapers
2009,105579,2114.777584,7,0,0,7,9,Kittipong Wachiramanowong
2005,101868,2114.756669,11,2,0,9,7,Dick Norman
2013,106210,2114.71628,7,0,0,7,6,Jiri Vesely
1998,102491,2114.641666,7,0,0,7,11,Alex Radulescu
1999,101703,2114.615605,30,10,0,20,3,Guillaume Raoux
1990,101358,2114.605093,22,6,0,16,4,Olivier Delaitre
1998,102231,2114.491118,29,11,0,18,3,Alex Calatrava
1987,100922,2114.422039,11,1,0,10,3,Roberto Arguello
2012,104665,2114.302678,48,19,0,29,3,Pablo Andujar
2006,103451,2114.280499,42,16,0,26,3,Bjorn Phau
2002,103397,2114.278587,12,2,0,10,6,Alexandre Simoni
2013,104494,2114.267626,14,3,0,11,1,Adrian Ungur
1987,101085,2114.250469,10,1,0,9,19,Corrado Aprili
1998,102375,2114.109009,22,6,0,16,7,Dinu Pescariu
1990,101460,2113.909512,20,5,0,15,1,Jose Francisco Altur
1997,101956,2113.873602,9,1,0,8,18,Mark Knowles
2011,104460,2113.868747,12,2,0,10,23,Dustin Brown
2001,103305,2113.783302,10,1,0,9,17,Daniel Elsner
2000,102720,2113.700543,18,5,0,13,19,Tomas Zib
1990,100946,2113.692641,14,3,0,11,17,Slobodan Zivojinovic
2004,104527,2113.660872,7,0,0,7,3,Stanislas Wawrinka
1989,101123,2113.609562,14,3,0,11,3,Alexander Mronz
1992,101276,2113.538419,25,7,0,18,8,Horacio De La Pena
1994,100944,2113.507627,7,0,0,7,21,Mikael Pernfors
2006,104160,2113.493861,30,8,0,22,3,Lukas Dlouhy
1987,101242,2113.411113,21,5,0,16,6,Brad Pearce
2006,102783,2113.386796,33,11,0,22,3,Rainer Schuettler
2005,102720,2113.233797,48,18,0,30,3,Tomas Zib
1990,100740,2113.021726,7,0,0,7,11,Dan Cassidy
1989,100908,2112.549524,16,4,0,12,20,Tobias Svantesson
1990,101071,2112.445356,16,3,0,13,8,Tom Nijssen
2006,103240,2112.424105,25,7,0,18,3,Kevin Kim
1999,102887,2112.399457,34,11,0,23,5,Ramon Delgado
2013,103893,2112.328332,38,13,0,25,6,Paolo Lorenzi
2003,103789,2112.099451,23,6,0,17,6,Irakli Labadze
1997,101016,2111.723531,13,2,0,11,17,Marcos Aurelio Gorriz
1991,101601,2111.657688,10,1,0,9,7,Brett Steven
2006,102720,2111.570169,26,6,0,20,3,Tomas Zib
1994,101783,2111.560113,41,15,0,26,6,Mark Petchey
1993,101717,2111.539261,33,10,0,23,3,Diego Nargiso
2015,105041,2111.534876,15,3,0,12,12,Lukas Lacko
2010,103997,2111.517928,41,16,0,25,5,Lukasz Kubot
1986,100744,2111.29614,7,0,0,7,8,Peter Doohan
1987,100742,2111.274273,21,5,0,16,3,Christo Steyn
2010,104330,2111.223991,24,6,0,18,5,Rajeev Ram
2003,103408,2111.176276,35,12,0,23,3,Brian Vahaly
2011,103105,2110.978349,20,5,0,15,18,Ruben Ramirez Hidalgo
2006,102494,2110.953943,16,4,0,12,17,Tomas Behrend
2010,103490,2110.735067,14,3,0,11,10,Santiago Ventura
2009,104327,2110.733199,25,7,0,18,4,Steve Darcis
2007,103018,2110.72923,31,9,0,22,3,Max Mirnyi
2014,104873,2110.714673,18,4,0,14,10,Aleksandr Nedovyesov
1989,100646,2110.617543,10,1,0,9,27,Claudio Panatta
2007,104198,2110.586842,35,13,0,22,3,Guillermo Garcia Lopez
2005,103169,2110.498391,22,6,0,16,7,Oscar Hernandez
1998,101459,2110.442604,25,7,0,18,10,Tomas Nydahl
1989,101237,2110.390389,17,4,0,13,2,Danilo Marcelino
1995,101224,2110.374579,10,1,0,9,15,Kenny Thorne
2008,104252,2110.201082,12,2,0,10,25,Florian Mayer
1988,101143,2110.14179,18,4,0,14,13,Branislav Stankovic
2005,103490,2109.955315,27,9,0,18,15,Santiago Ventura
2010,103188,2109.857376,34,11,0,23,2,Michael Russell
1992,100437,2109.842406,8,0,0,8,8,Bjorn Borg
1999,102234,2109.733289,20,6,0,14,10,Oliver Gross
1999,102231,2109.564917,12,2,0,10,10,Alex Calatrava
2007,103169,2109.44904,25,8,0,17,3,Oscar Hernandez
1992,101767,2109.340068,32,9,0,23,3,Lars Jonsson
2006,102548,2109.337688,16,4,0,12,7,Juan Antonio Marin
1986,100402,2109.255172,8,0,0,8,3,Francisco Gonzalez
1996,101416,2109.232706,15,3,0,12,14,Joao Cunha Silva
2009,103294,2109.199523,43,15,0,28,3,Christophe Rochus
2000,102238,2109.145997,18,4,0,14,11,Alberto Berasategui
1998,102629,2109.018036,12,2,0,10,7,Oscar Burrieza
1998,102472,2108.98843,15,3,0,12,10,Marcello Craca
2000,101888,2108.834658,17,4,0,13,30,Daniel Vacek
1992,101368,2108.742992,34,11,0,23,3,Christian Miniussi
1994,101468,2108.684987,15,3,0,12,8,Gerard Solves
2007,103709,2108.618745,21,5,0,16,12,Kristian Pless
2001,103694,2108.494442,30,9,0,21,3,Olivier Rochus
2005,105385,2108.338741,7,0,0,7,10,Donald Young
1995,101591,2108.296899,13,2,0,11,6,Danny Sapsford
1986,100926,2108.269638,19,4,0,15,3,Ken Flach
2000,101826,2108.143387,10,1,0,9,19,Alex Lopez Moron
2006,104312,2108.119324,50,20,0,30,2,Andreas Seppi
1986,100772,2107.930525,16,3,0,13,8,Kelly Evernden
1995,101214,2107.897423,33,11,0,22,6,Bryan Shelton
2011,104897,2107.658964,17,4,0,13,2,Matthias Bachinger
1993,101416,2107.627032,29,9,0,20,4,Joao Cunha Silva
2001,102231,2107.564413,47,18,0,29,3,Alex Calatrava
1985,100606,2107.304916,31,9,0,22,1,Mike Bauer
1991,101416,2107.27016,13,2,0,11,17,Joao Cunha Silva
1995,102088,2107.175108,23,6,0,17,7,Joern Renzenbrink
2001,101792,2107.148256,21,5,0,16,12,Slava Dosedel
2014,105614,2107.097647,13,2,0,11,10,Bradley Klahn
1995,102167,2107.09049,8,0,0,8,8,Juan Albert Viloca Puig
1995,101381,2106.877798,40,16,0,24,0,Aaron Krickstein
1998,102167,2106.714463,29,8,0,21,2,Juan Albert Viloca Puig
1992,101086,2106.626211,21,5,0,16,7,Ronald Agenor
2012,104166,2106.546411,46,14,0,32,6,Alex Bogomolov Jr
1987,100611,2106.479781,34,12,0,22,6,Mel Purcell
1996,101772,2106.46048,15,3,0,12,13,Andrei Cherkasov
2005,103820,2106.314316,9,0,0,9,3,Alan Mackin
2004,103444,2106.26409,17,4,0,13,6,Jean Rene Lisnard
2000,101902,2106.186888,21,5,0,16,3,Stephane Huet
2005,103171,2106.173219,20,5,0,15,6,Raemon Sluiter
2011,104593,2106.154489,34,9,0,25,4,Daniel Gimeno Traver
1997,101789,2105.909808,8,0,0,8,14,Steve Bryan
1993,101337,2105.843991,12,2,0,10,15,Martin Strelba
1994,101866,2105.775585,47,19,0,28,3,David Rikl
1985,100490,2105.655166,26,7,0,19,6,Jaroslav Navratil
2002,102788,2105.618649,35,10,0,25,3,Jan Vacek
2015,105065,2105.597904,18,5,0,13,12,Tim Smyczek
2008,105064,2105.568129,19,4,0,15,5,Thomaz Bellucci
2012,103105,2105.44042,18,4,0,14,0,Ruben Ramirez Hidalgo
1988,100661,2105.437662,24,7,0,17,10,Damir Keretic
1985,100390,2105.419075,19,4,0,15,19,Trevor Allan
1988,101040,2105.206162,12,2,0,10,19,Peter Lindgren
2009,104979,2105.146821,26,7,0,19,5,Andrey Golubev
1986,100776,2105.103845,15,3,0,12,5,Tomm Warneke
1991,101097,2104.83599,8,0,0,8,5,Rick Leach
1989,100934,2104.834157,15,3,0,12,3,Matt Anger
1994,101862,2104.786479,40,14,0,26,5,Maurice Ruah
1998,102154,2104.676267,13,2,0,11,6,Marcos Ondruska
2002,102382,2104.46684,18,4,0,14,6,Julian Knowle
2010,103893,2104.221478,17,3,0,14,18,Paolo Lorenzi
2007,103454,2104.181729,36,12,0,24,3,Nicolas Massu
2014,104978,2104.11248,14,3,0,11,4,Daniel Brands
1994,101481,2104.026831,17,3,0,14,13,Omar Camporese
2006,102106,2103.98415,36,11,0,25,5,Davide Sanguinetti
1992,101119,2103.938556,8,0,0,8,15,Marian Vajda
2007,103373,2103.810392,33,9,0,24,5,Sergio Roitman
2010,104724,2103.716574,37,13,0,24,4,Eduardo Schwank
1993,101761,2103.317418,37,12,0,25,3,Jaime Oncins
2004,102788,2103.169206,15,3,0,12,6,Jan Vacek
1995,101365,2103.07106,28,8,0,20,6,Paul Wekesa
1987,101000,2102.78633,34,12,0,22,3,Carl Limberger
1991,101469,2102.707297,14,2,0,12,15,Brian Garrow
1993,101606,2102.698256,37,13,0,24,3,Alberto Mancini
2004,102770,2102.47156,16,3,0,13,7,John Van Lottum
1991,100772,2102.466197,21,5,0,16,10,Kelly Evernden
2014,104714,2102.11434,11,1,0,10,16,Julian Reister
1990,101809,2102.078376,20,5,0,15,1,Nicolas Pereira
1998,102538,2102.073715,14,3,0,11,10,Tuomas Ketola
2001,102652,2102.045031,16,3,0,13,6,Christian Vinck
2007,103821,2102.014503,28,9,0,19,7,Danai Udomchoke
1987,100956,2101.826446,23,5,0,18,13,Simone Colombo
1992,101914,2101.76049,30,10,0,20,3,Lars Koslowski
2013,105064,2101.51158,27,8,0,19,11,Thomaz Bellucci
2008,103835,2101.488877,30,10,0,20,3,Filippo Volandri
2011,104225,2101.420847,11,1,0,10,12,Jan Hajek
1999,102106,2101.233173,35,10,0,25,7,Davide Sanguinetti
2009,104035,2100.913459,16,3,0,13,17,Bobby Reynolds
1990,101131,2100.439328,19,4,0,15,6,Jimmy Brown
1993,101285,2100.334653,15,3,0,12,4,Thierry Champion
2007,103470,2100.211326,23,5,0,18,7,Robert Kendrick
1992,101750,2100.207637,27,8,0,19,12,Cristiano Caratti
2007,102925,2099.923552,13,1,0,12,3,Justin Gimelstob
1992,101243,2099.919377,26,7,0,19,3,Roberto Azar
1986,100518,2099.915221,32,9,0,23,2,Ricardo Acuna
1985,100402,2099.76407,29,10,0,19,1,Francisco Gonzalez
1999,101475,2099.722237,11,1,0,10,10,Carlos Costa
2004,103169,2099.632694,27,8,0,19,3,Oscar Hernandez
1991,100752,2099.623161,32,11,0,21,10,Ramesh Krishnan
1996,102029,2099.530614,54,19,0,35,3,Filip Dewulf
2014,104932,2099.456995,26,7,0,19,2,Kenny De Schepper
1985,100543,2099.419246,13,2,0,11,10,Peter Elter
1985,100790,2099.209843,10,1,0,9,1,Bruce Derlin
2004,103408,2099.056739,11,1,0,10,17,Brian Vahaly
1994,101549,2099.015915,34,10,0,24,6,Rodolphe Gilbert
2001,103166,2098.944611,39,13,0,26,3,Vladimir Voltchkov
2007,103280,2098.912716,9,0,0,9,26,Martin Verkerk
1993,101016,2098.728905,32,9,0,23,6,Marcos Aurelio Gorriz
1988,101088,2098.5988,9,0,0,9,22,Larry Scott
2013,104593,2098.507182,41,14,0,27,5,Daniel Gimeno Traver
1993,101150,2098.363551,39,13,0,26,6,Gianluca Pozzi
1998,102104,2098.117342,19,4,0,15,4,Christian Ruud
2006,103228,2098.094726,21,5,0,16,6,Marcos Daniel
2008,103373,2097.913794,25,7,0,18,10,Sergio Roitman
2009,103534,2097.90364,18,4,0,14,23,Nicolas Devilder
1992,101237,2097.604047,17,3,0,14,3,Danilo Marcelino
1992,101031,2097.509945,11,1,0,10,9,Massimo Cierro
2005,101962,2097.225037,12,1,0,11,6,Younes El Aynaoui
1993,101154,2097.217782,11,1,0,10,13,Simon Youl
1995,101511,2097.166872,15,2,0,13,16,Horst Skoff
1998,101816,2097.053584,40,15,0,25,3,Steve Campbell
1985,100377,2096.891788,13,2,0,11,1,Colin Dowdeswell
1991,101797,2096.59208,36,12,0,24,3,Jacco Eltingh
2012,103694,2096.523839,33,10,0,23,5,Olivier Rochus
1988,100744,2096.292646,17,4,0,13,10,Peter Doohan
1998,102394,2096.218421,30,9,0,21,2,Johan Van Herck
2011,104216,2096.091576,16,3,0,13,13,Maximo Gonzalez
1990,100962,2095.618695,38,12,0,26,1,Thomas Hogstedt
1991,101792,2095.393662,17,4,0,13,7,Slava Dosedel
1994,101641,2095.280733,10,1,0,9,10,Jose Luis Noriega
2009,104229,2095.214915,33,10,0,23,6,Yen Hsun Lu
1993,101243,2094.657386,19,3,0,16,9,Roberto Azar
1985,100740,2094.649647,26,7,0,19,5,Dan Cassidy
2000,101086,2094.574724,22,6,0,16,16,Ronald Agenor
2004,103248,2094.410524,21,5,0,16,6,Harel Levy
1990,100829,2094.302595,29,8,0,21,1,Jan Gunnarsson
1996,101063,2094.293778,10,0,0,10,22,Jordi Arrese
2008,105385,2093.878351,28,8,0,20,6,Donald Young
2000,102966,2093.823604,17,4,0,13,2,Fredrik Jonsson
1998,102652,2093.8177,20,5,0,15,6,Christian Vinck
2008,103582,2093.716755,30,8,0,22,5,Michael Berrer
1997,102650,2093.714781,15,2,0,13,11,Roberto Carretero
1985,101109,2093.70207,42,16,0,26,1,Tarik Benhabiles
2002,102247,2093.612906,37,11,0,26,7,Andrea Gaudenzi
2005,103898,2093.589138,23,5,0,18,3,Julien Benneteau
1995,101026,2093.482946,23,6,0,17,4,Jim Grabb
2001,103324,2093.36886,25,6,0,19,12,Arnaud Di Pasquale
2015,104022,2093.193068,33,9,0,24,6,Mikhail Youzhny
2003,102437,2092.896468,28,8,0,20,14,Adrian Voinea
2009,103675,2092.895775,20,4,0,16,18,Diego Junqueira
1990,100837,2092.883779,24,6,0,18,1,Jeremy Bates
1989,101158,2092.813531,16,3,0,13,16,John Frawley
2004,103105,2092.798624,26,7,0,19,14,Ruben Ramirez Hidalgo
1990,101284,2092.795487,20,5,0,15,6,Lars Anders Wahlgren
2005,102231,2092.51664,21,4,0,17,7,Alex Calatrava
1988,101064,2092.059695,15,3,0,12,10,David Lewis
2000,101543,2091.897995,36,11,0,25,2,Jeff Tarango
2003,102987,2091.888788,23,4,0,19,9,Andre Sa
1986,101020,2091.844089,30,8,0,22,9,Hans Schwaier
1997,101265,2091.079748,13,2,0,11,6,Patrick Mcenroe
1996,102339,2091.068215,22,4,0,18,9,Kris Goossens
2009,103252,2090.717521,27,7,0,20,3,Alberto Martin
1996,101775,2090.425294,29,7,0,22,6,Frederik Fetterlein
2007,104589,2090.354427,26,8,0,18,9,Chris Guccione
1994,101552,2090.124446,20,5,0,15,13,Xavier Daufresne
1985,100701,2089.985556,27,7,0,20,6,Marko Ostoja
2002,103114,2089.892571,22,4,0,18,8,Martin Lee
2001,102223,2089.784095,24,6,0,18,8,Karim Alami
2000,102831,2089.722777,12,1,0,11,21,Jacobo Diaz
1992,101179,2089.699338,12,1,0,11,22,Jean Philippe Fleurian
1987,100747,2089.594656,13,1,0,12,13,Glenn Layendecker
1985,100323,2089.005893,14,2,0,12,16,Givaldo Barbosa
1999,101675,2088.724145,28,8,0,20,7,Martin Rodriguez
2010,103169,2088.620338,16,2,0,14,24,Oscar Hernandez
2002,102776,2088.400568,9,0,0,9,21,Andrew Ilie
2006,102950,2088.346368,22,5,0,17,6,Fernando Vicente
2006,104035,2087.902783,12,1,0,11,14,Bobby Reynolds
2008,102381,2087.575017,12,1,0,11,18,Werner Eschauer
1994,101917,2087.431108,33,11,0,22,10,Grant Stafford
1991,101382,2087.195647,32,9,0,23,3,Marcelo Filippini
1985,100475,2087.136691,28,8,0,20,5,Matt Mitchell
1991,102000,2086.96487,26,7,0,19,17,Aki Rahunen
2004,102287,2086.606403,20,4,0,16,14,Albert Portas
2005,103592,2086.281965,12,1,0,11,15,Jerome Haehnel
2007,103240,2086.255665,17,3,0,14,11,Kevin Kim
2001,102106,2085.997596,37,10,0,27,3,Davide Sanguinetti
2003,102821,2085.491856,18,3,0,15,6,Cecil Mamiit
2002,102287,2085.351532,32,9,0,23,3,Albert Portas
1996,101391,2084.866367,28,7,0,21,5,Carl Uwe Steeb
1993,100800,2084.719671,17,2,0,15,3,Diego Perez
1991,101460,2084.496778,15,2,0,13,12,Jose Francisco Altur
2009,104724,2084.496743,17,3,0,14,19,Eduardo Schwank
2010,103429,2084.005109,36,11,0,25,11,Peter Luczak
2009,104665,2083.688895,13,1,0,12,20,Pablo Andujar
2006,103503,2083.534166,39,12,0,27,3,Robin Vik
1993,101312,2082.539316,30,8,0,22,4,Robbie Weiss
1996,101868,2082.513572,13,1,0,12,14,Dick Norman
1991,100809,2082.425298,22,4,0,18,16,Juan Aguilera
2003,103318,2082.258124,16,2,0,14,15,Zeljko Krajan
1992,101719,2081.684618,36,9,0,27,6,Frederic Fontang
1986,100836,2081.538079,29,8,0,21,3,Glenn Michibata
2010,103971,2081.101614,12,1,0,11,3,Karol Beck
2015,105154,2081.091157,25,7,0,18,11,Joao Souza
2009,103506,2080.087679,41,15,0,26,3,Martin Vassallo Arguello
1994,101362,2079.940271,26,7,0,19,6,Stephane Simian
1994,101772,2079.317404,35,8,0,27,3,Andrei Cherkasov
2006,104081,2078.898433,33,10,0,23,9,Boris Pashanski
2006,103009,2078.346793,19,3,0,16,9,Razvan Sabau
2012,104349,2078.030046,15,1,0,14,12,Rui Machado
2005,103319,2077.989392,18,3,0,15,14,Jeff Morrison
2005,102694,2077.987835,27,6,0,21,3,Lars Burgsmuller
1992,100995,2076.974296,19,3,0,16,17,Eduardo Masso
1985,100598,2076.74166,21,4,0,17,4,Wolfgang Popp
1997,102220,2075.781927,22,4,0,18,6,Patrik Fredriksson
2010,103294,2075.319399,11,0,0,11,20,Christophe Rochus
1996,102259,2074.728603,17,3,0,14,9,Jerome Golmard
1993,101500,2074.359104,13,1,0,12,7,Christian Saceanu
1987,100548,2074.178654,14,1,0,13,2,Ivan Kley
2000,101969,2073.845164,29,8,0,21,7,Orlin Stanoytchev
1985,100534,2073.620861,17,2,0,15,16,Steve Meister
2014,104997,2073.406564,38,10,0,28,4,Igor Sijsling
1994,101788,2073.361358,21,4,0,17,14,Doug Flach
2001,102184,2072.829747,31,7,0,24,3,David Prinosil
2007,104025,2072.129536,33,9,0,24,3,Amer Delic
2010,104308,2072.085575,17,2,0,15,5,Michal Przysiezny
2000,102770,2072.053128,15,2,0,13,13,John Van Lottum
2014,104308,2071.54647,25,4,0,21,6,Michal Przysiezny
1991,101354,2071.331631,22,5,0,17,10,Andrew Sznajder
1988,100490,2071.144141,14,1,0,13,15,Jaroslav Navratil
1997,101969,2069.771127,14,1,0,13,9,Orlin Stanoytchev
1998,101439,2068.368784,34,8,0,26,7,Javier Sanchez
1985,100609,2067.676523,19,3,0,16,19,Zoltan Kuharszky
1987,101022,2067.556947,28,6,0,22,3,Kelly Jones
1989,100955,2065.625581,15,1,0,14,16,Yahiya Doumbia
2015,104594,2065.297812,19,3,0,16,16,Marinko Matosevic
2008,104122,2064.874871,19,3,0,16,18,Carlos Berlocq
2006,104371,2064.209693,15,1,0,14,14,Ivo Minar
2012,105385,2064.166836,29,5,0,24,6,Donald Young
2001,101150,2061.71266,30,7,0,23,6,Gianluca Pozzi
1997,101249,2061.113165,14,0,0,14,7,Andrei Olhovskiy
1995,101482,2061.000149,20,3,0,17,19,Markus Zoecke
2014,105051,2059.26994,26,5,0,21,7,Matthew Ebden
1994,101398,2058.302018,15,1,0,14,6,Neil Borwick
2015,105526,2057.688375,24,5,0,19,6,Jan Lennard Struff
2012,103857,2055.337293,26,5,0,21,18,Igor Kunitsyn
2007,104559,2053.819547,38,10,0,28,2,Teymuraz Gabashvili
2011,104999,2049.555019,20,2,0,18,10,Mischa Zverev
2011,104979,2049.138637,32,6,0,26,11,Andrey Golubev
2003,102565,2046.715741,20,2,0,18,5,Alexander Waske
1991,101242,2045.423565,21,2,0,19,15,Brad Pearce
1996,102031,2037.494502,27,4,0,23,11,Sandor Noszaly
2014,103835,2035.904103,17,1,0,16,16,Filippo Volandri
2000,102434,2034.136357,30,3,0,27,2,Vincent Spadea
1987,100830,2028.246483,20,1,0,19,11,Gary Donnelly